//MAP CONVERTED BY dmm2tgm.py THIS HEADER COMMENT PREVENTS RECONVERSION, DO NOT REMOVE
"am" = (
/obj/structure/stone_tile/block{
	dir = 8
	},
/turf/closed/mineral/random/high_chance/volcanic,
/area/lavaland/surface/outdoors)
"bc" = (
/obj/structure/stone_tile/cracked{
	dir = 8
	},
/obj/structure/flora/ash/cap_shroom,
/turf/closed/mineral/random/high_chance/volcanic,
/area/lavaland/surface/outdoors)
"br" = (
/obj/structure/stone_tile/burnt{
	dir = 4
	},
/obj/structure/stone_tile/cracked{
	dir = 1
	},
/turf/open/lava/smooth/lava_land_surface,
/area/lavaland/surface/outdoors)
"bD" = (
/obj/item/xenoarch/useless_relic{
	name = "Ancient relic";
	desc = "Sort of relic that can be exported through Cargo."
	},
/obj/effect/spawner/random/structure/spikes,
/turf/closed/mineral/volcanic/lava_land_surface,
/area/lavaland/surface/outdoors)
"bE" = (
/obj/structure/stone_tile/block,
/obj/structure/stone_tile{
	dir = 1
	},
/obj/item/flashlight/flare/torch,
/turf/closed/mineral/random/high_chance/volcanic,
/area/lavaland/surface/outdoors)
"bR" = (
/obj/structure/stone_tile/surrounding/cracked{
	dir = 6
	},
/obj/structure/stone_tile/center/cracked,
/obj/effect/gibspawner/human/bodypartless,
/obj/effect/spawner/random/mob/necropolis_mob,
/turf/open/misc/asteroid/basalt/lava_land_surface,
/area/lavaland/surface/outdoors)
"ce" = (
/obj/effect/mapping_helpers/bombable_wall,
/turf/closed/indestructible/riveted/boss/wasteland,
/area/lavaland/surface/outdoors)
"cs" = (
/obj/structure/stone_tile/surrounding/cracked{
	dir = 8
	},
/obj/item/shield/buckler,
/obj/effect/decal/cleanable/blood/old,
/obj/structure/glowshroom/shadowshroom,
/obj/item/food/meat/slab/human/mutant/shadow,
/obj/effect/decal/cleanable/grand_remains,
/obj/effect/mob_spawn/corpse/human/blood_cultist,
/obj/effect/gibspawner/human/bodypartless,
/obj/item/xenoarch/useless_relic/magnified{
	name = "Ancient relic";
	desc = "Sort of relic that can be exported through Cargo."
	},
/obj/item/book/granter/action/spell/random,
/turf/open/indestructible/necropolis,
/area/ruin/unpowered)
"cC" = (
/obj/structure/stone_tile,
/turf/closed/mineral/random/high_chance/volcanic,
/area/lavaland/surface/outdoors)
"cI" = (
/obj/structure/stone_tile/cracked{
	dir = 1
	},
/turf/closed/indestructible/riveted/boss,
/area/lavaland/surface/outdoors)
"dr" = (
/obj/structure/flora/rock/pile/style_random,
/obj/item/xenoarch/useless_relic{
	name = "Ancient relic";
	desc = "Sort of relic that can be exported through Cargo."
	},
/obj/effect/spawner/random/structure/spikes,
/turf/closed/mineral/volcanic/lava_land_surface,
/area/lavaland/surface/outdoors)
"dL" = (
/obj/structure/stone_tile/cracked,
/obj/effect/spawner/random/structure/spikes,
/turf/closed/mineral/volcanic/lava_land_surface,
/area/lavaland/surface/outdoors)
"eh" = (
/obj/structure/stone_tile/block/burnt{
	dir = 4
	},
/turf/open/lava/smooth/lava_land_surface,
/area/lavaland/surface/outdoors)
"ej" = (
/obj/structure/stone_tile/block{
	dir = 8
	},
/turf/closed/mineral/volcanic/lava_land_surface,
/area/lavaland/surface/outdoors)
"eK" = (
/obj/structure/stone_tile/slab/cracked{
	dir = 1
	},
/obj/structure/stone_tile/slab/cracked{
	dir = 8
	},
/obj/effect/decal/cleanable/blood,
/obj/effect/gibspawner/human/bodypartless,
/mob/living/basic/mining/ancient_demon/ancient_demon_lesser,
/turf/open/indestructible/necropolis,
/area/ruin/unpowered)
"eW" = (
/obj/structure/stone_tile/block/cracked{
	dir = 1
	},
/obj/structure/stone_tile/block,
/turf/open/lava/smooth/lava_land_surface,
/area/lavaland/surface/outdoors)
"fC" = (
/obj/effect/spawner/random/structure/spikes,
/turf/closed/mineral/volcanic/lava_land_surface,
/area/lavaland/surface/outdoors)
"fD" = (
/obj/structure/stone_tile/slab/cracked{
	dir = 4
	},
/obj/structure/stone_tile/slab/cracked{
	dir = 8
	},
/turf/open/lava/smooth/lava_land_surface,
/area/lavaland/surface/outdoors)
"fL" = (
/obj/structure/stone_tile/slab/cracked,
/turf/closed/mineral/random/high_chance/volcanic,
/area/ruin/unpowered)
"gs" = (
/obj/structure/stone_tile/cracked{
	dir = 8
	},
/obj/effect/spawner/random/structure/spikes,
/turf/closed/mineral/random/high_chance/volcanic,
/area/lavaland/surface/outdoors)
"hq" = (
/obj/structure/stone_tile/surrounding_tile/cracked,
/obj/structure/stone_tile/surrounding_tile/cracked{
	dir = 1
	},
/obj/structure/stone_tile/center/cracked,
/obj/effect/gibspawner/human/bodypartless,
/turf/open/indestructible/necropolis,
/area/ruin/unpowered)
"hr" = (
/obj/structure/stone_tile/surrounding/cracked{
	dir = 6
	},
/obj/item/clothing/gloves/military/claw,
/turf/closed/mineral/volcanic/lava_land_surface,
/area/lavaland/surface/outdoors)
"ic" = (
/obj/structure/stone_tile/slab/cracked{
	dir = 8
	},
/turf/open/lava/smooth/lava_land_surface,
/area/lavaland/surface/outdoors)
"ir" = (
/obj/structure/stone_tile/slab/cracked,
/turf/open/lava/smooth/lava_land_surface,
/area/ruin/unpowered)
"jc" = (
/obj/structure/stone_tile/burnt,
/obj/structure/stone_tile/cracked{
	dir = 8
	},
/obj/item/stack/sheet/runed_metal/five,
/turf/open/indestructible/necropolis,
/area/ruin/unpowered)
"jX" = (
/obj/structure/statue/bone/rib{
	pixel_y = 10
	},
/obj/structure/stone_tile/surrounding/cracked{
	dir = 8
	},
/obj/structure/stone_tile/burnt,
/turf/open/indestructible/necropolis,
/area/ruin/unpowered)
"kM" = (
/obj/structure/wall_torch/mount_only,
/turf/closed/indestructible/riveted/boss,
/area/lavaland/surface/outdoors)
"kN" = (
/obj/structure/stone_tile/cracked{
	dir = 1
	},
/turf/closed/mineral/random/high_chance/volcanic,
/area/lavaland/surface/outdoors)
"kZ" = (
/obj/structure/stone_tile/slab,
/obj/item/xenoarch/useless_relic/magnified{
	name = "Ancient relic";
	desc = "Sort of relic that can be exported through Cargo."
	},
/turf/closed/mineral/random/high_chance/volcanic,
/area/ruin/unpowered)
"lb" = (
/obj/structure/stone_tile/surrounding/burnt,
/turf/open/lava/smooth/lava_land_surface,
/area/lavaland/surface/outdoors)
"md" = (
/obj/structure/stone_tile/burnt{
	dir = 1
	},
/obj/structure/stone_tile/cracked,
/turf/open/lava/smooth/lava_land_surface,
/area/lavaland/surface/outdoors)
"mq" = (
/obj/structure/stone_tile/slab/cracked{
	dir = 10
	},
/turf/open/lava/smooth/lava_land_surface,
/area/lavaland/surface/outdoors)
"mw" = (
/obj/structure/stone_tile/surrounding/cracked{
	dir = 1
	},
/obj/item/knife/combat/bone,
/mob/living/basic/mining/ancient_demon/ancient_demon_lesser,
/turf/open/indestructible/necropolis,
/area/ruin/unpowered)
"mP" = (
/obj/structure/stone_tile/surrounding/cracked,
/obj/structure/stone_tile/center/burnt,
/turf/open/lava/smooth/lava_land_surface,
/area/lavaland/surface/outdoors)
"nq" = (
/obj/structure/stone_tile/surrounding_tile/cracked{
	dir = 1
	},
/obj/structure/stone_tile/surrounding_tile,
/obj/structure/stone_tile/surrounding_tile{
	dir = 4
	},
/obj/structure/stone_tile/surrounding_tile{
	dir = 8
	},
/obj/structure/stone_tile/center/cracked,
/obj/item/xenoarch/useless_relic{
	name = "Ancient relic";
	desc = "Sort of relic that can be exported through Cargo."
	},
/turf/closed/mineral/random/high_chance/volcanic,
/area/ruin/unpowered)
"nv" = (
/obj/structure/stone_tile/block,
/obj/effect/spawner/random/structure/spikes,
/turf/closed/mineral/volcanic/lava_land_surface,
/area/lavaland/surface/outdoors)
"nz" = (
/obj/structure/stone_tile/block/cracked{
	pixel_y = -16
	},
/obj/structure/stone_tile,
/obj/structure/stone_tile/cracked{
	dir = 8
	},
/turf/closed/mineral/random/high_chance/volcanic,
/area/ruin/unpowered)
"nT" = (
/obj/structure/stone_tile/surrounding,
/obj/structure/stone_tile/center,
/turf/closed/mineral/random/high_chance/volcanic,
/area/lavaland/surface/outdoors)
"od" = (
/obj/structure/stone_tile/surrounding/cracked{
	dir = 6
	},
/obj/structure/stone_tile/center/cracked,
/turf/closed/mineral/volcanic/lava_land_surface,
/area/lavaland/surface/outdoors)
"oe" = (
/obj/structure/stone_tile/surrounding,
/turf/closed/mineral/random/high_chance/volcanic,
/area/lavaland/surface/outdoors)
"on" = (
/obj/structure/stone_tile/block/cracked{
	dir = 4
	},
/turf/closed/mineral/volcanic/lava_land_surface,
/area/lavaland/surface/outdoors)
"oy" = (
/obj/structure/stone_tile/slab,
/obj/effect/decal/cleanable/blood/old{
	icon_state = "floor4-old"
	},
/turf/open/misc/asteroid/basalt/lava_land_surface,
/area/lavaland/surface/outdoors)
"pd" = (
/obj/structure/stone_tile/block,
/turf/closed/mineral/random/high_chance/volcanic,
/area/ruin/unpowered)
"qW" = (
/obj/structure/stone_tile/slab/cracked{
	dir = 1
	},
/turf/open/lava/smooth/lava_land_surface,
/area/lavaland/surface/outdoors)
"qX" = (
/obj/structure/stone_tile/cracked,
/turf/closed/mineral/volcanic/lava_land_surface,
/area/lavaland/surface/outdoors)
"qZ" = (
/obj/structure/stone_tile/block/cracked{
	dir = 8
	},
/obj/item/reagent_containers/cup/bowl/mushroom_bowl{
	pixel_x = 2;
	pixel_y = 4
	},
/turf/closed/mineral/volcanic/lava_land_surface,
/area/lavaland/surface/outdoors)
"sb" = (
/obj/structure/stone_tile/block/cracked{
	dir = 1
	},
/turf/closed/mineral/volcanic/lava_land_surface,
/area/lavaland/surface/outdoors)
"sx" = (
/obj/structure/stone_tile/block,
/obj/structure/stone_tile/cracked{
	dir = 4
	},
/obj/structure/stone_tile{
	dir = 1
	},
/turf/open/lava/smooth/lava_land_surface,
/area/lavaland/surface/outdoors)
"vj" = (
/obj/structure/stone_tile/block/cracked{
	dir = 1
	},
/obj/structure/stone_tile/block/burnt,
/turf/open/lava/smooth/lava_land_surface,
/area/ruin/unpowered)
"vG" = (
/obj/structure/stone_tile/cracked{
	dir = 8
	},
/obj/effect/spawner/random/structure/spikes,
/turf/closed/mineral/volcanic/lava_land_surface,
/area/lavaland/surface/outdoors)
"vQ" = (
/obj/structure/stone_tile/block/cracked{
	dir = 1
	},
/obj/effect/mob_spawn/corpse/human/miner,
/mob/living/basic/mining/ancient_demon/ancient_demon_lesser,
/turf/open/indestructible/necropolis,
/area/ruin/unpowered)
"wI" = (
/obj/structure/flora/rock/pile/style_random,
/obj/effect/spawner/random/structure/spikes,
/obj/item/hemostat/ashwalker,
/turf/closed/mineral/volcanic/lava_land_surface,
/area/lavaland/surface/outdoors)
"xj" = (
/obj/structure/stone_tile{
	dir = 8
	},
/obj/effect/spawner/random/mob/necropolis_mob,
/turf/closed/mineral/volcanic/lava_land_surface,
/area/lavaland/surface/outdoors)
"xy" = (
/obj/structure/stone_tile/slab/cracked{
	dir = 4
	},
/obj/structure/stone_tile/slab/cracked{
	dir = 1
	},
/obj/effect/decal/cleanable/blood,
/mob/living/basic/mining/ancient_demon/ancient_demon_lesser,
/turf/open/indestructible/necropolis,
/area/ruin/unpowered)
"xX" = (
/turf/closed/indestructible/riveted/boss,
/area/ruin/unpowered)
"yG" = (
/obj/structure/stone_tile/block/cracked{
	dir = 1
	},
/obj/structure/stone_tile{
	dir = 8
	},
/turf/closed/mineral/volcanic/lava_land_surface,
/area/lavaland/surface/outdoors)
"zL" = (
/obj/structure/stone_tile/cracked{
	dir = 1
	},
/turf/closed/mineral/volcanic/lava_land_surface,
/area/lavaland/surface/outdoors)
"zT" = (
/obj/structure/flora/ash/cacti,
/turf/closed/mineral/random/high_chance/volcanic,
/area/lavaland/surface/outdoors)
"Ae" = (
/turf/closed/indestructible/riveted/boss,
/area/lavaland/surface/outdoors)
"Al" = (
/obj/structure/stone_tile/block/cracked,
/turf/closed/mineral/volcanic/lava_land_surface,
/area/lavaland/surface/outdoors)
"AB" = (
/turf/template_noop,
/area/template_noop)
"AF" = (
/obj/structure/stone_tile/block/burnt,
/obj/structure/stone_tile{
	dir = 4
	},
/turf/closed/mineral/random/high_chance/volcanic,
/area/lavaland/surface/outdoors)
"AU" = (
/obj/structure/stone_tile{
	dir = 8
	},
/obj/item/xenoarch/useless_relic{
	name = "Ancient relic";
	desc = "Sort of relic that can be exported through Cargo."
	},
/turf/closed/mineral/volcanic/lava_land_surface,
/area/lavaland/surface/outdoors)
"Bp" = (
/obj/structure/stone_tile/block/cracked{
	dir = 8
	},
/turf/open/lava/smooth/lava_land_surface,
/area/lavaland/surface/outdoors)
"Bq" = (
/obj/structure/stone_tile/slab,
/obj/effect/decal/cleanable/blood/old{
	icon_state = "floor4-old"
	},
/turf/closed/mineral/random/high_chance/volcanic,
/area/ruin/unpowered)
"BB" = (
/obj/structure/stone_tile/slab,
/obj/effect/spawner/random/mob/necropolis_mob,
/turf/open/misc/asteroid/basalt/lava_land_surface,
/area/lavaland/surface/outdoors)
"BV" = (
/obj/structure/stone_tile/slab/cracked,
/obj/item/xenoarch/useless_relic{
	name = "Ancient relic";
	desc = "Sort of relic that can be exported through Cargo."
	},
/turf/closed/mineral/random/high_chance/volcanic,
/area/ruin/unpowered)
"Cd" = (
/obj/structure/flora/rock/pile/style_random,
/turf/closed/mineral/volcanic/lava_land_surface,
/area/lavaland/surface/outdoors)
"Cj" = (
/obj/structure/stone_tile,
/obj/effect/spawner/random/mob/necropolis_mob,
/obj/effect/spawner/random/structure/orevein_longregen,
/turf/closed/mineral/volcanic/lava_land_surface,
/area/lavaland/surface/outdoors)
"Ck" = (
/obj/structure/stone_tile/cracked{
	dir = 8
	},
/turf/closed/mineral/random/high_chance/volcanic,
/area/lavaland/surface/outdoors)
"Cq" = (
/turf/open/lava/smooth/lava_land_surface,
/area/lavaland/surface/outdoors)
"CV" = (
/obj/structure/flora/rock/pile/style_random,
/obj/effect/spawner/random/structure/spikes,
/turf/closed/mineral/volcanic/lava_land_surface,
/area/lavaland/surface/outdoors)
"DD" = (
/obj/structure/stone_tile/slab/cracked,
/turf/open/lava/smooth/lava_land_surface,
/area/lavaland/surface/outdoors)
"DR" = (
/obj/structure/stone_tile/block/cracked{
	dir = 8
	},
/turf/closed/mineral/volcanic/lava_land_surface,
/area/lavaland/surface/outdoors)
"DT" = (
/obj/structure/flora/rock/pile/style_random,
/obj/effect/spawner/random/mob/necropolis_mob,
/turf/closed/mineral/volcanic/lava_land_surface,
/area/lavaland/surface/outdoors)
"EP" = (
/obj/structure/flora/rock/pile/style_random,
/obj/item/clothing/shoes/wraps/ashwalker,
/turf/closed/mineral/volcanic/lava_land_surface,
/area/lavaland/surface/outdoors)
"ER" = (
/obj/structure/stone_tile/block,
/obj/structure/stone_tile/cracked{
	dir = 4
	},
/obj/effect/spawner/random/mob/necropolis_mob,
/turf/open/misc/asteroid/basalt/lava_land_surface,
/area/lavaland/surface/outdoors)
"EY" = (
/obj/structure/stone_tile/slab,
/turf/closed/mineral/random/high_chance/volcanic,
/area/ruin/unpowered)
"Fo" = (
/obj/effect/mapping_helpers/bombable_wall,
/obj/structure/statue/bone/rib{
	dir = 1;
	pixel_y = 10
	},
/turf/closed/indestructible/riveted/boss/wasteland,
/area/ruin/unpowered)
"FN" = (
/obj/structure/stone_tile/cracked{
	dir = 4
	},
/obj/item/xenoarch/useless_relic{
	name = "Ancient relic";
	desc = "Sort of relic that can be exported through Cargo."
	},
/turf/closed/mineral/volcanic/lava_land_surface,
/area/lavaland/surface/outdoors)
"GW" = (
/obj/structure/stone_tile/surrounding/cracked,
/obj/structure/stone_tile/center/cracked,
/obj/effect/mob_spawn/corpse/human/blood_cultist,
/mob/living/basic/mining/ancient_demon,
/turf/open/indestructible/necropolis,
/area/ruin/unpowered)
"HM" = (
/obj/structure/stone_tile/cracked,
/turf/open/lava/smooth/lava_land_surface,
/area/lavaland/surface/outdoors)
"HV" = (
/obj/structure/stone_tile,
/obj/effect/spawner/random/structure/spikes,
/turf/closed/mineral/volcanic/lava_land_surface,
/area/lavaland/surface/outdoors)
"IF" = (
/obj/structure/stone_tile/block/cracked,
/turf/closed/mineral/random/high_chance/volcanic,
/area/lavaland/surface/outdoors)
"IN" = (
/obj/structure/stone_tile/surrounding/cracked{
	dir = 1
	},
/obj/structure/stone_tile/surrounding/cracked,
/turf/closed/mineral/random/high_chance/volcanic,
/area/ruin/unpowered)
"JQ" = (
/obj/structure/stone_tile/block/burnt,
/obj/structure/stone_tile/burnt{
	dir = 4
	},
/obj/structure/stone_tile/cracked{
	dir = 1
	},
/turf/open/lava/smooth/lava_land_surface,
/area/lavaland/surface/outdoors)
"KL" = (
/obj/structure/stone_tile/slab/burnt,
/turf/open/lava/smooth/lava_land_surface,
/area/lavaland/surface/outdoors)
"KR" = (
/obj/structure/stone_tile/block/cracked{
	dir = 8
	},
/turf/closed/mineral/random/high_chance/volcanic,
/area/lavaland/surface/outdoors)
"Ls" = (
/obj/effect/mapping_helpers/bombable_wall,
/turf/closed/indestructible/riveted/boss/wasteland,
/area/ruin/unpowered)
"LY" = (
/obj/structure/stone_tile/block/cracked{
	dir = 1
	},
/obj/structure/stone_tile/cracked{
	dir = 8
	},
/turf/open/lava/smooth/lava_land_surface,
/area/ruin/unpowered)
"MV" = (
/obj/structure/stone_tile/block/cracked{
	dir = 4
	},
/turf/closed/mineral/strange_rock,
/area/lavaland/surface/outdoors)
"Nm" = (
/obj/structure/stone_tile/block,
/obj/structure/stone_tile/cracked{
	dir = 1
	},
/turf/closed/mineral/random/high_chance/volcanic,
/area/lavaland/surface/outdoors)
"NA" = (
/obj/structure/statue/bone/rib{
	dir = 1;
	pixel_y = 10
	},
/obj/structure/stone_tile/surrounding/cracked{
	dir = 6
	},
/turf/open/indestructible/necropolis,
/area/ruin/unpowered)
"NG" = (
/obj/structure/stone_tile/slab/cracked,
/obj/effect/gibspawner/human/bodypartless,
/mob/living/basic/mining/ancient_demon,
/turf/open/indestructible/necropolis,
/area/ruin/unpowered)
"Pv" = (
/obj/structure/stone_tile/surrounding/cracked,
/obj/structure/stone_tile/center/burnt,
/obj/effect/gibspawner/human/bodypartless,
/turf/open/indestructible/necropolis,
/area/ruin/unpowered)
"Qa" = (
/obj/structure/stone_tile/slab,
/turf/closed/mineral/random/high_chance/volcanic,
/area/lavaland/surface/outdoors)
"Qb" = (
/obj/structure/stone_tile/burnt,
/turf/open/lava/smooth/lava_land_surface,
/area/lavaland/surface/outdoors)
"Qc" = (
/obj/structure/stone_tile/cracked{
	dir = 4
	},
/turf/open/lava/smooth/lava_land_surface,
/area/lavaland/surface/outdoors)
"Sm" = (
/obj/structure/stone_tile/block/cracked{
	dir = 1
	},
/obj/effect/spawner/random/mob/necropolis_mob,
/turf/closed/mineral/volcanic/lava_land_surface,
/area/lavaland/surface/outdoors)
"Tp" = (
/obj/structure/stone_tile/block/cracked,
/turf/open/lava/smooth/lava_land_surface,
/area/lavaland/surface/outdoors)
"Uk" = (
/obj/structure/stone_tile/slab/cracked{
	dir = 1
	},
/turf/open/lava/smooth/lava_land_surface,
/area/ruin/unpowered)
"Um" = (
/obj/structure/stone_tile/cracked{
	dir = 1
	},
/obj/structure/flora/ash/seraka,
/obj/item/xenoarch/useless_relic{
	name = "Ancient relic";
	desc = "Sort of relic that can be exported through Cargo."
	},
/turf/closed/mineral/random/high_chance/volcanic,
/area/ruin/unpowered)
"UN" = (
/obj/structure/stone_tile/block/cracked{
	dir = 8
	},
/obj/effect/gibspawner/human/bodypartless,
/turf/open/misc/asteroid/basalt/lava_land_surface,
/area/ruin/unpowered)
"Vk" = (
/obj/structure/stone_tile/burnt,
/turf/open/lava/smooth/lava_land_surface,
/area/ruin/unpowered)
"VD" = (
/obj/structure/stone_tile/cracked{
	dir = 1
	},
/obj/item/flashlight/flare/torch,
/obj/effect/spawner/random/mob/necropolis_mob,
/turf/closed/mineral/volcanic/lava_land_surface,
/area/lavaland/surface/outdoors)
"WI" = (
/obj/structure/stone_tile/cracked{
	dir = 8
	},
/obj/item/xenoarch/useless_relic{
	name = "Ancient relic";
	desc = "Sort of relic that can be exported through Cargo."
	},
/turf/closed/mineral/random/high_chance/volcanic,
/area/lavaland/surface/outdoors)
"Ya" = (
/obj/structure/stone_tile/block{
	dir = 8
	},
/turf/closed/mineral/strange_rock,
/area/lavaland/surface/outdoors)
"Zj" = (
/obj/structure/flora/rock/pile/style_random,
/turf/closed/mineral/random/high_chance/volcanic,
/area/lavaland/surface/outdoors)
"Zy" = (
/obj/structure/stone_tile/burnt,
/turf/closed/mineral/volcanic/lava_land_surface,
/area/lavaland/surface/outdoors)

(1,1,1) = {"
AB
AB
AB
AB
FN
xj
CV
AB
Ae
Ae
AB
AB
Ae
Ae
vG
Cd
AB
Ae
Ck
AB
AB
AB
AB
AB
"}
(2,1,1) = {"
AB
xX
xX
Ls
xX
xX
gs
wI
Ae
Ae
Ae
AB
Ae
Ae
Ae
AB
AB
Ae
Ae
AU
AB
Ae
AB
AB
"}
(3,1,1) = {"
Ae
xX
xX
EY
xX
xX
xX
Ae
cI
Ae
ce
nv
fD
Ae
Ae
AB
Sm
Ae
ce
qX
fC
Ae
Ae
AB
"}
(4,1,1) = {"
Ae
xX
NA
xy
hq
xX
Fo
Qb
Cq
AB
AB
qZ
kN
MV
AB
AB
Zj
zL
md
Bp
Zj
on
dL
AB
"}
(5,1,1) = {"
bD
xX
NG
cs
vQ
pd
Vk
Cq
kM
AB
AB
Ae
Al
AB
AB
Ae
IF
Cq
ic
kM
WI
zT
DT
kM
"}
(6,1,1) = {"
AB
Ls
jc
mw
Pv
Bq
LY
KL
bR
AB
Nm
nT
ER
AB
AB
mP
eW
JQ
KL
hr
bE
nv
AB
AB
"}
(7,1,1) = {"
AB
xX
eK
GW
fL
vj
ir
oy
AB
AB
AF
od
AB
AB
Qa
lb
DD
sx
BB
oe
yG
AB
AB
AB
"}
(8,1,1) = {"
AB
xX
jX
IN
nz
Uk
UN
AB
kM
AB
VD
Ae
DD
Zj
kN
kM
mq
CV
sb
Ae
AB
AB
AB
ce
"}
(9,1,1) = {"
Ae
xX
Um
kZ
nq
xX
xX
AB
AB
DR
am
EP
Qc
ej
bc
eh
Qc
KR
Ya
gs
AB
AB
AB
AB
"}
(10,1,1) = {"
Ae
xX
xX
BV
Ls
xX
xX
AB
AB
Ae
Ae
Tp
br
ce
ce
qW
Cd
Ae
Ae
AB
AB
Ae
Ae
AB
"}
(11,1,1) = {"
AB
xX
Ls
Ls
xX
xX
dL
AB
Ae
Ae
ce
HM
ce
Ae
Ae
Zy
AB
Ae
ce
AB
AB
Ae
AB
AB
"}
(12,1,1) = {"
AB
AB
AB
AB
zL
HV
AB
AB
Ae
Ae
cC
dr
Ae
Ae
Cj
AB
AB
ce
AB
AB
AB
AB
AB
AB
"}
