//MAP CONVERTED BY dmm2tgm.py THIS HEADER COMMENT PREVENTS RECONVERSION, DO NOT REMOVE
"a" = (
/turf/open/indestructible/hierophant,
/area/ruin/unpowered/hierophant)
"b" = (
/obj/effect/mapping_helpers/bombable_wall,
/turf/closed/indestructible/riveted/boss/wasteland,
/area/lavaland/surface/outdoors)
"j" = (
/turf/closed/indestructible/riveted/hierophant,
/area/ruin/unpowered/hierophant)
"m" = (
/turf/closed/indestructible/riveted/boss,
/area/ruin/unpowered/hierophant)
"n" = (
/obj/effect/spawner/random/entertainment/coin{
	pixel_x = 8;
	pixel_y = -9
	},
/turf/open/indestructible/hierophant,
/area/ruin/unpowered/hierophant)
"t" = (
/obj/effect/light_emitter{
	set_cap = 3;
	set_luminosity = 5
	},
/turf/open/indestructible/hierophant/two,
/area/ruin/unpowered/hierophant)
"u" = (
/mob/living/simple_animal/hostile/megafauna/hierophant{
	speed = 3;
	melee_damage_upper = 30;
	major_attack_cooldown = 30;
	ranged_cooldown_time = 20;
	health = 1800;
	maxHealth = 1800
	},
/turf/open/indestructible/hierophant/two,
/area/ruin/unpowered/hierophant)
"D" = (
/turf/template_noop,
/area/template_noop)
"G" = (
/obj/structure/flora/rock/pile/style_random,
/obj/effect/spawner/random/structure/orevein_longregen,
/turf/open/misc/asteroid/basalt/lava_land_surface,
/area/lavaland/surface/outdoors)
"J" = (
/obj/effect/mapping_helpers/bombable_wall,
/turf/closed/indestructible/riveted/boss/wasteland,
/area/ruin/unpowered/hierophant)
"M" = (
/obj/effect/spawner/random/entertainment/coin{
	pixel_x = -9;
	pixel_y = 5
	},
/turf/open/indestructible/hierophant,
/area/ruin/unpowered/hierophant)
"R" = (
/turf/open/indestructible/hierophant/two,
/area/ruin/unpowered/hierophant)
"U" = (
/turf/closed/indestructible/riveted/boss,
/area/lavaland/surface/outdoors)

(1,1,1) = {"
D
D
D
D
D
D
D
U
U
U
U
U
U
U
U
U
D
D
D
D
D
D
D
"}
(2,1,1) = {"
D
U
U
D
D
D
a
m
j
j
j
j
j
j
j
J
D
a
D
D
b
U
D
"}
(3,1,1) = {"
D
U
U
D
D
a
a
a
n
a
a
a
a
a
a
a
D
a
a
a
U
U
D
"}
(4,1,1) = {"
D
D
D
D
D
D
D
a
j
a
a
a
a
a
j
D
D
D
a
a
D
D
D
"}
(5,1,1) = {"
D
D
D
a
j
j
D
D
a
a
a
j
a
a
G
D
a
j
j
a
D
D
D
"}
(6,1,1) = {"
D
a
D
D
j
j
a
D
a
a
a
a
a
a
a
a
a
j
j
a
D
a
D
"}
(7,1,1) = {"
D
a
a
D
D
a
R
D
D
j
R
R
R
j
R
j
R
a
a
D
D
a
D
"}
(8,1,1) = {"
U
m
a
a
D
D
R
j
D
j
R
R
R
j
R
R
D
D
D
D
a
m
U
"}
(9,1,1) = {"
U
j
a
a
D
a
R
R
R
R
R
j
R
R
R
R
R
a
D
a
a
j
U
"}
(10,1,1) = {"
U
j
a
j
a
a
j
j
R
R
R
t
R
R
R
j
j
a
a
j
a
j
U
"}
(11,1,1) = {"
U
j
a
a
a
a
R
R
R
R
R
R
R
R
R
R
R
a
a
a
a
j
U
"}
(12,1,1) = {"
U
j
a
a
j
a
R
R
j
t
R
u
R
t
j
R
R
a
j
a
a
j
U
"}
(13,1,1) = {"
U
j
a
a
a
a
R
R
R
R
R
R
R
R
R
R
R
a
a
a
a
j
U
"}
(14,1,1) = {"
U
j
a
j
D
a
j
j
R
R
R
t
R
R
R
j
j
a
a
j
a
j
U
"}
(15,1,1) = {"
U
j
a
D
D
a
R
R
R
R
R
j
R
R
R
R
R
a
a
a
a
j
U
"}
(16,1,1) = {"
U
m
a
D
a
a
D
j
R
j
R
R
R
j
R
j
D
a
a
a
a
J
U
"}
(17,1,1) = {"
D
a
D
D
D
D
D
D
R
j
R
R
R
j
R
R
D
D
a
D
a
a
D
"}
(18,1,1) = {"
D
a
D
D
j
j
a
a
a
a
a
a
a
D
D
a
D
j
j
D
D
a
D
"}
(19,1,1) = {"
D
D
D
a
j
j
a
a
a
a
a
j
a
a
D
D
D
j
j
M
D
D
D
"}
(20,1,1) = {"
D
D
D
a
a
a
a
a
j
a
a
a
a
a
j
D
D
a
a
D
D
D
D
"}
(21,1,1) = {"
D
U
b
a
a
a
D
G
a
a
a
a
a
a
a
a
D
D
D
D
U
U
D
"}
(22,1,1) = {"
D
U
U
D
D
a
D
J
j
j
j
j
j
j
j
m
a
a
D
D
U
U
D
"}
(23,1,1) = {"
D
D
D
D
D
D
D
U
U
U
U
U
U
U
U
U
D
D
D
D
D
D
D
"}
