//MAP CONVERTED BY dmm2tgm.py THIS HEADER COMMENT PREVENTS RECONVERSION, DO NOT REMOVE
"ak" = (
/obj/structure/stone_tile{
	dir = 1
	},
/obj/structure/stone_tile{
	dir = 4
	},
/obj/structure/stone_tile,
/turf/open/misc/asteroid/basalt/lava_land_surface,
/area/lavaland/surface/outdoors)
"aq" = (
/obj/item/xenoarch/useless_relic{
	name = "Ancient relic";
	desc = "Sort of relic that can be exported through Cargo."
	},
/turf/closed/mineral/volcanic/lava_land_surface,
/area/lavaland/surface/outdoors)
"bO" = (
/obj/structure/stone_tile{
	dir = 8
	},
/obj/structure/stone_tile,
/obj/structure/stone_tile{
	dir = 1
	},
/turf/open/misc/asteroid/basalt/lava_land_surface,
/area/lavaland/surface/outdoors)
"bU" = (
/mob/living/basic/mining/legion,
/obj/structure/stone_tile/slab,
/turf/closed/mineral/volcanic/lava_land_surface,
/area/lavaland/surface/outdoors)
"bV" = (
/obj/structure/stone_tile,
/obj/structure/stone_tile{
	dir = 8
	},
/obj/structure/stone_tile{
	dir = 1
	},
/turf/open/misc/asteroid/basalt/lava_land_surface,
/area/lavaland/surface/outdoors)
"cp" = (
/obj/structure/stone_tile/slab/cracked{
	dir = 4
	},
/obj/structure/stone_tile/slab/cracked{
	dir = 8
	},
/turf/closed/mineral/volcanic/lava_land_surface,
/area/lavaland/surface/outdoors)
"cP" = (
/obj/structure/trap/damage{
	name = "Anctient runic spikes";
	desc = "A strange carving of some symbols. What's that for?";
	icon = 'icons/obj/service/hydroponics/equipment.dmi';
	icon_state = "woodspike";
	light_color = "#DDFFDD";
	color = "#77FF77";
	alpha = 180
	},
/turf/closed/mineral/volcanic/lava_land_surface,
/area/lavaland/surface/outdoors)
"cR" = (
/obj/structure/stone_tile,
/obj/structure/stone_tile{
	dir = 1
	},
/turf/open/misc/asteroid/basalt/lava_land_surface,
/area/lavaland/surface/outdoors)
"dB" = (
/obj/structure/stone_tile/slab/cracked{
	dir = 6
	},
/turf/open/lava/smooth/lava_land_surface,
/area/lavaland/surface/outdoors)
"dP" = (
/obj/structure/stone_tile/slab,
/turf/closed/mineral/strange_rock/volcanic,
/area/lavaland/surface/outdoors)
"fi" = (
/obj/structure/stone_tile/slab,
/turf/open/lava/smooth/lava_land_surface,
/area/template_noop)
"fn" = (
/obj/effect/mapping_helpers/bombable_wall,
/turf/closed/indestructible/riveted/boss/wasteland,
/area/lavaland/surface/outdoors)
"fA" = (
/obj/structure/stone_tile/surrounding/burnt,
/obj/structure/stone_tile/center/burnt,
/turf/open/lava/smooth/lava_land_surface,
/area/lavaland/surface/outdoors)
"fB" = (
/obj/structure/stone_tile/slab/burnt,
/turf/open/lava/smooth/lava_land_surface,
/area/lavaland/surface/outdoors)
"fJ" = (
/turf/closed/mineral/random/high_chance/volcanic,
/area/lavaland/surface/outdoors)
"gq" = (
/obj/structure/stone_tile/slab/cracked{
	dir = 4
	},
/obj/structure/stone_tile/slab/cracked{
	dir = 1
	},
/turf/closed/mineral/random/high_chance/volcanic,
/area/lavaland/surface/outdoors)
"hq" = (
/obj/item/clothing/gloves/bracer,
/obj/structure/stone_tile/slab,
/mob/living/basic/mining/lobstrosity/lava,
/mob/living/basic/mining/lobstrosity/lava,
/mob/living/basic/mining/lobstrosity/lava,
/turf/closed/mineral/volcanic/lava_land_surface,
/area/lavaland/surface/outdoors)
"kb" = (
/obj/structure/stone_tile/slab/cracked{
	dir = 4
	},
/turf/open/lava/smooth/lava_land_surface,
/area/lavaland/surface/outdoors)
"kZ" = (
/obj/structure/stone_tile/slab,
/obj/item/xenoarch/useless_relic{
	name = "Ancient relic";
	desc = "Sort of relic that can be exported through Cargo."
	},
/turf/closed/mineral/random/high_chance/volcanic,
/area/lavaland/surface/outdoors)
"mz" = (
/obj/structure/stone_tile{
	dir = 8
	},
/obj/structure/stone_tile{
	dir = 4
	},
/turf/closed/mineral/volcanic/lava_land_surface,
/area/lavaland/surface/outdoors)
"mN" = (
/obj/structure/stone_tile/slab/cracked{
	dir = 6
	},
/turf/closed/mineral/random/high_chance/volcanic,
/area/lavaland/surface/outdoors)
"mV" = (
/obj/structure/stone_tile/block{
	dir = 8
	},
/obj/structure/stone_tile/block/cracked{
	dir = 4
	},
/turf/closed/mineral/volcanic/lava_land_surface,
/area/lavaland/surface/outdoors)
"pM" = (
/obj/structure/stone_tile/surrounding/cracked,
/turf/closed/mineral/volcanic/lava_land_surface,
/area/lavaland/surface/outdoors)
"qj" = (
/obj/structure/stone_tile/surrounding_tile{
	dir = 8
	},
/obj/structure/stone_tile/surrounding_tile{
	dir = 1
	},
/obj/structure/stone_tile/center/cracked,
/turf/closed/mineral/random/high_chance/volcanic,
/area/lavaland/surface/outdoors)
"qk" = (
/obj/structure/stone_tile/block{
	dir = 4
	},
/obj/structure/stone_tile/block/burnt{
	dir = 8
	},
/turf/open/misc/asteroid/basalt/lava_land_surface,
/area/lavaland/surface/outdoors)
"qt" = (
/obj/structure/stone_tile/slab/cracked,
/turf/closed/mineral/volcanic/lava_land_surface,
/area/lavaland/surface/outdoors)
"qy" = (
/obj/structure/flora/rock/pile/style_random,
/turf/open/misc/asteroid/basalt/lava_land_surface,
/area/lavaland/surface/outdoors)
"qV" = (
/turf/open/lava/smooth/lava_land_surface,
/area/lavaland/surface/outdoors)
"rx" = (
/obj/structure/stone_tile/slab/cracked{
	dir = 4
	},
/obj/structure/stone_tile/slab/cracked{
	dir = 1
	},
/turf/open/lava/smooth/lava_land_surface,
/area/lavaland/surface/outdoors)
"ry" = (
/obj/structure/stone_tile/slab/cracked{
	dir = 1
	},
/turf/closed/indestructible/riveted/boss,
/area/lavaland/surface/outdoors)
"rE" = (
/obj/structure/stone_tile/block/cracked{
	dir = 1
	},
/turf/open/misc/asteroid/basalt/lava_land_surface,
/area/lavaland/surface/outdoors)
"rX" = (
/obj/structure/stone_tile/block{
	dir = 1
	},
/obj/structure/stone_tile/block/cracked,
/turf/closed/mineral/volcanic/lava_land_surface,
/area/lavaland/surface/outdoors)
"sd" = (
/obj/structure/stone_tile/surrounding/cracked{
	dir = 1
	},
/turf/open/lava/smooth/lava_land_surface,
/area/lavaland/surface/outdoors)
"sm" = (
/obj/structure/stone_tile/slab/cracked{
	dir = 4
	},
/obj/structure/stone_tile/slab/cracked{
	dir = 1
	},
/mob/living/basic/mining/brimdemon,
/turf/open/misc/asteroid/basalt/lava_land_surface,
/area/lavaland/surface/outdoors)
"sn" = (
/obj/structure/stone_tile/block/cracked,
/obj/structure/punji_sticks/spikes,
/turf/open/misc/asteroid/basalt/lava_land_surface,
/area/lavaland/surface/outdoors)
"sS" = (
/obj/structure/stone_tile/slab,
/turf/closed/mineral/volcanic/lava_land_surface,
/area/lavaland/surface/outdoors)
"tc" = (
/obj/structure/trap/damage{
	name = "Anctient runic spikes";
	desc = "A strange carving of some symbols. What's that for?";
	icon = 'icons/obj/service/hydroponics/equipment.dmi';
	icon_state = "woodspike";
	light_color = "#DDFFDD";
	color = "#77FF77";
	alpha = 180
	},
/turf/closed/mineral/random/high_chance/volcanic,
/area/lavaland/surface/outdoors)
"tz" = (
/obj/structure/stone_tile/slab,
/turf/closed/mineral/random/high_chance/volcanic,
/area/lavaland/surface/outdoors)
"tH" = (
/obj/structure/stone_tile/slab/cracked,
/obj/item/xenoarch/useless_relic{
	name = "Ancient relic";
	desc = "Sort of relic that can be exported through Cargo."
	},
/turf/closed/mineral/volcanic/lava_land_surface,
/area/lavaland/surface/outdoors)
"uh" = (
/obj/structure/stone_tile{
	dir = 8
	},
/obj/structure/stone_tile{
	dir = 1
	},
/obj/structure/stone_tile{
	dir = 4
	},
/turf/open/misc/asteroid/basalt/lava_land_surface,
/area/lavaland/surface/outdoors)
"uY" = (
/mob/living/basic/mining/goliath,
/obj/structure/stone_tile/slab,
/turf/closed/mineral/volcanic/lava_land_surface,
/area/lavaland/surface/outdoors)
"wI" = (
/obj/structure/stone_tile/slab,
/obj/item/xenoarch/useless_relic/magnified{
	name = "Ancient relic";
	desc = "Sort of relic that can be exported through Cargo."
	},
/turf/closed/mineral/random/high_chance/volcanic,
/area/lavaland/surface/outdoors)
"wU" = (
/obj/structure/stone_tile/slab,
/obj/structure/stone_tile/block/cracked,
/turf/open/lava/smooth/lava_land_surface,
/area/lavaland/surface/outdoors)
"xb" = (
/obj/structure/stone_tile/slab/cracked{
	dir = 4
	},
/obj/structure/stone_tile/slab/cracked{
	dir = 8
	},
/obj/item/xenoarch/useless_relic/magnified{
	name = "Ancient relic";
	desc = "Sort of relic that can be exported through Cargo."
	},
/turf/open/misc/asteroid/basalt/lava_land_surface,
/area/lavaland/surface/outdoors)
"xQ" = (
/obj/structure/stone_tile/surrounding_tile{
	dir = 1
	},
/obj/structure/stone_tile/surrounding_tile{
	dir = 8
	},
/obj/structure/stone_tile/center/cracked,
/turf/closed/mineral/random/high_chance/volcanic,
/area/lavaland/surface/outdoors)
"zW" = (
/obj/structure/flora/rock/pile/style_random,
/turf/closed/mineral/volcanic/lava_land_surface,
/area/lavaland/surface/outdoors)
"AK" = (
/obj/structure/stone_tile/slab/cracked{
	dir = 6
	},
/mob/living/basic/mining/lobstrosity/lava,
/mob/living/basic/mining/lobstrosity/lava,
/turf/open/misc/asteroid/basalt/lava_land_surface,
/area/lavaland/surface/outdoors)
"AX" = (
/obj/structure/stone_tile/slab/cracked{
	dir = 6
	},
/turf/closed/mineral/volcanic/lava_land_surface,
/area/lavaland/surface/outdoors)
"Be" = (
/obj/structure/stone_tile{
	dir = 8
	},
/obj/structure/stone_tile{
	dir = 1
	},
/obj/structure/stone_tile{
	dir = 4
	},
/obj/structure/stone_tile/cracked,
/turf/open/misc/asteroid/basalt/lava_land_surface,
/area/lavaland/surface/outdoors)
"BF" = (
/obj/structure/trap/fire{
	name = "Anctient runic spikes";
	desc = "A strange carving of some symbols. What's that for?";
	alpha = 180;
	icon = 'icons/obj/service/hydroponics/equipment.dmi';
	icon_state = "woodspike";
	light_color = "#FF1111";
	color = "#FF1111"
	},
/turf/closed/mineral/random/high_chance/volcanic,
/area/lavaland/surface/outdoors)
"BI" = (
/obj/structure/stone_tile/surrounding/cracked{
	dir = 6
	},
/obj/structure/stone_tile/center/cracked,
/turf/closed/mineral/volcanic/lava_land_surface,
/area/lavaland/surface/outdoors)
"Cy" = (
/obj/structure/stone_tile/slab,
/obj/item/coin/silver,
/turf/closed/mineral/volcanic/lava_land_surface,
/area/lavaland/surface/outdoors)
"Dl" = (
/obj/structure/punji_sticks/spikes,
/turf/closed/mineral/strange_rock/volcanic,
/area/lavaland/surface/outdoors)
"Dq" = (
/obj/structure/flora/rock/pile/style_random,
/mob/living/basic/mining/lobstrosity/lava,
/turf/open/misc/asteroid/basalt/lava_land_surface,
/area/lavaland/surface/outdoors)
"Ec" = (
/obj/structure/stone_tile/surrounding/cracked,
/turf/open/lava/smooth/lava_land_surface,
/area/lavaland/surface/outdoors)
"Fl" = (
/obj/item/reagent_containers/cup/bowl/wood_bowl,
/obj/structure/stone_tile/slab,
/turf/closed/mineral/volcanic/lava_land_surface,
/area/lavaland/surface/outdoors)
"FB" = (
/obj/structure/stone_tile{
	dir = 8
	},
/obj/structure/stone_tile{
	dir = 1
	},
/obj/structure/stone_tile{
	dir = 4
	},
/turf/closed/mineral/random/high_chance/volcanic,
/area/lavaland/surface/outdoors)
"FQ" = (
/obj/structure/stone_tile/slab,
/turf/open/lava/smooth/lava_land_surface,
/area/lavaland/surface/outdoors)
"Gn" = (
/obj/structure/stone_tile{
	dir = 8
	},
/obj/structure/stone_tile{
	dir = 1
	},
/obj/structure/stone_tile/cracked{
	dir = 4
	},
/turf/open/misc/asteroid/basalt/lava_land_surface,
/area/lavaland/surface/outdoors)
"GB" = (
/obj/structure/stone_tile/slab/cracked{
	dir = 4
	},
/mob/living/basic/mining/lobstrosity/lava,
/turf/open/misc/asteroid/basalt/lava_land_surface,
/area/lavaland/surface/outdoors)
"GY" = (
/turf/closed/indestructible/riveted/boss,
/area/lavaland/surface/outdoors)
"Hb" = (
/obj/structure/stone_tile/block{
	dir = 4
	},
/turf/closed/mineral/volcanic/lava_land_surface,
/area/lavaland/surface/outdoors)
"Ib" = (
/obj/structure/punji_sticks/spikes,
/turf/closed/mineral/volcanic/lava_land_surface,
/area/lavaland/surface/outdoors)
"Id" = (
/obj/structure/stone_tile,
/obj/structure/stone_tile{
	dir = 8
	},
/obj/structure/stone_tile{
	dir = 4
	},
/turf/closed/mineral/volcanic/lava_land_surface,
/area/lavaland/surface/outdoors)
"Ih" = (
/obj/item/kitchen/spoon,
/obj/structure/stone_tile/slab,
/turf/closed/mineral/volcanic/lava_land_surface,
/area/lavaland/surface/outdoors)
"II" = (
/obj/structure/punji_sticks/spikes,
/turf/closed/mineral/random/high_chance/volcanic,
/area/lavaland/surface/outdoors)
"IL" = (
/obj/structure/stone_tile{
	dir = 8
	},
/obj/structure/stone_tile{
	dir = 4
	},
/turf/open/misc/asteroid/basalt/lava_land_surface,
/area/lavaland/surface/outdoors)
"IS" = (
/obj/structure/stone_tile/slab/cracked,
/turf/open/misc/asteroid/basalt/lava_land_surface,
/area/lavaland/surface/outdoors)
"JQ" = (
/obj/structure/stone_tile/block/cracked{
	dir = 1
	},
/turf/closed/mineral/volcanic/lava_land_surface,
/area/lavaland/surface/outdoors)
"Kx" = (
/obj/structure/stone_tile{
	dir = 8
	},
/obj/structure/stone_tile{
	dir = 4
	},
/obj/structure/stone_tile{
	dir = 1
	},
/turf/open/misc/asteroid/basalt/lava_land_surface,
/area/lavaland/surface/outdoors)
"KD" = (
/obj/structure/stone_tile{
	dir = 8
	},
/obj/structure/stone_tile{
	dir = 1
	},
/obj/structure/stone_tile/cracked,
/turf/closed/mineral/volcanic/lava_land_surface,
/area/lavaland/surface/outdoors)
"KE" = (
/turf/closed/mineral/strange_rock/volcanic,
/area/lavaland/surface/outdoors)
"La" = (
/obj/structure/stone_tile/surrounding/cracked{
	dir = 4
	},
/turf/open/lava/smooth/lava_land_surface,
/area/lavaland/surface/outdoors)
"LE" = (
/obj/structure/trap/fire{
	name = "Anctient runic spikes";
	desc = "A strange carving of some symbols. What's that for?";
	alpha = 180;
	icon = 'icons/obj/service/hydroponics/equipment.dmi';
	icon_state = "woodspike";
	light_color = "#FF1111";
	color = "#FF1111"
	},
/turf/closed/mineral/volcanic/lava_land_surface,
/area/lavaland/surface/outdoors)
"LN" = (
/obj/structure/stone_tile,
/obj/structure/stone_tile{
	dir = 8
	},
/obj/structure/stone_tile{
	dir = 1
	},
/obj/structure/punji_sticks/spikes,
/turf/closed/mineral/volcanic/lava_land_surface,
/area/lavaland/surface/outdoors)
"Mk" = (
/obj/structure/stone_tile/slab/cracked{
	dir = 6
	},
/turf/open/misc/asteroid/basalt/lava_land_surface,
/area/lavaland/surface/outdoors)
"Mt" = (
/obj/structure/flora/rock/pile/style_random,
/mob/living/basic/mining/brimdemon,
/turf/open/misc/asteroid/basalt/lava_land_surface,
/area/lavaland/surface/outdoors)
"MO" = (
/obj/structure/stone_tile/slab,
/turf/open/misc/asteroid/basalt/lava_land_surface,
/area/lavaland/surface/outdoors)
"MX" = (
/obj/structure/stone_tile/slab,
/obj/item/coin/silver,
/turf/closed/mineral/random/high_chance/volcanic,
/area/lavaland/surface/outdoors)
"Ng" = (
/obj/structure/stone_tile{
	dir = 8
	},
/obj/structure/stone_tile/burnt,
/turf/closed/mineral/volcanic/lava_land_surface,
/area/lavaland/surface/outdoors)
"Nm" = (
/obj/structure/stone_tile{
	dir = 8
	},
/obj/structure/stone_tile{
	dir = 4
	},
/turf/closed/mineral/random/high_chance/volcanic,
/area/lavaland/surface/outdoors)
"NM" = (
/obj/structure/stone_tile/slab,
/obj/item/coin/silver/doubloon,
/turf/closed/mineral/random/high_chance/volcanic,
/area/lavaland/surface/outdoors)
"OD" = (
/obj/structure/stone_tile/slab/cracked,
/mob/living/basic/mining/brimdemon,
/turf/open/misc/asteroid/basalt/lava_land_surface,
/area/lavaland/surface/outdoors)
"Pj" = (
/obj/structure/stone_tile/surrounding_tile{
	dir = 4
	},
/obj/structure/stone_tile/surrounding_tile,
/obj/structure/stone_tile/center,
/turf/closed/mineral/volcanic/lava_land_surface,
/area/lavaland/surface/outdoors)
"Pm" = (
/obj/item/reagent_containers/cup/bowl/wood_bowl,
/obj/structure/stone_tile/slab,
/turf/closed/mineral/random/high_chance/volcanic,
/area/lavaland/surface/outdoors)
"QN" = (
/obj/structure/stone_tile/block{
	dir = 1
	},
/obj/structure/stone_tile/block,
/turf/open/misc/asteroid/basalt/lava_land_surface,
/area/lavaland/surface/outdoors)
"Rd" = (
/obj/structure/flora/rock/pile/style_random,
/turf/closed/mineral/random/high_chance/volcanic,
/area/lavaland/surface/outdoors)
"Rs" = (
/obj/structure/stone_tile/slab,
/mob/living/basic/mining/goliath,
/turf/closed/mineral/random/high_chance/volcanic,
/area/lavaland/surface/outdoors)
"RC" = (
/obj/structure/stone_tile/block/cracked{
	dir = 4
	},
/mob/living/basic/mining/brimdemon,
/turf/open/misc/asteroid/basalt/lava_land_surface,
/area/lavaland/surface/outdoors)
"RJ" = (
/obj/structure/stone_tile/slab/cracked{
	dir = 1
	},
/turf/open/lava/smooth/lava_land_surface,
/area/lavaland/surface/outdoors)
"SJ" = (
/obj/structure/stone_tile,
/obj/structure/stone_tile{
	dir = 8
	},
/obj/structure/stone_tile{
	dir = 4
	},
/obj/structure/stone_tile/cracked{
	dir = 1
	},
/turf/open/misc/asteroid/basalt/lava_land_surface,
/area/lavaland/surface/outdoors)
"SS" = (
/obj/structure/stone_tile,
/obj/structure/stone_tile{
	dir = 1
	},
/obj/structure/stone_tile/cracked{
	dir = 4
	},
/turf/closed/mineral/volcanic/lava_land_surface,
/area/lavaland/surface/outdoors)
"Tb" = (
/obj/structure/stone_tile/slab/cracked{
	dir = 4
	},
/obj/structure/stone_tile/slab/cracked{
	dir = 8
	},
/turf/open/lava/smooth/lava_land_surface,
/area/lavaland/surface/outdoors)
"Tz" = (
/obj/structure/stone_tile,
/obj/structure/stone_tile{
	dir = 1
	},
/obj/structure/stone_tile{
	dir = 4
	},
/turf/closed/mineral/volcanic/lava_land_surface,
/area/lavaland/surface/outdoors)
"TN" = (
/obj/structure/stone_tile,
/obj/structure/stone_tile{
	dir = 8
	},
/obj/structure/stone_tile{
	dir = 4
	},
/turf/open/misc/asteroid/basalt/lava_land_surface,
/area/lavaland/surface/outdoors)
"UN" = (
/turf/template_noop,
/area/template_noop)
"UY" = (
/obj/structure/stone_tile/slab/cracked{
	dir = 4
	},
/obj/structure/stone_tile/slab/cracked{
	dir = 8
	},
/turf/open/misc/asteroid/basalt/lava_land_surface,
/area/lavaland/surface/outdoors)
"Va" = (
/obj/structure/stone_tile,
/obj/structure/stone_tile{
	dir = 8
	},
/obj/structure/stone_tile{
	dir = 1
	},
/turf/closed/mineral/volcanic/lava_land_surface,
/area/lavaland/surface/outdoors)
"Vj" = (
/obj/structure/stone_tile/surrounding_tile,
/obj/structure/stone_tile/surrounding_tile{
	dir = 4
	},
/obj/structure/stone_tile/center,
/turf/closed/mineral/random/high_chance/volcanic,
/area/lavaland/surface/outdoors)
"We" = (
/obj/structure/stone_tile/slab,
/obj/item/xenoarch/useless_relic{
	name = "Ancient relic";
	desc = "Sort of relic that can be exported through Cargo."
	},
/turf/closed/mineral/volcanic/lava_land_surface,
/area/lavaland/surface/outdoors)
"WR" = (
/mob/living/basic/mining/legion,
/obj/structure/stone_tile/slab,
/turf/closed/mineral/random/high_chance/volcanic,
/area/lavaland/surface/outdoors)
"Xr" = (
/obj/structure/stone_tile/block{
	dir = 1
	},
/obj/structure/stone_tile/block,
/turf/closed/mineral/volcanic/lava_land_surface,
/area/lavaland/surface/outdoors)
"ZX" = (
/turf/closed/mineral/volcanic/lava_land_surface,
/area/lavaland/surface/outdoors)

(1,1,1) = {"
UN
UN
UN
UN
UN
UN
UN
UN
ZX
ZX
ZX
ZX
ZX
ZX
ZX
IL
UN
IL
UN
mz
fJ
Nm
ZX
UN
"}
(2,1,1) = {"
UN
Kx
GY
GY
GY
GY
GY
GY
ZX
fJ
Nm
Ib
LE
GY
GY
GY
GY
GY
GY
GY
tc
GY
Id
cP
"}
(3,1,1) = {"
ZX
GY
GY
tz
MX
GY
MO
MO
MO
fJ
fJ
fJ
tz
tz
tz
kZ
GY
sS
sS
Rd
tz
GY
GY
Ng
"}
(4,1,1) = {"
zW
GY
kZ
NM
AK
FQ
sd
La
rx
MO
GY
GB
MO
tz
WR
tz
MX
mN
sS
sS
tz
tz
GY
II
"}
(5,1,1) = {"
ZX
fn
MO
UN
wU
qV
qV
qV
qV
MO
GY
MO
MO
Mk
fJ
gq
tz
sS
uY
Cy
mN
tz
GY
ZX
"}
(6,1,1) = {"
UN
GY
MO
dB
qV
qV
FQ
FQ
qV
qV
qV
FQ
MO
UN
UN
MO
GY
dP
sS
tz
tz
kZ
GY
UN
"}
(7,1,1) = {"
UN
GY
GY
qV
qV
GY
GY
GY
GY
GY
qV
qV
FQ
MO
GY
GY
GY
GY
GY
GY
GY
GY
GY
UN
"}
(8,1,1) = {"
UN
GY
qV
qV
FQ
MO
tz
mN
MX
sS
GY
qV
qV
FQ
UN
Mk
GY
MO
FQ
FQ
FQ
MO
fn
UN
"}
(9,1,1) = {"
qV
qV
qV
Ec
sm
sS
ZX
fJ
Rd
wI
GY
MO
qV
FQ
UN
UN
GY
FQ
qV
qV
qV
FQ
GY
LE
"}
(10,1,1) = {"
UN
GY
fB
MO
sS
Fl
UN
UN
tz
sS
GY
qV
qV
Mt
UN
MO
FQ
qV
RJ
qy
qV
qV
GY
aq
"}
(11,1,1) = {"
qy
GY
MO
zW
tz
BF
AX
UN
ZX
MO
GY
qV
qV
qV
fi
FQ
qV
qV
rx
MO
FQ
qV
qV
UN
"}
(12,1,1) = {"
UN
GY
GY
kZ
sS
sS
UN
UN
cp
GY
GY
GY
qV
qV
qV
qV
qV
FQ
UN
MO
UY
GY
qV
qV
"}
(13,1,1) = {"
UN
ak
GY
GY
GY
GY
ZX
ZX
GY
GY
cR
GY
GY
GY
GY
qV
GY
GY
UN
AX
GY
GY
bO
UN
"}
(14,1,1) = {"
UN
UN
UN
ZX
Ib
fJ
fJ
ZX
ZX
ZX
UN
Dl
aq
LE
UN
qV
qV
qV
UN
sS
ZX
aq
ZX
UN
"}
(15,1,1) = {"
rE
IS
Gn
MO
RC
qt
pM
Rs
SS
MO
QN
Vj
xQ
rX
qt
Be
kb
Ec
MO
Hb
fJ
FB
OD
sn
"}
(16,1,1) = {"
UN
UY
KD
MO
qk
MO
BI
tH
bV
MO
JQ
qj
Pj
Xr
MO
SJ
RJ
fA
OD
mV
sS
Va
sS
QN
"}
(17,1,1) = {"
UN
UN
ZX
ZX
UN
UN
UN
ZX
UN
UN
ZX
ZX
UN
UN
UN
qV
qV
UN
cP
fJ
UN
UN
UN
UN
"}
(18,1,1) = {"
UN
uh
GY
GY
GY
GY
UN
cP
GY
GY
mz
GY
GY
GY
GY
qV
GY
GY
ZX
II
GY
GY
TN
UN
"}
(19,1,1) = {"
UN
GY
GY
sS
mN
hq
UN
sS
Ih
GY
GY
GY
MO
FQ
qV
qV
FQ
Mk
ZX
tz
Cy
ry
GY
ZX
"}
(20,1,1) = {"
ZX
GY
We
sS
ZX
qy
UN
UN
sS
sS
GY
MO
Mk
FQ
qV
qV
FQ
MO
ZX
bU
tz
gq
GY
ZX
"}
(21,1,1) = {"
ZX
GY
tz
tz
dP
Cy
AX
UN
mN
tz
GY
xb
UN
MO
FQ
qV
qV
Tb
Mk
sS
Pm
wI
GY
fJ
"}
(22,1,1) = {"
ZX
GY
GY
gq
tz
tz
sS
sS
sS
GY
GY
GY
UN
UN
Dq
GY
qV
FQ
MO
fJ
tz
GY
GY
fJ
"}
(23,1,1) = {"
ZX
Tz
GY
GY
GY
ZX
ZX
GY
GY
GY
cR
GY
fn
GY
GY
GY
qV
qV
GY
GY
GY
GY
LN
KE
"}
(24,1,1) = {"
UN
UN
UN
UN
ZX
ZX
ZX
zW
ZX
UN
UN
UN
UN
UN
Ib
LE
ZX
qV
UN
qy
Ib
fJ
ZX
UN
"}
