//MAP CONVERTED BY dmm2tgm.py THIS HEADER COMMENT PREVENTS RECONVERSION, DO NOT REMOVE
"a" = (
/turf/template_noop,
/area/template_noop)
"b" = (
/obj/structure/stone_tile/center,
/obj/structure/stone_tile/surrounding/cracked{
	pixel_x = 1;
	pixel_y = -1
	},
/turf/open/indestructible/necropolis,
/area/ruin/unpowered)
"c" = (
/obj/structure/stone_tile/block/cracked,
/obj/structure/trap/fire{
	name = "Anctient runic spikes";
	desc = "A strange carving of some symbols. What's that for?";
	alpha = 180;
	icon = 'icons/obj/service/hydroponics/equipment.dmi';
	icon_state = "woodspike";
	light_color = "#FF1111";
	color = "#FF1111";
	max_integrity = 30
	},
/turf/closed/mineral/random/high_chance/volcanic,
/area/lavaland/surface/outdoors)
"d" = (
/obj/structure/stone_tile/block{
	dir = 4
	},
/turf/closed/mineral/volcanic/lava_land_surface,
/area/lavaland/surface/outdoors)
"i" = (
/obj/structure/stone_tile/block/cracked,
/obj/structure/stone_tile/cracked{
	dir = 1
	},
/obj/structure/stone_tile/burnt{
	dir = 4
	},
/turf/closed/mineral/volcanic/lava_land_surface,
/area/ruin/unpowered)
"j" = (
/obj/structure/stone_tile/burnt,
/turf/closed/mineral/volcanic/lava_land_surface,
/area/lavaland/surface/outdoors)
"n" = (
/obj/structure/stone_tile/block,
/turf/closed/mineral/random/high_chance/volcanic,
/area/lavaland/surface/outdoors)
"q" = (
/obj/structure/stone_tile{
	dir = 4
	},
/turf/closed/mineral/volcanic/lava_land_surface,
/area/lavaland/surface/outdoors)
"t" = (
/obj/structure/wall_torch/mount_only,
/turf/closed/indestructible/riveted/boss,
/area/lavaland/surface/outdoors)
"u" = (
/turf/closed/indestructible/riveted/boss,
/area/lavaland/surface/outdoors)
"v" = (
/obj/structure/stone_tile/block{
	dir = 1
	},
/turf/closed/mineral/random/high_chance/volcanic,
/area/lavaland/surface/outdoors)
"w" = (
/obj/structure/stone_tile/surrounding/cracked{
	dir = 1
	},
/obj/item/knife/envy,
/turf/closed/mineral/volcanic/lava_land_surface,
/area/ruin/unpowered)
"E" = (
/obj/structure/stone_tile/surrounding/cracked,
/obj/structure/stone_tile/center/burnt,
/turf/closed/mineral/volcanic/lava_land_surface,
/area/ruin/unpowered)
"G" = (
/obj/structure/stone_tile/block{
	dir = 4
	},
/turf/closed/mineral/random/high_chance/volcanic,
/area/lavaland/surface/outdoors)
"H" = (
/obj/structure/stone_tile{
	dir = 1
	},
/turf/closed/mineral/volcanic/lava_land_surface,
/area/lavaland/surface/outdoors)
"J" = (
/obj/structure/trap/damage{
	name = "Anctient runic spikes";
	desc = "A strange carving of some symbols. What's that for?";
	icon = 'icons/obj/service/hydroponics/equipment.dmi';
	icon_state = "woodspike";
	light_color = "#DDFFDD";
	color = "#77FF77";
	alpha = 180;
	max_integrity = 30
	},
/turf/closed/mineral/random/high_chance/volcanic,
/area/lavaland/surface/outdoors)
"K" = (
/obj/structure/stone_tile/slab/burnt,
/turf/closed/mineral/volcanic/lava_land_surface,
/area/lavaland/surface/outdoors)
"M" = (
/obj/structure/flora/rock/pile/style_random,
/turf/closed/mineral/volcanic/lava_land_surface,
/area/lavaland/surface/outdoors)
"S" = (
/obj/structure/stone_tile/cracked{
	dir = 8
	},
/obj/structure/trap/cult{
	name = "Anctient runic spikes";
	desc = "A strange carving of some symbols. What's that for?";
	alpha = 180;
	icon = 'icons/obj/service/hydroponics/equipment.dmi';
	icon_state = "woodspike";
	light_color = "#FF9911";
	color = "#FF9911";
	max_integrity = 30
	},
/turf/closed/mineral/volcanic/lava_land_surface,
/area/lavaland/surface/outdoors)
"T" = (
/obj/structure/stone_tile/slab/cracked,
/turf/closed/mineral/volcanic/lava_land_surface,
/area/lavaland/surface/outdoors)
"U" = (
/obj/structure/stone_tile/slab/cracked{
	dir = 6
	},
/obj/effect/decal/cleanable/blood/old,
/mob/living/basic/mining/wolf{
	desc = "A demonic creature that moves relatively fast, but doesn't do a lot of damage.";
	faction = list("mining","boss","hell");
	name = "Ancient Demon";
	attack_sound = 'sound/effects/wounds/crackandbleed.ogg';
	attack_verb_continuous = "maniacally tears";
	attack_verb_simple = "tears";
	attack_vis_effect = "slash";
	bare_wound_bonus = 5;
	butcher_results = list(/obj/item/food/grown/mushroom/glowshroom/shadowshroom = 1,/obj/item/food/meat/slab/human/mutant/shadow = 1,/obj/item/organ/external/tail/lizard = 1);
	can_tame = 0;
	damage_coeff = list("brute" = 1, "burn" = 1, "toxin" = 1, "stamina" = 0.42, "oxygen" = 1);
	health = 240;
	icon = 'modular_nova/master_files/icons/mob/newmobs32x64.dmi';
	icon_dead = "demondead";
	icon_living = "engorgedemon";
	icon_state = "engorgedemon";
	maxHealth = 240;
	melee_damage_lower = 3;
	melee_attack_cooldown = 5;
	speed = -0.1;
	wound_bonus = -1;
	guaranteed_butcher_results = list(/obj/structure/trap/fire=1);
	crusher_loot = /obj/item/organ/internal/eyes/shadow
	},
/turf/open/misc/asteroid/basalt/lava_land_surface,
/area/ruin/unpowered)
"V" = (
/obj/structure/stone_tile/surrounding,
/obj/structure/stone_tile/center,
/obj/item/clothing/suit/hooded/bloated_human,
/obj/effect/decal/cleanable/blood/old,
/turf/closed/mineral/volcanic/lava_land_surface,
/area/ruin/unpowered)
"W" = (
/obj/effect/mapping_helpers/bombable_wall,
/turf/closed/indestructible/riveted/boss/wasteland,
/area/lavaland/surface/outdoors)
"X" = (
/obj/structure/stone_tile/surrounding,
/obj/structure/stone_tile/center,
/turf/closed/mineral/volcanic/lava_land_surface,
/area/ruin/unpowered)
"Y" = (
/obj/structure/stone_tile/burnt,
/obj/structure/punji_sticks/spikes,
/turf/closed/mineral/random/high_chance/volcanic,
/area/lavaland/surface/outdoors)

(1,1,1) = {"
a
a
M
K
S
a
a
"}
(2,1,1) = {"
a
q
W
T
u
a
a
"}
(3,1,1) = {"
q
u
u
E
u
u
a
"}
(4,1,1) = {"
v
u
w
i
V
u
n
"}
(5,1,1) = {"
J
u
b
U
X
u
c
"}
(6,1,1) = {"
H
u
u
t
W
u
j
"}
(7,1,1) = {"
a
a
d
a
G
Y
a
"}
