//MAP CONVERTED BY dmm2tgm.py THIS HEADER COMMENT PREVENTS RECONVERSION, DO NOT REMOVE
"aN" = (
/obj/structure/stone_tile/surrounding_tile{
	dir = 4
	},
/obj/structure/stone_tile/surrounding_tile,
/obj/structure/stone_tile/center/burnt,
/turf/closed/mineral/random/high_chance/volcanic,
/area/ruin/unpowered)
"cc" = (
/obj/structure/stone_tile/surrounding,
/obj/structure/stone_tile/center/burnt,
/turf/closed/mineral/volcanic/lava_land_surface,
/area/ruin/unpowered)
"cK" = (
/turf/template_noop,
/area/template_noop)
"dG" = (
/obj/structure/trap/damage{
	name = "Anctient runic spikes";
	desc = "A strange carving of some symbols. What's that for?";
	icon = 'icons/obj/service/hydroponics/equipment.dmi';
	icon_state = "woodspike";
	light_color = "#DDFFDD";
	color = "#77FF77";
	alpha = 180;
	max_integrity = 30
	},
/turf/closed/mineral/volcanic/lava_land_surface,
/area/lavaland/surface/outdoors)
"dR" = (
/obj/item/reagent_containers/cup/beaker/large/ceramic{
	pixel_x = 7;
	pixel_y = -5
	},
/turf/closed/mineral/random/high_chance/volcanic,
/area/lavaland/surface/outdoors)
"dU" = (
/obj/structure/stone_tile/surrounding,
/obj/structure/stone_tile/center/burnt,
/obj/item/bodypart/arm/left/golem,
/obj/effect/decal/cleanable/glass/titanium,
/turf/open/misc/asteroid/basalt/lava_land_surface,
/area/ruin/unpowered)
"dV" = (
/obj/structure/flora/rock/pile/style_random,
/turf/closed/mineral/volcanic/lava_land_surface,
/area/lavaland/surface/outdoors)
"ed" = (
/obj/structure/stone_tile/block,
/obj/structure/stone_tile/block/cracked{
	dir = 1
	},
/turf/open/lava/smooth/lava_land_surface,
/area/lavaland/surface/outdoors)
"ei" = (
/obj/structure/stone_tile/surrounding,
/obj/structure/stone_tile/center/burnt,
/turf/open/misc/asteroid/basalt/lava_land_surface,
/area/lavaland/surface/outdoors)
"eH" = (
/obj/structure/stone_tile/burnt{
	dir = 4
	},
/turf/open/lava/smooth/lava_land_surface,
/area/lavaland/surface/outdoors)
"eP" = (
/obj/structure/stone_tile{
	dir = 8
	},
/obj/structure/stone_tile,
/obj/structure/stone_tile{
	dir = 4
	},
/obj/item/xenoarch/useless_relic/magnified{
	name = "Ancient relic";
	desc = "Sort of relic that can be exported through Cargo."
	},
/turf/closed/mineral/volcanic/lava_land_surface,
/area/lavaland/surface/outdoors)
"eX" = (
/obj/structure/stone_tile/slab/cracked{
	dir = 6
	},
/obj/item/reagent_containers/cup/bowl/wood_bowl,
/turf/closed/mineral/volcanic/lava_land_surface,
/area/lavaland/surface/outdoors)
"fZ" = (
/obj/structure/stone_tile/slab,
/obj/effect/spawner/random/medical/minor_healing,
/turf/closed/mineral/random/high_chance/volcanic,
/area/ruin/unpowered)
"gW" = (
/obj/structure/stone_tile/surrounding_tile{
	dir = 8
	},
/obj/structure/stone_tile/center/burnt,
/obj/structure/stone_tile/surrounding_tile/cracked{
	dir = 1
	},
/obj/item/claymore,
/turf/closed/mineral/random/high_chance/volcanic,
/area/ruin/unpowered)
"ib" = (
/obj/structure/stone_tile/surrounding_tile{
	dir = 1
	},
/obj/structure/stone_tile/surrounding_tile/cracked{
	dir = 8
	},
/turf/closed/mineral/volcanic/lava_land_surface,
/area/lavaland/surface/outdoors)
"iz" = (
/obj/item/wallframe/torch_mount,
/turf/closed/indestructible/riveted/boss,
/area/ruin/unpowered)
"iW" = (
/obj/structure/stone_tile/block/burnt{
	dir = 4
	},
/turf/open/lava/smooth/lava_land_surface,
/area/lavaland/surface/outdoors)
"iZ" = (
/obj/structure/stone_tile/slab,
/obj/effect/decal/cleanable/dirt,
/obj/effect/decal/cleanable/dirt/dust,
/turf/open/misc/asteroid/basalt/lava_land_surface,
/area/ruin/unpowered)
"jl" = (
/obj/structure/stone_tile/block/burnt,
/turf/open/lava/smooth/lava_land_surface,
/area/lavaland/surface/outdoors)
"jz" = (
/obj/structure/stone_tile/slab,
/obj/structure/fluff/divine/conduit,
/obj/effect/decal/cleanable/cobweb,
/obj/effect/decal/cleanable/dirt/dust,
/turf/open/misc/asteroid/basalt/lava_land_surface,
/area/ruin/unpowered)
"jT" = (
/obj/structure/stone_tile/block{
	dir = 1
	},
/obj/structure/stone_tile/block/cracked,
/turf/open/lava/smooth/lava_land_surface,
/area/lavaland/surface/outdoors)
"jV" = (
/obj/structure/stone_tile/surrounding,
/obj/structure/stone_tile/center/burnt,
/turf/closed/mineral/strong{
	base_icon_state = "smoothrocks";
	icon = 'modular_nova/modules/liquids/icons/turf/smoothrocks.dmi';
	icon_state = "smoothrocks-55"
	},
/area/ruin/unpowered)
"kf" = (
/obj/structure/stone_tile/surrounding_tile{
	dir = 4
	},
/obj/structure/stone_tile/surrounding_tile,
/obj/structure/stone_tile/center/cracked,
/obj/item/xenoarch/useless_relic{
	name = "Ancient relic";
	desc = "Sort of relic that can be exported through Cargo."
	},
/turf/closed/mineral/volcanic/lava_land_surface,
/area/lavaland/surface/outdoors)
"kM" = (
/obj/structure/stone_tile/slab,
/obj/effect/decal/cleanable/dirt/dust,
/turf/open/misc/asteroid/basalt/lava_land_surface,
/area/ruin/unpowered)
"kU" = (
/obj/structure/stone_tile/slab,
/obj/item/xenoarch/useless_relic/magnified{
	name = "Ancient relic";
	desc = "Sort of relic that can be exported through Cargo."
	},
/turf/closed/mineral/random/high_chance/volcanic,
/area/ruin/unpowered)
"le" = (
/obj/structure/stone_tile/slab,
/turf/open/lava/smooth/lava_land_surface,
/area/lavaland/surface/outdoors)
"ma" = (
/obj/structure/stone_tile/slab,
/turf/closed/mineral/volcanic/lava_land_surface,
/area/lavaland/surface/outdoors)
"mR" = (
/obj/structure/stone_tile/block,
/obj/structure/stone_tile{
	dir = 1
	},
/obj/item/xenoarch/useless_relic{
	name = "Ancient relic";
	desc = "Sort of relic that can be exported through Cargo."
	},
/turf/closed/mineral/random/high_chance/volcanic,
/area/lavaland/surface/outdoors)
"nF" = (
/obj/structure/punji_sticks/spikes,
/turf/closed/mineral/volcanic/lava_land_surface,
/area/lavaland/surface/outdoors)
"ol" = (
/obj/structure/stone_tile/surrounding_tile/burnt,
/turf/open/lava/smooth/lava_land_surface,
/area/lavaland/surface/outdoors)
"ou" = (
/obj/structure/flora/rock/pile/style_random,
/obj/item/xenoarch/useless_relic{
	name = "Ancient relic";
	desc = "Sort of relic that can be exported through Cargo."
	},
/turf/closed/mineral/random/high_chance/volcanic,
/area/lavaland/surface/outdoors)
"qD" = (
/obj/structure/stone_tile/surrounding_tile{
	dir = 4
	},
/obj/structure/stone_tile/surrounding_tile/burnt,
/obj/structure/stone_tile/center/burnt,
/turf/closed/mineral/volcanic/lava_land_surface,
/area/lavaland/surface/outdoors)
"qF" = (
/obj/structure/stone_tile/slab/cracked{
	dir = 5
	},
/turf/open/lava/smooth/lava_land_surface,
/area/lavaland/surface/outdoors)
"rh" = (
/obj/structure/stone_tile/slab,
/turf/closed/mineral/random/high_chance/volcanic,
/area/lavaland/surface/outdoors)
"sD" = (
/obj/structure/stone_tile/surrounding_tile{
	dir = 4
	},
/obj/structure/stone_tile/surrounding_tile,
/obj/structure/stone_tile/center/cracked,
/turf/closed/mineral/random/high_chance/volcanic,
/area/ruin/unpowered)
"ty" = (
/obj/structure/stone_tile/slab,
/turf/closed/mineral/volcanic/lava_land_surface,
/area/ruin/unpowered)
"uw" = (
/obj/structure/stone_tile/slab,
/obj/item/reagent_containers/cup/beaker/large/ceramic{
	pixel_x = 7;
	pixel_y = -5
	},
/obj/effect/decal/cleanable/dirt,
/turf/open/misc/asteroid/basalt/lava_land_surface,
/area/ruin/unpowered)
"uA" = (
/obj/structure/stone_tile/slab,
/turf/closed/mineral/random/high_chance/volcanic,
/area/ruin/unpowered)
"uQ" = (
/obj/structure/stone_tile/center/burnt,
/obj/structure/stone_tile/surrounding/cracked,
/turf/open/lava/smooth/lava_land_surface,
/area/lavaland/surface/outdoors)
"vc" = (
/obj/structure/stone_tile/surrounding_tile{
	dir = 4
	},
/obj/structure/stone_tile/surrounding_tile/burnt,
/obj/structure/stone_tile/center/cracked,
/obj/item/shield/kite,
/turf/closed/mineral/random/high_chance/volcanic,
/area/ruin/unpowered)
"vs" = (
/obj/structure/stone_tile/slab/burnt,
/turf/closed/mineral/volcanic/lava_land_surface,
/area/lavaland/surface/outdoors)
"vI" = (
/obj/structure/stone_tile/slab/burnt,
/turf/open/lava/smooth/lava_land_surface,
/area/lavaland/surface/outdoors)
"vN" = (
/obj/structure/stone_tile/surrounding_tile{
	dir = 1
	},
/obj/structure/stone_tile/center/burnt,
/obj/structure/stone_tile/surrounding_tile/cracked{
	dir = 8
	},
/obj/structure/stone_tile/surrounding_tile,
/obj/structure/stone_tile/surrounding_tile{
	dir = 4
	},
/obj/item/bodypart/chest/golem{
	pixel_x = -10
	},
/turf/open/misc/asteroid/basalt/lava_land_surface,
/area/ruin/unpowered)
"wA" = (
/obj/structure/stone_tile/surrounding_tile{
	dir = 4
	},
/obj/structure/stone_tile/surrounding_tile/burnt,
/obj/structure/stone_tile/center/burnt,
/turf/closed/mineral/random/high_chance/volcanic,
/area/ruin/unpowered)
"xi" = (
/obj/structure/stone_tile/center/burnt,
/obj/structure/stone_tile/surrounding_tile/burnt{
	dir = 4
	},
/turf/open/lava/smooth/lava_land_surface,
/area/lavaland/surface/outdoors)
"xr" = (
/turf/open/lava/smooth/lava_land_surface,
/area/lavaland/surface/outdoors)
"xN" = (
/obj/structure/stone_tile/surrounding/cracked{
	dir = 4
	},
/turf/open/lava/smooth/lava_land_surface,
/area/lavaland/surface/outdoors)
"xZ" = (
/obj/structure/stone_tile/center/burnt,
/obj/structure/stone_tile/surrounding/cracked{
	dir = 1
	},
/turf/open/lava/smooth/lava_land_surface,
/area/lavaland/surface/outdoors)
"yk" = (
/turf/closed/indestructible/riveted/boss,
/area/ruin/unpowered)
"ym" = (
/obj/structure/stone_tile/burnt,
/turf/open/lava/smooth/lava_land_surface,
/area/lavaland/surface/outdoors)
"yS" = (
/obj/structure/stone_tile/slab,
/obj/item/reagent_containers/cup/primitive_centrifuge{
	pixel_x = -14;
	pixel_y = -1
	},
/turf/open/misc/asteroid/basalt/lava_land_surface,
/area/ruin/unpowered)
"ze" = (
/obj/structure/stone_tile/slab,
/turf/closed/mineral/strong{
	base_icon_state = "smoothrocks";
	icon = 'modular_nova/modules/liquids/icons/turf/smoothrocks.dmi';
	icon_state = "smoothrocks-55"
	},
/area/ruin/unpowered)
"zO" = (
/obj/structure/flora/rock/pile/style_random,
/turf/open/misc/asteroid/basalt/lava_land_surface,
/area/lavaland/surface/outdoors)
"zY" = (
/obj/structure/stone_tile/surrounding,
/obj/structure/stone_tile/center/burnt,
/turf/open/lava/smooth/lava_land_surface,
/area/lavaland/surface/outdoors)
"Ag" = (
/obj/structure/stone_tile/surrounding,
/obj/structure/stone_tile/center/burnt,
/turf/closed/mineral/volcanic/lava_land_surface,
/area/lavaland/surface/outdoors)
"Ap" = (
/obj/structure/stone_tile/surrounding,
/obj/structure/stone_tile/center/burnt,
/turf/closed/mineral/strong{
	base_icon_state = "smoothrocks";
	icon = 'modular_nova/modules/liquids/icons/turf/smoothrocks.dmi';
	icon_state = "smoothrocks-55"
	},
/area/lavaland/surface/outdoors)
"AE" = (
/obj/structure/stone_tile/center/burnt,
/obj/structure/punji_sticks/spikes,
/turf/closed/mineral/strong{
	base_icon_state = "smoothrocks";
	icon = 'modular_nova/modules/liquids/icons/turf/smoothrocks.dmi';
	icon_state = "smoothrocks-55"
	},
/area/lavaland/surface/outdoors)
"Bg" = (
/obj/effect/mapping_helpers/bombable_wall,
/turf/closed/indestructible/riveted/boss/wasteland,
/area/ruin/unpowered)
"Cf" = (
/obj/structure/stone_tile/surrounding/cracked{
	dir = 8
	},
/obj/structure/stone_tile/center/burnt,
/turf/open/lava/smooth/lava_land_surface,
/area/lavaland/surface/outdoors)
"Dh" = (
/obj/structure/trap/cult{
	name = "Anctient runic spikes";
	desc = "A strange carving of some symbols. What's that for?";
	alpha = 180;
	icon = 'icons/obj/service/hydroponics/equipment.dmi';
	icon_state = "woodspike";
	light_color = "#FF9911";
	color = "#FF9911";
	max_integrity = 30
	},
/turf/closed/mineral/volcanic/lava_land_surface,
/area/lavaland/surface/outdoors)
"Dx" = (
/obj/structure/stone_tile/block{
	dir = 1
	},
/obj/structure/stone_tile/block/cracked,
/turf/open/misc/asteroid/basalt/lava_land_surface,
/area/lavaland/surface/outdoors)
"Eu" = (
/obj/structure/stone_tile/surrounding_tile{
	dir = 4
	},
/obj/structure/stone_tile/surrounding_tile/burnt,
/obj/structure/stone_tile/center/cracked,
/obj/structure/stone_tile/surrounding_tile{
	dir = 8
	},
/obj/structure/stone_tile/surrounding_tile{
	dir = 1
	},
/obj/effect/decal/cleanable/dirt/dust,
/turf/open/misc/asteroid/basalt/lava_land_surface,
/area/ruin/unpowered)
"FA" = (
/obj/structure/stone_tile/center/burnt,
/obj/structure/stone_tile/surrounding/burnt,
/turf/open/lava/smooth/lava_land_surface,
/area/lavaland/surface/outdoors)
"FI" = (
/obj/structure/stone_tile/surrounding/burnt,
/obj/structure/stone_tile/center/burnt,
/turf/open/lava/smooth/lava_land_surface,
/area/lavaland/surface/outdoors)
"HE" = (
/obj/structure/stone_tile/surrounding_tile{
	dir = 8
	},
/obj/structure/stone_tile/center/burnt,
/obj/structure/stone_tile/surrounding_tile/cracked{
	dir = 1
	},
/turf/closed/mineral/volcanic/lava_land_surface,
/area/lavaland/surface/outdoors)
"HU" = (
/obj/effect/mapping_helpers/bombable_wall,
/turf/closed/indestructible/riveted/boss/wasteland,
/area/lavaland/surface/outdoors)
"IJ" = (
/obj/structure/stone_tile/center/burnt,
/obj/structure/stone_tile/surrounding/cracked{
	dir = 4
	},
/turf/open/lava/smooth/lava_land_surface,
/area/lavaland/surface/outdoors)
"IN" = (
/obj/structure/stone_tile,
/obj/structure/stone_tile{
	dir = 1
	},
/turf/closed/mineral/volcanic/lava_land_surface,
/area/lavaland/surface/outdoors)
"Jv" = (
/obj/structure/stone_tile,
/obj/structure/stone_tile{
	dir = 8
	},
/obj/structure/stone_tile{
	dir = 1
	},
/turf/closed/mineral/volcanic/lava_land_surface,
/area/lavaland/surface/outdoors)
"Ka" = (
/turf/closed/indestructible/riveted/boss,
/area/lavaland/surface/outdoors)
"KO" = (
/obj/structure/stone_tile/block,
/obj/structure/stone_tile/block{
	dir = 1
	},
/turf/closed/mineral/volcanic/lava_land_surface,
/area/ruin/unpowered)
"Lq" = (
/obj/structure/stone_tile/surrounding_tile{
	dir = 4
	},
/obj/structure/stone_tile/surrounding_tile,
/obj/structure/stone_tile/center,
/obj/structure/stone_tile/surrounding_tile{
	dir = 8
	},
/obj/structure/stone_tile/surrounding_tile{
	dir = 1
	},
/turf/open/misc/asteroid/basalt/lava_land_surface,
/area/ruin/unpowered)
"LY" = (
/obj/structure/stone_tile/slab/cracked{
	dir = 6
	},
/turf/open/lava/smooth/lava_land_surface,
/area/lavaland/surface/outdoors)
"Mj" = (
/obj/structure/stone_tile/surrounding/cracked{
	dir = 8
	},
/turf/open/lava/smooth/lava_land_surface,
/area/lavaland/surface/outdoors)
"MB" = (
/obj/item/reagent_containers/cup/bowl/wood_bowl,
/obj/structure/punji_sticks/spikes,
/turf/closed/mineral/volcanic/lava_land_surface,
/area/lavaland/surface/outdoors)
"MW" = (
/obj/structure/stone_tile/block{
	dir = 1
	},
/obj/structure/stone_tile{
	dir = 8
	},
/obj/item/xenoarch/useless_relic/magnified{
	name = "Ancient relic";
	desc = "Sort of relic that can be exported through Cargo."
	},
/turf/closed/mineral/random/high_chance/volcanic,
/area/lavaland/surface/outdoors)
"NU" = (
/obj/structure/stone_tile/block/burnt{
	dir = 1
	},
/turf/open/lava/smooth/lava_land_surface,
/area/lavaland/surface/outdoors)
"OB" = (
/turf/closed/mineral/volcanic/lava_land_surface,
/area/lavaland/surface/outdoors)
"QB" = (
/obj/structure/stone_tile,
/obj/structure/stone_tile{
	dir = 1
	},
/turf/closed/mineral/random/high_chance/volcanic,
/area/lavaland/surface/outdoors)
"Rk" = (
/obj/structure/stone_tile/block{
	dir = 8
	},
/turf/closed/mineral/random/high_chance/volcanic,
/area/lavaland/surface/outdoors)
"Sm" = (
/obj/structure/stone_tile/slab,
/mob/living/basic/mining/goliath/ancient,
/turf/closed/mineral/random/high_chance/volcanic,
/area/lavaland/surface/outdoors)
"SS" = (
/obj/structure/stone_tile/surrounding_tile{
	dir = 8
	},
/obj/structure/stone_tile/center/burnt,
/obj/structure/stone_tile/surrounding_tile/cracked{
	dir = 1
	},
/obj/structure/stone_tile/surrounding_tile,
/obj/structure/stone_tile/surrounding_tile{
	dir = 4
	},
/obj/item/bodypart/arm/right/golem,
/obj/effect/gibspawner/human,
/mob/living/basic/mining/wolf{
	desc = "A demonic creature that moves relatively fast, but doesn't do a lot of damage.";
	faction = list("mining","boss","hell");
	name = "Ancient Demon";
	attack_sound = 'sound/effects/wounds/crackandbleed.ogg';
	attack_verb_continuous = "maniacally tears";
	attack_verb_simple = "tears";
	attack_vis_effect = "slash";
	bare_wound_bonus = 5;
	butcher_results = list(/obj/item/food/grown/mushroom/glowshroom/shadowshroom = 1,/obj/item/food/meat/slab/human/mutant/shadow = 1,/obj/item/organ/external/tail/lizard = 1);
	can_tame = 0;
	damage_coeff = list("brute" = 1, "burn" = 1, "toxin" = 1, "stamina" = 0.42, "oxygen" = 1);
	health = 240;
	icon = 'modular_nova/master_files/icons/mob/newmobs32x64.dmi';
	icon_dead = "demondead";
	icon_living = "engorgedemon";
	icon_state = "engorgedemon";
	maxHealth = 240;
	melee_damage_lower = 3;
	melee_attack_cooldown = 5;
	speed = -0.1;
	wound_bonus = -1;
	guaranteed_butcher_results = list(/obj/structure/trap/fire=1);
	crusher_loot = /obj/item/organ/internal/eyes/shadow
	},
/turf/open/misc/asteroid/basalt/lava_land_surface,
/area/ruin/unpowered)
"TZ" = (
/obj/structure/stone_tile/block/cracked{
	dir = 1
	},
/turf/open/lava/smooth/lava_land_surface,
/area/lavaland/surface/outdoors)
"UV" = (
/obj/structure/stone_tile/surrounding_tile{
	dir = 1
	},
/obj/structure/stone_tile/surrounding_tile/cracked{
	dir = 8
	},
/turf/closed/mineral/random/high_chance/volcanic,
/area/ruin/unpowered)
"Vo" = (
/obj/structure/stone_tile/surrounding_tile{
	dir = 8
	},
/obj/structure/stone_tile/surrounding_tile/cracked{
	dir = 1
	},
/turf/closed/mineral/random/high_chance/volcanic,
/area/ruin/unpowered)
"Vq" = (
/obj/structure/stone_tile/block,
/obj/structure/stone_tile{
	dir = 4
	},
/turf/closed/mineral/random/high_chance/volcanic,
/area/lavaland/surface/outdoors)
"WA" = (
/obj/structure/stone_tile/block,
/obj/structure/stone_tile/block{
	dir = 1
	},
/turf/closed/mineral/strong{
	base_icon_state = "smoothrocks";
	icon = 'modular_nova/modules/liquids/icons/turf/smoothrocks.dmi';
	icon_state = "smoothrocks-55"
	},
/area/ruin/unpowered)
"WG" = (
/obj/structure/stone_tile/slab,
/obj/structure/fluff/divine/conduit,
/obj/effect/decal/cleanable/dirt/dust,
/turf/open/misc/asteroid/basalt/lava_land_surface,
/area/ruin/unpowered)
"Xd" = (
/obj/structure/stone_tile/burnt{
	dir = 8
	},
/turf/open/lava/smooth/lava_land_surface,
/area/lavaland/surface/outdoors)
"Xl" = (
/obj/structure/stone_tile/surrounding,
/obj/structure/stone_tile/center/burnt,
/obj/item/clothing/head/wizard/black,
/turf/closed/mineral/random/high_chance/volcanic,
/area/ruin/unpowered)
"Xq" = (
/obj/structure/stone_tile/slab/cracked{
	dir = 10
	},
/turf/open/lava/smooth/lava_land_surface,
/area/lavaland/surface/outdoors)
"Yj" = (
/obj/structure/stone_tile/center/burnt,
/obj/structure/punji_sticks/spikes,
/turf/closed/mineral/volcanic/lava_land_surface,
/area/ruin/unpowered)
"YG" = (
/obj/structure/stone_tile{
	dir = 4
	},
/turf/open/lava/smooth/lava_land_surface,
/area/lavaland/surface/outdoors)
"YN" = (
/obj/structure/stone_tile/slab/cracked,
/turf/open/lava/smooth/lava_land_surface,
/area/lavaland/surface/outdoors)
"YS" = (
/obj/structure/trap/fire{
	name = "Anctient runic spikes";
	desc = "A strange carving of some symbols. What's that for?";
	alpha = 180;
	icon = 'icons/obj/service/hydroponics/equipment.dmi';
	icon_state = "woodspike";
	light_color = "#FF1111";
	color = "#FF1111";
	max_integrity = 30
	},
/turf/closed/mineral/random/high_chance/volcanic,
/area/lavaland/surface/outdoors)
"Zd" = (
/obj/structure/stone_tile,
/turf/closed/mineral/volcanic/lava_land_surface,
/area/lavaland/surface/outdoors)

(1,1,1) = {"
cK
cK
yk
Bg
yk
yk
xr
xr
cK
cK
HU
YS
nF
nF
cK
cK
"}
(2,1,1) = {"
cK
yk
yk
uA
uA
yk
Bg
xr
xr
OB
dV
Sm
rh
OB
dG
xr
"}
(3,1,1) = {"
cK
yk
kU
vc
Vo
ze
Ap
NU
ed
FI
eX
qD
HE
vI
xr
xr
"}
(4,1,1) = {"
dV
yk
ty
UV
aN
fZ
AE
jT
jl
xN
vI
ib
kf
xr
xr
cK
"}
(5,1,1) = {"
Dh
yk
yk
ty
uA
iz
yk
zO
xr
xr
xr
YN
xr
xr
cK
cK
"}
(6,1,1) = {"
OB
OB
yk
dU
jV
yk
Ka
mR
iW
ym
xr
xr
xr
cK
cK
cK
"}
(7,1,1) = {"
cK
yk
iz
uw
kM
iz
eP
Ka
Xd
xr
YG
HU
Xd
xr
eH
cK
"}
(8,1,1) = {"
cK
yk
jz
Eu
SS
cc
ma
xZ
vI
Mj
xr
xN
Xq
uQ
vs
cK
"}
(9,1,1) = {"
nF
yk
WG
vN
Lq
Yj
LY
FA
le
ei
vI
Cf
qF
Ag
ma
cK
"}
(10,1,1) = {"
HU
yk
iz
yS
iZ
iz
Jv
HU
IN
Ka
QB
HU
QB
Ka
Zd
OB
"}
(11,1,1) = {"
OB
xr
iW
IJ
zY
yk
Ka
Vq
Rk
MW
yk
yk
yk
yk
ou
dR
"}
(12,1,1) = {"
OB
xr
Xd
xr
xr
Bg
yk
yk
yk
yk
iz
uA
fZ
yk
yk
YS
"}
(13,1,1) = {"
cK
cK
xr
ol
xr
xr
ei
KO
WA
Xl
uA
wA
gW
uA
yk
OB
"}
(14,1,1) = {"
cK
cK
cK
xr
xi
xr
xZ
Dx
WA
jV
ze
UV
sD
kU
yk
nF
"}
(15,1,1) = {"
cK
cK
cK
cK
cK
xr
xr
TZ
Bg
yk
yk
ty
uA
yk
yk
cK
"}
(16,1,1) = {"
cK
cK
cK
cK
cK
cK
cK
xr
dV
MB
yk
yk
Bg
yk
cK
cK
"}
