//MAP CONVERTED BY dmm2tgm.py THIS HEADER COMMENT PREVENTS RECONVERSION, DO NOT REMOVE
"a" = (
/turf/template_noop,
/area/template_noop)
"i" = (
/obj/structure/girder,
/obj/effect/spawner/random/structure/grille,
/turf/open/floor/plating/lavaland_atmos,
/area/lavaland/surface/outdoors)
"o" = (
/obj/item/reagent_containers/hash,
/obj/structure/lattice/catwalk/mining,
/obj/machinery/atmospherics/pipe/smart/simple/scrubbers/hidden/layer4{
	dir = 4
	},
/obj/machinery/atmospherics/pipe/smart/simple/supply/hidden/layer2{
	dir = 4
	},
/obj/structure/cable,
/obj/item/clothing/mask/cigarette/rollie/trippy,
/obj/item/clothing/mask/cigarette/rollie/trippy{
	pixel_x = 5;
	pixel_y = 7
	},
/turf/open/floor/plating/lavaland_atmos,
/area/ruin/unpowered)
"v" = (
/obj/structure/lattice,
/turf/open/misc/asteroid/basalt/lava_land_surface,
/area/lavaland/surface/outdoors)
"D" = (
/obj/item/reagent_containers/hash/dabs{
	pixel_x = 5;
	pixel_y = 8
	},
/obj/item/reagent_containers/hashbrick{
	pixel_x = -5
	},
/obj/item/reagent_containers/heroin,
/obj/item/reagent_containers/hash/dabs,
/obj/structure/lattice/catwalk/mining,
/obj/machinery/atmospherics/pipe/smart/simple/scrubbers/hidden/layer4{
	dir = 4
	},
/obj/machinery/atmospherics/pipe/smart/simple/supply/hidden/layer2{
	dir = 4
	},
/obj/structure/cable,
/turf/open/floor/plating/lavaland_atmos,
/area/ruin/unpowered)
"E" = (
/obj/item/reagent_containers/heroinbrick{
	pixel_y = 7
	},
/obj/item/reagent_containers/hash/dabs,
/obj/structure/lattice/catwalk/mining,
/obj/effect/spawner/random/structure/closet_empty/crate/with_loot,
/turf/open/floor/plating/lavaland_atmos,
/area/ruin/unpowered)
"F" = (
/obj/structure/lattice/catwalk/mining,
/obj/item/reagent_containers/heroinbrick{
	pixel_x = 9;
	pixel_y = 12
	},
/obj/item/reagent_containers/heroin{
	pixel_x = 9;
	pixel_y = 4
	},
/turf/open/floor/plating/lavaland_atmos,
/area/ruin/unpowered)
"K" = (
/turf/closed/wall/r_wall,
/area/lavaland/surface/outdoors)
"O" = (
/obj/item/reagent_containers/hash{
	pixel_x = 16;
	pixel_y = 7
	},
/obj/structure/lattice/catwalk/mining,
/obj/machinery/atmospherics/pipe/smart/simple/scrubbers/hidden/layer4{
	dir = 4
	},
/obj/machinery/atmospherics/pipe/smart/simple/supply/hidden/layer2{
	dir = 4
	},
/obj/structure/cable,
/obj/item/reagent_containers/heroinbrick,
/turf/open/floor/plating/lavaland_atmos,
/area/ruin/unpowered)
"Q" = (
/obj/structure/girder,
/obj/machinery/atmospherics/pipe/smart/simple/scrubbers/hidden/layer4{
	dir = 4
	},
/obj/machinery/atmospherics/pipe/smart/simple/supply/hidden/layer2{
	dir = 4
	},
/obj/structure/cable,
/obj/effect/spawner/random/structure/grille,
/turf/open/floor/plating/lavaland_atmos,
/area/lavaland/surface/outdoors)
"S" = (
/turf/closed/mineral/volcanic/lava_land_surface,
/area/lavaland/surface/outdoors)
"V" = (
/obj/structure/lattice,
/obj/effect/spawner/random/structure/grille,
/turf/open/misc/asteroid/basalt/lava_land_surface,
/area/lavaland/surface/outdoors)

(1,1,1) = {"
a
v
S
a
a
"}
(2,1,1) = {"
a
K
i
v
S
"}
(3,1,1) = {"
K
O
F
i
S
"}
(4,1,1) = {"
K
D
E
K
S
"}
(5,1,1) = {"
K
o
K
K
S
"}
(6,1,1) = {"
S
Q
V
S
a
"}
(7,1,1) = {"
a
S
K
a
a
"}
