//MAP CONVERTED BY dmm2tgm.py THIS HEADER COMMENT PREVENTS RECONVERSION, DO NOT REMOVE
"a" = (
/turf/open/space/basic,
/area/space)
"d" = (
/obj/item/food/grown/grass/thatch,
/obj/structure/stone_tile/block/cracked{
	dir = 1
	},
/turf/closed/mineral/random/high_chance/volcanic,
/area/lavaland/surface/outdoors)
"i" = (
/obj/structure/stone_tile/burnt{
	dir = 1
	},
/turf/open/floor/grass/lavaland,
/area/lavaland/surface/outdoors)
"j" = (
/obj/structure/stone_tile/surrounding/cracked{
	dir = 8
	},
/obj/structure/stone_tile/center/burnt,
/turf/open/floor/grass/lavaland,
/area/lavaland/surface/outdoors)
"o" = (
/obj/structure/water_source/puddle,
/obj/structure/flora/bush/ferny/style_random,
/obj/structure/stone_tile/surrounding_tile/cracked,
/obj/structure/stone_tile/surrounding_tile/cracked{
	dir = 8
	},
/obj/effect/spawner/random/decoration/flower,
/obj/item/xenoarch/useless_relic/magnified{
	name = "Ancient relic";
	desc = "Sort of relic that can be exported through Cargo."
	},
/turf/open/floor/grass/lavaland,
/area/ruin/unpowered)
"q" = (
/obj/effect/spawner/random/structure/spikes,
/obj/effect/spawner/random/structure/orevein_longregen,
/turf/closed/mineral/random/high_chance/volcanic,
/area/lavaland/surface/outdoors)
"w" = (
/obj/effect/spawner/random/structure/spikes,
/obj/effect/spawner/random/structure/orevein_longregen,
/turf/closed/mineral/volcanic/lava_land_surface,
/area/lavaland/surface/outdoors)
"A" = (
/obj/structure/stone_tile/surrounding/cracked{
	dir = 1
	},
/turf/open/floor/grass/lavaland,
/area/lavaland/surface/outdoors)
"C" = (
/obj/structure/stone_tile/surrounding_tile/cracked{
	dir = 5
	},
/obj/structure/stone_tile/surrounding_tile/cracked{
	dir = 1
	},
/turf/open/floor/grass/lavaland,
/area/lavaland/surface/outdoors)
"E" = (
/obj/structure/stone_tile/block/cracked,
/obj/effect/spawner/random/structure/spikes,
/turf/closed/mineral/volcanic/lava_land_surface,
/area/lavaland/surface/outdoors)
"M" = (
/obj/structure/flora/rock/pile/style_random,
/obj/effect/spawner/random/structure/spikes,
/turf/closed/mineral/volcanic/lava_land_surface,
/area/lavaland/surface/outdoors)
"T" = (
/obj/effect/spawner/random/structure/spikes,
/turf/closed/mineral/volcanic/lava_land_surface,
/area/lavaland/surface/outdoors)
"V" = (
/obj/structure/stone_tile/cracked{
	dir = 4
	},
/turf/closed/mineral/volcanic/lava_land_surface,
/area/lavaland/surface/outdoors)
"W" = (
/obj/item/food/grown/grass/thatch,
/obj/structure/flora/rock/pile/style_random,
/turf/closed/mineral/random/high_chance/volcanic,
/area/lavaland/surface/outdoors)
"Y" = (
/obj/structure/flora/rock/pile/style_random,
/obj/structure/stone_tile/surrounding_tile/cracked{
	dir = 1
	},
/turf/closed/mineral/volcanic/lava_land_surface,
/area/lavaland/surface/outdoors)

(1,1,1) = {"
a
V
M
a
a
"}
(2,1,1) = {"
T
d
j
T
a
"}
(3,1,1) = {"
w
C
o
W
E
"}
(4,1,1) = {"
T
Y
A
i
M
"}
(5,1,1) = {"
a
q
T
w
T
"}
