//MAP CONVERTED BY dmm2tgm.py THIS HEADER COMMENT PREVENTS RECONVERSION, DO NOT REMOVE
"av" = (
/obj/structure/stone_tile,
/obj/structure/stone_tile{
	dir = 1
	},
/obj/structure/stone_tile/cracked{
	dir = 4
	},
/turf/closed/mineral/volcanic/lava_land_surface,
/area/lavaland/surface/outdoors)
"aw" = (
/obj/structure/flora/bush/flowers_yw/style_random,
/obj/effect/spawner/random/food_or_drink/seed_rare,
/turf/closed/wall/mineral/bronze,
/area/ruin/unpowered/gaia)
"aJ" = (
/obj/structure/flora/grass/jungle/b/style_random,
/turf/open/misc/grass/lavaland,
/area/ruin/unpowered/gaia)
"aL" = (
/obj/structure/stone_tile/slab,
/turf/closed/mineral/volcanic/lava_land_surface,
/area/lavaland/surface/outdoors)
"br" = (
/obj/structure/flora/bush/flowers_br/style_random,
/turf/open/misc/grass/lavaland,
/area/ruin/unpowered/gaia)
"bH" = (
/obj/structure/flora/grass/jungle/a/style_random,
/turf/closed/indestructible/riveted/boss,
/area/lavaland/surface/outdoors)
"cG" = (
/obj/structure/stone_tile/cracked,
/turf/closed/mineral/volcanic/lava_land_surface,
/area/lavaland/surface/outdoors)
"cZ" = (
/obj/structure/flora/bush/stalky/style_random,
/obj/structure/flora/bush/fullgrass/style_random,
/turf/open/floor/bronze/filled/lavaland,
/area/ruin/unpowered/gaia)
"ee" = (
/obj/structure/flora/bush/fullgrass/style_random,
/turf/open/misc/grass/lavaland,
/area/ruin/unpowered/gaia)
"eP" = (
/obj/structure/flora/bush/sparsegrass/style_random,
/turf/open/misc/grass/lavaland,
/area/ruin/unpowered/gaia)
"go" = (
/obj/structure/flora/bush/lavendergrass/style_random,
/turf/open/misc/grass/lavaland,
/area/ruin/unpowered/gaia)
"hM" = (
/obj/structure/stone_tile/block,
/obj/structure/stone_tile/block{
	dir = 1
	},
/turf/closed/mineral/volcanic/lava_land_surface,
/area/lavaland/surface/outdoors)
"ia" = (
/obj/structure/flora/bush/lavendergrass/style_random,
/obj/structure/flora/bush/fullgrass/style_random,
/turf/open/misc/grass/lavaland,
/area/ruin/unpowered/gaia)
"it" = (
/obj/structure/flora/bush/ferny/style_random,
/obj/structure/flora/bush/lavendergrass/style_random,
/turf/open/misc/grass/lavaland,
/area/ruin/unpowered/gaia)
"iF" = (
/obj/structure/stone_tile/block,
/turf/closed/mineral/volcanic/lava_land_surface,
/area/lavaland/surface/outdoors)
"iK" = (
/obj/structure/stone_tile,
/obj/structure/stone_tile{
	dir = 8
	},
/obj/structure/stone_tile{
	dir = 1
	},
/turf/closed/mineral/volcanic/lava_land_surface,
/area/lavaland/surface/outdoors)
"jb" = (
/obj/structure/stone_tile,
/obj/structure/stone_tile{
	dir = 8
	},
/obj/structure/stone_tile{
	dir = 4
	},
/obj/structure/stone_tile/cracked{
	dir = 1
	},
/turf/closed/mineral/volcanic/lava_land_surface,
/area/lavaland/surface/outdoors)
"jd" = (
/mob/living/basic/butterfly/lavaland,
/obj/structure/flora/grass/jungle/b/style_random,
/turf/open/misc/grass/lavaland,
/area/ruin/unpowered/gaia)
"jf" = (
/obj/structure/stone_tile/surrounding_tile,
/obj/structure/stone_tile/surrounding_tile{
	dir = 4
	},
/obj/structure/stone_tile/center,
/turf/closed/mineral/volcanic/lava_land_surface,
/area/lavaland/surface/outdoors)
"jZ" = (
/obj/structure/stone_tile/surrounding_tile{
	dir = 8
	},
/obj/structure/stone_tile/surrounding_tile{
	dir = 1
	},
/obj/structure/stone_tile/center/cracked,
/turf/closed/mineral/volcanic/lava_land_surface,
/area/lavaland/surface/outdoors)
"lK" = (
/obj/structure/stone_tile/block/burnt,
/turf/closed/mineral/volcanic/lava_land_surface,
/area/lavaland/surface/outdoors)
"lL" = (
/obj/structure/flora/bush/flowers_yw/style_random,
/turf/open/misc/grass/lavaland,
/area/ruin/unpowered/gaia)
"lZ" = (
/obj/structure/stone_tile/surrounding/cracked{
	dir = 6
	},
/obj/structure/stone_tile/center/cracked,
/turf/closed/mineral/volcanic/lava_land_surface,
/area/lavaland/surface/outdoors)
"mO" = (
/obj/structure/stone_tile/surrounding_tile,
/obj/structure/stone_tile/surrounding_tile{
	dir = 4
	},
/turf/closed/mineral/volcanic/lava_land_surface,
/area/lavaland/surface/outdoors)
"ph" = (
/obj/structure/flora/bush/stalky/style_random,
/obj/structure/flora/bush/fullgrass/style_random,
/turf/open/misc/grass/lavaland,
/area/ruin/unpowered/gaia)
"pZ" = (
/mob/living/basic/lightgeist{
	light_color = "#42ECFF"
	},
/turf/open/misc/grass/lavaland,
/area/ruin/unpowered/gaia)
"qd" = (
/mob/living/basic/butterfly/lavaland,
/obj/structure/flora/bush/lavendergrass/style_random,
/turf/closed/wall/mineral/bronze,
/area/ruin/unpowered/gaia)
"qi" = (
/obj/structure/flora/grass/jungle/a/style_random,
/obj/structure/flora/tree/jungle/small/style_random,
/turf/open/misc/grass/lavaland,
/area/ruin/unpowered/gaia)
"rg" = (
/obj/structure/stone_tile/surrounding/cracked,
/turf/closed/mineral/volcanic/lava_land_surface,
/area/lavaland/surface/outdoors)
"rm" = (
/obj/structure/stone_tile/surrounding_tile{
	dir = 4
	},
/obj/structure/stone_tile/surrounding_tile,
/obj/structure/stone_tile/center,
/turf/closed/mineral/volcanic/lava_land_surface,
/area/lavaland/surface/outdoors)
"sa" = (
/turf/closed/wall/mineral/bronze,
/area/ruin/unpowered/gaia)
"sh" = (
/obj/structure/flora/grass/jungle/b/style_random,
/obj/structure/flora/bush/flowers_br/style_random,
/turf/open/misc/grass/lavaland,
/area/ruin/unpowered/gaia)
"ti" = (
/obj/machinery/hydroponics/soil{
	self_sustaining = 1
	},
/turf/open/misc/grass/lavaland,
/area/ruin/unpowered/gaia)
"tC" = (
/obj/structure/flora/grass/jungle/b/style_random,
/turf/closed/indestructible/riveted/boss,
/area/lavaland/surface/outdoors)
"tG" = (
/obj/structure/stone_tile/slab/burnt,
/turf/closed/mineral/volcanic/lava_land_surface,
/area/lavaland/surface/outdoors)
"uH" = (
/obj/structure/flora/grass/jungle/a/style_random,
/turf/open/floor/bronze/filled/lavaland,
/area/ruin/unpowered/gaia)
"uS" = (
/obj/structure/stone_tile/slab/cracked{
	dir = 1
	},
/turf/closed/mineral/volcanic/lava_land_surface,
/area/lavaland/surface/outdoors)
"vK" = (
/obj/structure/stone_tile/surrounding_tile{
	dir = 1
	},
/obj/structure/stone_tile/surrounding_tile{
	dir = 8
	},
/obj/structure/stone_tile/center/burnt,
/turf/closed/mineral/volcanic/lava_land_surface,
/area/lavaland/surface/outdoors)
"wh" = (
/obj/structure/stone_tile/slab/cracked{
	dir = 6
	},
/turf/closed/mineral/volcanic/lava_land_surface,
/area/lavaland/surface/outdoors)
"wB" = (
/obj/structure/flora/grass/jungle/a/style_random,
/mob/living/basic/butterfly/lavaland,
/turf/open/misc/grass/lavaland,
/area/ruin/unpowered/gaia)
"wX" = (
/obj/structure/stone_tile/block/cracked,
/turf/closed/mineral/volcanic/lava_land_surface,
/area/lavaland/surface/outdoors)
"xO" = (
/mob/living/basic/butterfly/lavaland,
/turf/open/misc/grass/lavaland,
/area/ruin/unpowered/gaia)
"ye" = (
/obj/item/mod/construction/lavalandcore,
/turf/open/misc/grass/lavaland,
/area/ruin/unpowered/gaia)
"yf" = (
/obj/structure/stone_tile/burnt,
/turf/closed/mineral/volcanic/lava_land_surface,
/area/lavaland/surface/outdoors)
"zH" = (
/obj/structure/flora/bush/sunny/style_random,
/obj/structure/flora/bush/flowers_br/style_random,
/turf/open/misc/grass/lavaland,
/area/ruin/unpowered/gaia)
"zN" = (
/obj/structure/flora/grass/jungle/b/style_random,
/obj/effect/spawner/random/food_or_drink/seed_rare,
/turf/open/misc/grass/lavaland,
/area/ruin/unpowered/gaia)
"zV" = (
/obj/structure/flora/grass/jungle/a/style_random,
/mob/living/basic/lightgeist{
	light_color = "#42ECFF"
	},
/turf/open/misc/grass/lavaland,
/area/ruin/unpowered/gaia)
"Ad" = (
/obj/structure/flora/bush/flowers_br/style_random,
/obj/item/food/grown/mushroom/amanita,
/turf/open/floor/bronze/filled/lavaland,
/area/ruin/unpowered/gaia)
"Aw" = (
/obj/structure/flora/tree/jungle/style_random,
/turf/open/misc/grass/lavaland,
/area/ruin/unpowered/gaia)
"Db" = (
/turf/open/floor/bronze/filled/lavaland,
/area/ruin/unpowered/gaia)
"DF" = (
/obj/structure/stone_tile/surrounding_tile{
	dir = 1
	},
/obj/structure/stone_tile/surrounding_tile{
	dir = 8
	},
/obj/structure/stone_tile/center/cracked,
/turf/closed/mineral/volcanic/lava_land_surface,
/area/lavaland/surface/outdoors)
"DH" = (
/obj/item/food/grown/mushroom/chanterelle,
/turf/open/misc/grass/lavaland,
/area/ruin/unpowered/gaia)
"DP" = (
/obj/item/food/grown/mushroom/libertycap,
/turf/open/misc/grass/lavaland,
/area/ruin/unpowered/gaia)
"DV" = (
/obj/structure/stone_tile/block,
/obj/structure/stone_tile/block/cracked{
	dir = 1
	},
/mob/living/basic/mining/brimdemon,
/turf/closed/mineral/volcanic/lava_land_surface,
/area/lavaland/surface/outdoors)
"Ey" = (
/obj/structure/stone_tile/slab/cracked,
/turf/closed/mineral/volcanic/lava_land_surface,
/area/lavaland/surface/outdoors)
"FL" = (
/mob/living/basic/butterfly/lavaland,
/obj/structure/flora/bush/ferny/style_random,
/turf/open/misc/grass/lavaland,
/area/ruin/unpowered/gaia)
"Gc" = (
/obj/structure/flora/bush/ferny/style_random,
/turf/open/misc/grass/lavaland,
/area/ruin/unpowered/gaia)
"GT" = (
/obj/structure/flora/rock/style_random,
/turf/closed/mineral/volcanic/lava_land_surface,
/area/lavaland/surface/outdoors)
"IT" = (
/obj/structure/stone_tile{
	dir = 8
	},
/obj/structure/stone_tile{
	dir = 1
	},
/obj/structure/stone_tile{
	dir = 4
	},
/obj/structure/stone_tile/cracked,
/turf/closed/mineral/volcanic/lava_land_surface,
/area/lavaland/surface/outdoors)
"JI" = (
/obj/structure/flora/tree/jungle/small/style_random,
/turf/open/misc/grass/lavaland,
/area/ruin/unpowered/gaia)
"KK" = (
/obj/structure/flora/grass/jungle/a/style_random,
/turf/open/misc/grass/lavaland,
/area/ruin/unpowered/gaia)
"LN" = (
/obj/effect/mapping_helpers/bombable_wall,
/turf/closed/indestructible/riveted/boss/wasteland,
/area/lavaland/surface/outdoors)
"Mw" = (
/obj/structure/stone_tile/block/cracked{
	dir = 1
	},
/turf/closed/mineral/volcanic/lava_land_surface,
/area/lavaland/surface/outdoors)
"MO" = (
/obj/item/food/grown/mushroom/amanita,
/turf/open/floor/bronze/filled/lavaland,
/area/ruin/unpowered/gaia)
"MQ" = (
/obj/structure/flora/grass/jungle/b/style_random,
/obj/structure/flora/bush/lavendergrass/style_random,
/turf/open/misc/grass/lavaland,
/area/ruin/unpowered/gaia)
"MU" = (
/obj/structure/stone_tile/block{
	dir = 1
	},
/obj/structure/stone_tile/block/cracked,
/turf/closed/mineral/volcanic/lava_land_surface,
/area/lavaland/surface/outdoors)
"MZ" = (
/obj/structure/flora/bush/fullgrass/style_random,
/obj/item/mod/construction/lavalandcore,
/turf/open/floor/bronze/filled/lavaland,
/area/ruin/unpowered/gaia)
"Pl" = (
/obj/structure/stone_tile/slab/cracked{
	dir = 4
	},
/turf/closed/mineral/volcanic/lava_land_surface,
/area/lavaland/surface/outdoors)
"PG" = (
/obj/structure/flora/bush/flowers_br/style_random,
/turf/open/floor/bronze/filled/lavaland,
/area/ruin/unpowered/gaia)
"Qg" = (
/obj/structure/flora/rock/pile/style_random,
/turf/closed/mineral/volcanic/lava_land_surface,
/area/lavaland/surface/outdoors)
"QG" = (
/obj/structure/stone_tile/cracked{
	dir = 4
	},
/turf/closed/mineral/volcanic/lava_land_surface,
/area/lavaland/surface/outdoors)
"Sh" = (
/obj/structure/stone_tile/surrounding_tile{
	dir = 1
	},
/turf/closed/mineral/volcanic/lava_land_surface,
/area/lavaland/surface/outdoors)
"Sj" = (
/obj/structure/flora/grass/jungle/b/style_random,
/turf/open/floor/bronze/filled/lavaland,
/area/ruin/unpowered/gaia)
"SG" = (
/obj/structure/stone_tile/block{
	dir = 1
	},
/obj/structure/stone_tile/block,
/turf/closed/mineral/volcanic/lava_land_surface,
/area/lavaland/surface/outdoors)
"SY" = (
/obj/structure/flora/bush/lavendergrass/style_random,
/obj/item/mod/construction/lavalandcore,
/turf/open/misc/grass/lavaland,
/area/ruin/unpowered/gaia)
"Tf" = (
/obj/structure/stone_tile/surrounding_tile{
	dir = 4
	},
/obj/structure/stone_tile/surrounding_tile,
/obj/structure/stone_tile/center/burnt,
/turf/closed/mineral/volcanic/lava_land_surface,
/area/lavaland/surface/outdoors)
"TH" = (
/obj/structure/flora/bush/flowers_br/style_random,
/turf/closed/wall/mineral/bronze,
/area/ruin/unpowered/gaia)
"VN" = (
/turf/closed/indestructible/riveted/boss,
/area/lavaland/surface/outdoors)
"Wu" = (
/obj/structure/flora/bush/fullgrass/style_random,
/turf/open/floor/bronze/filled/lavaland,
/area/ruin/unpowered/gaia)
"Wv" = (
/obj/structure/flora/bush/sparsegrass/style_random,
/obj/effect/spawner/random/food_or_drink/salad,
/turf/open/misc/grass/lavaland,
/area/ruin/unpowered/gaia)
"Ww" = (
/obj/structure/stone_tile/slab,
/mob/living/basic/mining/goliath,
/turf/closed/mineral/volcanic/lava_land_surface,
/area/lavaland/surface/outdoors)
"XN" = (
/turf/closed/mineral/volcanic/lava_land_surface,
/area/lavaland/surface/outdoors)
"YN" = (
/obj/structure/flora/grass/jungle/b/style_random,
/obj/item/food/grown/mushroom/angel,
/turf/open/misc/grass/lavaland,
/area/ruin/unpowered/gaia)
"YZ" = (
/obj/structure/flora/grass/jungle/b/style_random,
/obj/structure/flora/bush/flowers_yw/style_random,
/turf/open/misc/grass/lavaland,
/area/ruin/unpowered/gaia)
"Za" = (
/turf/template_noop,
/area/template_noop)

(1,1,1) = {"
Za
Za
VN
VN
Za
Za
DV
mO
vK
hM
wh
Za
Za
Za
Za
Za
"}
(2,1,1) = {"
Za
Za
Qg
XN
XN
aL
lK
Sh
Tf
iF
yf
Qg
Ey
Za
Za
Za
"}
(3,1,1) = {"
Za
XN
XN
VN
VN
VN
VN
VN
VN
LN
VN
VN
XN
XN
GT
Za
"}
(4,1,1) = {"
Za
XN
VN
VN
VN
VN
Db
Aw
uH
jd
VN
VN
VN
XN
XN
Qg
"}
(5,1,1) = {"
VN
Pl
VN
VN
tC
KK
DP
ph
br
it
YZ
VN
VN
VN
XN
XN
"}
(6,1,1) = {"
XN
Mw
VN
VN
br
wB
Sj
KK
br
zV
DP
KK
VN
VN
cG
Za
"}
(7,1,1) = {"
GT
QG
VN
eP
KK
aw
KK
SY
Ad
eP
qd
aJ
MQ
VN
wX
Za
"}
(8,1,1) = {"
XN
XN
VN
aJ
Wu
ia
pZ
zH
aJ
uH
ee
cZ
aJ
VN
Qg
Za
"}
(9,1,1) = {"
Za
Qg
VN
PG
KK
ti
zH
Wv
Wu
br
MZ
xO
JI
VN
XN
VN
"}
(10,1,1) = {"
Za
XN
VN
pZ
lL
MO
ye
sh
sa
SY
uH
br
Gc
VN
cG
VN
"}
(11,1,1) = {"
Za
Mw
bH
VN
qi
YN
TH
eP
PG
br
lL
zN
VN
VN
wX
VN
"}
(12,1,1) = {"
VN
tG
VN
VN
VN
jd
sh
Wu
aJ
FL
DH
VN
VN
VN
XN
VN
"}
(13,1,1) = {"
Za
XN
VN
VN
VN
VN
Wu
go
lL
ee
VN
VN
VN
XN
XN
Qg
"}
(14,1,1) = {"
Za
Qg
XN
VN
VN
VN
VN
LN
VN
VN
VN
VN
XN
Qg
Za
Za
"}
(15,1,1) = {"
Za
Za
XN
rg
aL
av
aL
SG
jf
DF
MU
Ey
IT
Pl
GT
Za
"}
(16,1,1) = {"
Za
Za
Za
lZ
Ey
iK
aL
Mw
jZ
rm
SG
Ww
jb
uS
Za
Za
"}
