//MAP CONVERTED BY dmm2tgm.py THIS HEADER COMMENT PREVENTS RECONVERSION, DO NOT REMOVE
"co" = (
/obj/structure/railing/stone/left,
/obj/effect/spawner/random/structure/spikes,
/turf/closed/mineral/random/high_chance/volcanic,
/area/lavaland/surface/outdoors)
"cs" = (
/obj/structure/stone_tile/block{
	dir = 8
	},
/obj/structure/stone_tile/block{
	dir = 4
	},
/turf/closed/mineral/volcanic/lava_land_surface,
/area/lavaland/surface/outdoors)
"cQ" = (
/obj/structure/stone_tile,
/obj/effect/spawner/random/mob/necropolis_mob,
/turf/closed/mineral/volcanic/lava_land_surface,
/area/lavaland/surface/outdoors)
"cZ" = (
/obj/structure/stone_tile/surrounding/cracked{
	dir = 1
	},
/turf/open/lava/smooth/lava_land_surface,
/area/lavaland/surface/outdoors)
"ex" = (
/obj/structure/stone_tile/block,
/turf/open/lava/smooth/lava_land_surface,
/area/lavaland/surface/outdoors)
"eF" = (
/obj/structure/stone_tile/block/burnt{
	dir = 1
	},
/turf/closed/mineral/volcanic/lava_land_surface,
/area/lavaland/surface/outdoors)
"ge" = (
/obj/structure/stone_tile/surrounding_tile{
	dir = 8
	},
/obj/effect/spawner/random/structure/spikes,
/turf/closed/mineral/volcanic/lava_land_surface,
/area/lavaland/surface/outdoors)
"kl" = (
/obj/structure/stone_tile/cracked{
	dir = 4
	},
/turf/closed/mineral/volcanic/lava_land_surface,
/area/lavaland/surface/outdoors)
"kN" = (
/obj/structure/stone_tile/block{
	dir = 8
	},
/turf/closed/mineral/volcanic/lava_land_surface,
/area/lavaland/surface/outdoors)
"kR" = (
/obj/structure/stone_tile/surrounding/cracked{
	dir = 6
	},
/obj/structure/railing/stone/left,
/turf/closed/mineral/volcanic/lava_land_surface,
/area/lavaland/surface/outdoors)
"lc" = (
/obj/structure/stone_tile/surrounding_tile/burnt{
	dir = 1
	},
/obj/structure/railing/stone/left,
/obj/effect/spawner/random/mob/brimdemon,
/turf/closed/mineral/volcanic/lava_land_surface,
/area/lavaland/surface/outdoors)
"lK" = (
/obj/structure/ore_vein,
/turf/closed/mineral/volcanic/lava_land_surface,
/area/lavaland/surface/outdoors)
"lQ" = (
/obj/structure/stone_tile/center/cracked,
/obj/structure/stone_tile/surrounding/cracked,
/turf/closed/mineral/volcanic/lava_land_surface,
/area/lavaland/surface/outdoors)
"ml" = (
/obj/structure/flora/rock/pile/style_random,
/turf/closed/mineral/volcanic/lava_land_surface,
/area/lavaland/surface/outdoors)
"nz" = (
/obj/structure/stone_tile/block/cracked{
	dir = 8
	},
/turf/closed/mineral/volcanic/lava_land_surface,
/area/lavaland/surface/outdoors)
"oh" = (
/obj/structure/stone_tile/surrounding/burnt,
/turf/closed/mineral/volcanic/lava_land_surface,
/area/lavaland/surface/outdoors)
"oW" = (
/obj/structure/flora/rock/style_random,
/obj/item/xenoarch/useless_relic/magnified{
	name = "Ancient relic";
	desc = "Sort of relic that can be exported through Cargo."
	},
/turf/closed/mineral/volcanic/lava_land_surface,
/area/lavaland/surface/outdoors)
"qr" = (
/obj/structure/railing/stone,
/obj/item/xenoarch/useless_relic/magnified{
	name = "Ancient relic";
	desc = "Sort of relic that can be exported through Cargo."
	},
/turf/closed/mineral/volcanic/lava_land_surface,
/area/lavaland/surface/outdoors)
"qu" = (
/obj/structure/stone_tile/burnt,
/obj/structure/railing/stone/right,
/obj/effect/spawner/random/structure/spikes,
/turf/closed/mineral/volcanic/lava_land_surface,
/area/lavaland/surface/outdoors)
"rE" = (
/obj/structure/stone_tile/block,
/obj/structure/stone_tile/block/cracked{
	dir = 1
	},
/turf/closed/mineral/volcanic/lava_land_surface,
/area/lavaland/surface/outdoors)
"tg" = (
/obj/structure/stone_tile/surrounding_tile/cracked,
/obj/structure/stone_tile/surrounding_tile/burnt{
	dir = 4
	},
/turf/closed/mineral/volcanic/lava_land_surface,
/area/lavaland/surface/outdoors)
"tQ" = (
/obj/structure/stone_tile,
/obj/item/xenoarch/useless_relic{
	name = "Ancient relic";
	desc = "Sort of relic that can be exported through Cargo."
	},
/turf/closed/mineral/volcanic/lava_land_surface,
/area/lavaland/surface/outdoors)
"uS" = (
/obj/structure/stone_tile/surrounding_tile/cracked{
	dir = 1
	},
/turf/closed/mineral/volcanic/lava_land_surface,
/area/lavaland/surface/outdoors)
"wf" = (
/obj/structure/stone_tile/slab/cracked,
/obj/effect/spawner/random/mob/brimdemon,
/turf/closed/mineral/volcanic/lava_land_surface,
/area/lavaland/surface/outdoors)
"wp" = (
/obj/structure/stone_tile/surrounding/cracked,
/turf/closed/mineral/volcanic/lava_land_surface,
/area/lavaland/surface/outdoors)
"xd" = (
/obj/structure/stone_tile/slab/burnt,
/turf/open/lava/smooth/lava_land_surface,
/area/lavaland/surface/outdoors)
"xk" = (
/turf/closed/mineral/volcanic/lava_land_surface,
/area/lavaland/surface/outdoors)
"xp" = (
/obj/structure/stone_tile,
/obj/structure/stone_tile{
	dir = 1
	},
/obj/structure/stone_tile/burnt{
	dir = 4
	},
/turf/closed/mineral/volcanic/lava_land_surface,
/area/lavaland/surface/outdoors)
"xC" = (
/obj/effect/spawner/random/structure/spikes,
/turf/closed/mineral/volcanic/lava_land_surface,
/area/lavaland/surface/outdoors)
"xU" = (
/obj/structure/stone_tile,
/obj/structure/stone_tile{
	dir = 8
	},
/obj/structure/stone_tile{
	dir = 1
	},
/obj/structure/railing/stone/right,
/turf/closed/mineral/volcanic/lava_land_surface,
/area/lavaland/surface/outdoors)
"yD" = (
/obj/structure/railing/stone/right,
/obj/structure/stone_tile/surrounding/burnt,
/obj/structure/stone_tile/center/burnt,
/turf/closed/mineral/volcanic/lava_land_surface,
/area/lavaland/surface/outdoors)
"yM" = (
/obj/structure/stone_tile/slab/cracked{
	dir = 8
	},
/obj/structure/stone_tile/slab/cracked{
	dir = 4
	},
/turf/open/lava/smooth/lava_land_surface,
/area/lavaland/surface/outdoors)
"yQ" = (
/obj/structure/stone_tile/surrounding_tile,
/obj/structure/railing/stone,
/obj/effect/spawner/random/structure/spikes,
/turf/closed/mineral/volcanic/lava_land_surface,
/area/lavaland/surface/outdoors)
"zh" = (
/obj/structure/stone_tile/surrounding_tile/burnt{
	dir = 8
	},
/obj/structure/railing/stone,
/obj/effect/spawner/random/structure/spikes,
/turf/closed/mineral/volcanic/lava_land_surface,
/area/lavaland/surface/outdoors)
"Ak" = (
/obj/structure/stone_tile/block/burnt{
	dir = 1
	},
/obj/structure/stone_tile/block,
/turf/open/lava/smooth/lava_land_surface,
/area/lavaland/surface/outdoors)
"Ax" = (
/obj/structure/stone_tile/slab/cracked,
/turf/closed/mineral/volcanic/lava_land_surface,
/area/lavaland/surface/outdoors)
"CL" = (
/obj/effect/spawner/random/structure/spikes,
/turf/closed/mineral/random/high_chance/volcanic,
/area/lavaland/surface/outdoors)
"Dn" = (
/obj/structure/stone_tile/slab/burnt,
/obj/effect/spawner/random/mob/brimdemon,
/turf/open/misc/asteroid/basalt/lava_land_surface,
/area/lavaland/surface/outdoors)
"Fh" = (
/obj/effect/mapping_helpers/bombable_wall,
/turf/closed/indestructible/riveted/boss/wasteland,
/area/lavaland/surface/outdoors)
"FB" = (
/obj/structure/railing/stone,
/obj/structure/stone_tile,
/turf/closed/mineral/volcanic/lava_land_surface,
/area/lavaland/surface/outdoors)
"HX" = (
/obj/structure/stone_tile/block/burnt,
/obj/effect/spawner/random/structure/spikes,
/turf/closed/mineral/volcanic/lava_land_surface,
/area/lavaland/surface/outdoors)
"Im" = (
/obj/structure/stone_tile/slab/cracked{
	dir = 4
	},
/obj/structure/stone_tile/slab/cracked{
	dir = 8
	},
/turf/closed/mineral/volcanic/lava_land_surface,
/area/lavaland/surface/outdoors)
"In" = (
/obj/structure/stone_tile/surrounding/cracked{
	dir = 8
	},
/turf/closed/mineral/volcanic/lava_land_surface,
/area/lavaland/surface/outdoors)
"Jt" = (
/obj/structure/stone_tile,
/turf/open/lava/smooth/lava_land_surface,
/area/lavaland/surface/outdoors)
"Ls" = (
/obj/structure/stone_tile/block/burnt{
	dir = 4
	},
/turf/open/lava/smooth/lava_land_surface,
/area/lavaland/surface/outdoors)
"Nq" = (
/obj/structure/stone_tile/surrounding_tile/burnt{
	dir = 1
	},
/turf/open/lava/smooth/lava_land_surface,
/area/lavaland/surface/outdoors)
"NH" = (
/obj/structure/stone_tile/cracked{
	dir = 4
	},
/turf/open/lava/smooth/lava_land_surface,
/area/lavaland/surface/outdoors)
"Oh" = (
/obj/structure/stone_tile,
/turf/closed/mineral/random/high_chance/volcanic,
/area/lavaland/surface/outdoors)
"Ov" = (
/obj/structure/stone_tile{
	dir = 1
	},
/turf/closed/mineral/volcanic/lava_land_surface,
/area/lavaland/surface/outdoors)
"Ox" = (
/obj/structure/stone_tile/burnt,
/obj/structure/stone_tile/burnt{
	dir = 1
	},
/obj/structure/stone_tile/cracked{
	dir = 4
	},
/turf/open/misc/asteroid/basalt/lava_land_surface,
/area/lavaland/surface/outdoors)
"PF" = (
/obj/structure/stone_tile/center/burnt,
/turf/open/lava/smooth/lava_land_surface,
/area/lavaland/surface/outdoors)
"PY" = (
/obj/structure/stone_tile/slab/cracked,
/obj/effect/spawner/random/mob/necropolis_mob,
/turf/closed/mineral/volcanic/lava_land_surface,
/area/lavaland/surface/outdoors)
"Qb" = (
/obj/structure/stone_tile/slab/cracked{
	dir = 6
	},
/turf/closed/mineral/volcanic/lava_land_surface,
/area/lavaland/surface/outdoors)
"QJ" = (
/obj/structure/stone_tile/slab/burnt,
/turf/closed/mineral/volcanic/lava_land_surface,
/area/lavaland/surface/outdoors)
"QZ" = (
/turf/template_noop,
/area/template_noop)
"Sf" = (
/obj/structure/stone_tile/slab/cracked,
/turf/open/lava/smooth/lava_land_surface,
/area/lavaland/surface/outdoors)
"Uf" = (
/turf/closed/indestructible/riveted/boss,
/area/lavaland/surface/outdoors)
"UI" = (
/obj/structure/stone_tile/surrounding_tile/burnt{
	dir = 8
	},
/turf/closed/mineral/volcanic/lava_land_surface,
/area/lavaland/surface/outdoors)
"Vq" = (
/obj/structure/stone_tile/surrounding_tile/cracked{
	dir = 4
	},
/obj/structure/stone_tile/surrounding_tile/burnt,
/turf/closed/mineral/volcanic/lava_land_surface,
/area/lavaland/surface/outdoors)
"YO" = (
/obj/structure/stone_tile/surrounding_tile{
	dir = 8
	},
/obj/effect/spawner/random/structure/spikes,
/turf/closed/mineral/random/high_chance/volcanic,
/area/lavaland/surface/outdoors)
"Ze" = (
/obj/structure/railing/stone,
/obj/effect/spawner/random/structure/spikes,
/turf/closed/mineral/volcanic/lava_land_surface,
/area/lavaland/surface/outdoors)

(1,1,1) = {"
QZ
QZ
QZ
QZ
nz
QZ
Ov
PY
ge
QZ
"}
(2,1,1) = {"
QZ
QZ
QZ
Fh
Fh
Uf
cs
kN
QZ
QZ
"}
(3,1,1) = {"
QZ
lQ
QZ
NH
Sf
eF
Vq
uS
QZ
QZ
"}
(4,1,1) = {"
xk
oh
QJ
xp
xd
ex
UI
tg
HX
QZ
"}
(5,1,1) = {"
xk
Uf
Uf
oW
lc
cZ
Ls
kN
kR
QZ
"}
(6,1,1) = {"
xk
Ax
Uf
Uf
qr
uS
yM
Dn
yQ
QZ
"}
(7,1,1) = {"
QZ
QZ
kl
Uf
yD
kl
Nq
Ox
Ze
ml
"}
(8,1,1) = {"
QZ
QZ
cQ
Oh
In
xC
Ak
Jt
Ze
QZ
"}
(9,1,1) = {"
Fh
tQ
kl
YO
co
xC
wp
PF
FB
xk
"}
(10,1,1) = {"
Fh
Fh
Uf
Qb
Ze
CL
QJ
wf
zh
xC
"}
(11,1,1) = {"
QZ
Im
Uf
Uf
xU
ml
xk
rE
qu
QZ
"}
(12,1,1) = {"
QZ
xC
xk
lK
xk
QZ
Im
QZ
QZ
QZ
"}
