//MAP CONVERTED BY dmm2tgm.py THIS HEADER COMMENT PREVENTS RECONVERSION, DO NOT REMOVE
"a" = (
/turf/template_noop,
/area/template_noop)
"c" = (
/obj/structure/stone_tile/surrounding/cracked{
	dir = 8
	},
/obj/structure/stone_tile/slab/cracked{
	dir = 8
	},
/turf/open/indestructible/necropolis,
/area/ruin/unpowered)
"e" = (
/obj/structure/stone_tile/block/burnt{
	dir = 8
	},
/turf/open/indestructible/necropolis,
/area/ruin/unpowered)
"f" = (
/turf/closed/indestructible/riveted/boss,
/area/lavaland/surface/outdoors)
"h" = (
/obj/structure/stone_tile/slab/cracked{
	dir = 4
	},
/obj/structure/stone_tile/slab/cracked{
	dir = 8
	},
/turf/open/chasm/lavaland,
/area/ruin/unpowered)
"i" = (
/obj/structure/stone_tile/burnt{
	dir = 1
	},
/obj/structure/stone_tile/burnt{
	dir = 4
	},
/turf/open/chasm/lavaland,
/area/ruin/unpowered)
"j" = (
/obj/structure/stone_tile/block/cracked{
	dir = 4
	},
/turf/open/indestructible/necropolis,
/area/ruin/unpowered)
"l" = (
/obj/structure/stone_tile/burnt,
/turf/open/chasm/lavaland,
/area/ruin/unpowered)
"o" = (
/obj/structure/stone_tile/surrounding/cracked,
/turf/open/indestructible/necropolis,
/area/ruin/unpowered)
"p" = (
/obj/structure/stone_tile/block/cracked,
/obj/structure/stone_tile/cracked{
	dir = 1
	},
/turf/open/chasm/lavaland,
/area/ruin/unpowered)
"q" = (
/obj/structure/stone_tile/surrounding_tile/cracked{
	dir = 5
	},
/obj/structure/stone_tile/center/burnt,
/mob/living/simple_animal/hostile/megafauna/wendigo{
	name = "Hunger";
	speed = 1;
	health = 1500;
	maxHealth = 1500;
	desc = "An ancient demon, a spirit of the old nature. Chained. Hungry.";
	light_color = "#333333";
	color = "#333333"
	},
/obj/effect/decal/cleanable/grand_remains,
/obj/effect/gibspawner/human/bodypartless,
/obj/item/gun/ballistic/bow/tribalbow/ashen{
	projectile_damage_multiplier = 2;
	name = "Living bow";
	attack_speed = 6;
	desc = "Some sort of primitive projectile weapon made of bone and wrapped sinew, something wrong with it."
	},
/obj/structure/marker_beacon/burgundy,
/obj/item/stack/ore/diamond{
	amount = 25
	},
/turf/open/indestructible/necropolis,
/area/ruin/unpowered)
"r" = (
/obj/structure/stone_tile/block/burnt,
/turf/open/indestructible/necropolis,
/area/ruin/unpowered)
"s" = (
/turf/closed/indestructible/riveted/boss,
/area/ruin/unpowered)
"t" = (
/obj/effect/mapping_helpers/bombable_wall,
/obj/structure/stone_tile/slab/cracked,
/turf/closed/indestructible/riveted/boss/wasteland,
/area/lavaland/surface/outdoors)
"u" = (
/obj/structure/fluff/big_chain{
	pixel_y = 12
	},
/turf/closed/indestructible/riveted/boss,
/area/ruin/unpowered)
"v" = (
/obj/structure/stone_tile/cracked{
	dir = 4
	},
/obj/structure/stone_tile/surrounding_tile/cracked{
	dir = 8
	},
/turf/open/chasm/lavaland,
/area/ruin/unpowered)
"w" = (
/obj/structure/stone_tile/surrounding/cracked{
	dir = 4
	},
/turf/open/chasm/lavaland,
/area/ruin/unpowered)
"y" = (
/obj/structure/stone_tile/surrounding_tile/cracked,
/turf/open/chasm/lavaland,
/area/ruin/unpowered)
"z" = (
/obj/structure/stone_tile/cracked{
	dir = 8
	},
/turf/open/chasm/lavaland,
/area/ruin/unpowered)
"A" = (
/obj/structure/stone_tile/surrounding/cracked{
	dir = 1
	},
/obj/structure/stone_tile/slab/cracked{
	dir = 1
	},
/turf/open/indestructible/necropolis,
/area/ruin/unpowered)
"B" = (
/obj/structure/fluff/big_chain{
	pixel_y = 12
	},
/turf/closed/indestructible/riveted/boss,
/area/lavaland/surface/outdoors)
"C" = (
/obj/structure/stone_tile/block/burnt{
	dir = 8
	},
/turf/open/chasm/lavaland,
/area/ruin/unpowered)
"E" = (
/obj/structure/stone_tile/surrounding/cracked{
	dir = 6
	},
/turf/open/chasm/lavaland,
/area/ruin/unpowered)
"F" = (
/obj/structure/stone_tile/surrounding/cracked{
	dir = 4
	},
/turf/open/indestructible/necropolis,
/area/ruin/unpowered)
"G" = (
/obj/effect/mapping_helpers/bombable_wall,
/obj/structure/stone_tile/slab/burnt,
/turf/closed/indestructible/riveted/boss/wasteland,
/area/lavaland/surface/outdoors)
"H" = (
/obj/structure/stone_tile/block{
	dir = 4
	},
/turf/open/chasm/lavaland,
/area/ruin/unpowered)
"I" = (
/obj/effect/mapping_helpers/bombable_wall,
/obj/structure/stone_tile/slab,
/turf/closed/indestructible/riveted/boss/wasteland,
/area/lavaland/surface/outdoors)
"J" = (
/obj/structure/stone_tile/block/cracked{
	dir = 4
	},
/turf/open/chasm/lavaland,
/area/ruin/unpowered)
"K" = (
/obj/structure/stone_tile/cracked{
	dir = 4
	},
/obj/structure/stone_tile/block/burnt,
/turf/open/chasm/lavaland,
/area/ruin/unpowered)
"L" = (
/obj/effect/mapping_helpers/bombable_wall,
/turf/closed/indestructible/riveted/boss/wasteland,
/area/ruin/unpowered)
"M" = (
/obj/structure/stone_tile/slab/cracked{
	dir = 10
	},
/obj/structure/stone_tile/surrounding/cracked{
	dir = 8
	},
/turf/open/chasm/lavaland,
/area/ruin/unpowered)
"N" = (
/obj/structure/stone_tile/block/cracked{
	dir = 8
	},
/turf/open/chasm/lavaland,
/area/ruin/unpowered)
"O" = (
/obj/structure/stone_tile/block/cracked{
	dir = 1
	},
/turf/open/indestructible/necropolis,
/area/ruin/unpowered)
"P" = (
/obj/structure/stone_tile/surrounding_tile/cracked{
	dir = 9
	},
/obj/structure/stone_tile/surrounding_tile/burnt{
	dir = 8
	},
/turf/open/chasm/lavaland,
/area/ruin/unpowered)
"R" = (
/obj/structure/stone_tile/surrounding_tile/cracked{
	dir = 1
	},
/turf/open/chasm/lavaland,
/area/ruin/unpowered)
"T" = (
/obj/structure/stone_tile/surrounding_tile/cracked{
	dir = 4
	},
/turf/open/chasm/lavaland,
/area/ruin/unpowered)
"U" = (
/obj/structure/stone_tile/slab/burnt,
/turf/open/chasm/lavaland,
/area/ruin/unpowered)
"V" = (
/obj/effect/mapping_helpers/bombable_wall,
/turf/closed/indestructible/riveted/boss/wasteland,
/area/lavaland/surface/outdoors)
"X" = (
/turf/open/chasm/lavaland,
/area/ruin/unpowered)
"Y" = (
/obj/structure/stone_tile/surrounding/cracked{
	dir = 4
	},
/obj/structure/stone_tile/center/cracked,
/turf/open/chasm/lavaland,
/area/ruin/unpowered)
"Z" = (
/obj/structure/stone_tile/slab,
/turf/open/chasm/lavaland,
/area/ruin/unpowered)

(1,1,1) = {"
a
a
f
f
a
a
a
f
f
a
a
a
a
a
a
"}
(2,1,1) = {"
a
f
f
f
f
f
V
f
f
f
a
a
a
a
a
"}
(3,1,1) = {"
f
B
X
X
X
X
X
X
X
B
f
f
f
a
a
"}
(4,1,1) = {"
f
X
X
X
X
X
X
X
X
X
X
X
f
f
f
"}
(5,1,1) = {"
f
X
X
X
X
X
X
X
X
X
X
X
X
X
f
"}
(6,1,1) = {"
f
X
X
u
L
L
s
u
z
X
X
X
X
T
B
"}
(7,1,1) = {"
f
X
X
s
A
j
F
L
M
K
C
P
N
v
t
"}
(8,1,1) = {"
f
X
X
L
r
q
O
L
Z
U
Y
h
E
Z
I
"}
(9,1,1) = {"
f
X
X
s
c
e
o
L
w
p
J
R
H
i
G
"}
(10,1,1) = {"
f
X
X
u
s
L
L
u
l
y
X
X
X
R
B
"}
(11,1,1) = {"
V
X
X
X
X
X
X
X
X
X
X
X
X
X
f
"}
(12,1,1) = {"
f
X
X
X
X
X
X
X
X
X
X
X
f
f
f
"}
(13,1,1) = {"
f
B
X
X
X
X
X
X
X
B
V
f
f
a
a
"}
(14,1,1) = {"
a
f
f
f
f
f
f
f
f
f
a
a
a
a
a
"}
(15,1,1) = {"
a
a
f
f
a
a
a
f
f
a
a
a
a
a
a
"}
