//MAP CONVERTED BY dmm2tgm.py THIS HEADER COMMENT PREVENTS RECONVERSION, DO NOT REMOVE
"a" = (
/turf/closed/mineral/volcanic/lava_land_surface,
/area/lavaland/surface/outdoors)
"b" = (
/obj/structure/meateor_fluff/eyeball,
/obj/effect/gibspawner/human/bodypartless,
/obj/item/antag_granter/changeling,
/obj/item/food/meat/slab/meatproduct,
/turf/open/indestructible/meat{
	initial_gas_mix = "LAVALAND_ATMOS"
	},
/area/ruin/powered)
"c" = (
/obj/structure/stone_tile/surrounding_tile/burnt{
	dir = 1
	},
/obj/effect/gibspawner/human/bodypartless,
/turf/open/misc/asteroid/basalt/lava_land_surface,
/area/lavaland/surface/outdoors)
"e" = (
/obj/structure/stone_tile/block,
/obj/effect/gibspawner/human/bodypartless,
/mob/living/basic/mining/hivelord,
/turf/open/misc/asteroid/basalt/lava_land_surface,
/area/lavaland/surface/outdoors)
"f" = (
/obj/structure/statue/uranium/eng{
	icon = 'icons/obj/art/statuelarge.dmi';
	icon_preview = 'icons/obj/fluff/previews.dmi';
	icon_state = "rib";
	icon_state_preview = "rib";
	pixel_y = 10;
	dir = 1;
	desc = "A giant teeth. Or a rib. You barely can figure.";
	name = "Rib"
	},
/turf/closed/indestructible/meat,
/area/lavaland/surface/outdoors)
"g" = (
/obj/structure/stone_tile/slab/cracked,
/obj/item/flashlight/flare/torch,
/turf/closed/mineral/volcanic/lava_land_surface,
/area/lavaland/surface/outdoors)
"h" = (
/obj/structure/stone_tile/slab/cracked{
	dir = 6
	},
/turf/closed/mineral/volcanic/lava_land_surface,
/area/lavaland/surface/outdoors)
"i" = (
/obj/structure/stone_tile/surrounding_tile/burnt{
	dir = 1
	},
/turf/open/chasm/lavaland,
/area/lavaland/surface/outdoors)
"j" = (
/obj/structure/meateor_fluff/flesh_pod,
/turf/open/indestructible/meat{
	initial_gas_mix = "LAVALAND_ATMOS"
	},
/area/ruin/powered)
"k" = (
/obj/effect/gibspawner/human/bodypartless,
/mob/living/basic/mining/hivelord/no_wander,
/turf/open/misc/asteroid/basalt/lava_land_surface,
/area/lavaland/surface/outdoors)
"l" = (
/obj/structure/flora/ash/tall_shroom,
/turf/closed/mineral/volcanic/lava_land_surface,
/area/lavaland/surface/outdoors)
"n" = (
/turf/open/chasm/lavaland,
/area/lavaland/surface/outdoors)
"o" = (
/obj/structure/stone_tile/burnt,
/obj/structure/stone_tile{
	dir = 4
	},
/obj/effect/gibspawner/human/bodypartless,
/mob/living/basic/mining/hivelord/no_wander,
/turf/open/misc/asteroid/basalt/lava_land_surface,
/area/lavaland/surface/outdoors)
"p" = (
/obj/structure/stone_tile/surrounding_tile/cracked,
/turf/closed/mineral/volcanic/lava_land_surface,
/area/lavaland/surface/outdoors)
"q" = (
/obj/structure/punji_sticks/spikes,
/turf/closed/mineral/volcanic/lava_land_surface,
/area/lavaland/surface/outdoors)
"s" = (
/obj/structure/flora/ash/fireblossom,
/mob/living/basic/mining/hivelord,
/obj/structure/flora/rock/pile/style_random,
/turf/open/misc/asteroid/basalt/lava_land_surface,
/area/lavaland/surface/outdoors)
"t" = (
/obj/effect/gibspawner/human/bodypartless,
/turf/open/indestructible/meat{
	initial_gas_mix = "LAVALAND_ATMOS"
	},
/area/lavaland/surface/outdoors)
"u" = (
/obj/structure/stone_tile/block/cracked{
	dir = 1
	},
/mob/living/basic/mining/hivelord/no_wander,
/mob/living/basic/mining/hivelord/no_wander,
/turf/open/misc/asteroid/basalt/lava_land_surface,
/area/lavaland/surface/outdoors)
"v" = (
/obj/structure/stone_tile,
/obj/structure/stone_tile{
	dir = 8
	},
/turf/closed/mineral/volcanic/lava_land_surface,
/area/lavaland/surface/outdoors)
"w" = (
/obj/structure/stone_tile/block/cracked,
/obj/effect/gibspawner/human/bodypartless,
/mob/living/basic/mining/hivelord,
/mob/living/basic/mining/hivelord/no_wander,
/turf/open/misc/asteroid/basalt/lava_land_surface,
/area/lavaland/surface/outdoors)
"x" = (
/obj/effect/gibspawner/human,
/turf/open/indestructible/meat{
	initial_gas_mix = "LAVALAND_ATMOS"
	},
/area/lavaland/surface/outdoors)
"y" = (
/obj/effect/mapping_helpers/bombable_wall,
/obj/structure/trap/eldritch/tentacle,
/turf/closed/indestructible/riveted/boss/wasteland{
	base_icon_state = "meat_wall";
	icon = 'icons/turf/walls/meat_wall.dmi';
	icon_state = "meat_wall-0";
	baseturfs = /turf/open/indestructible/meat
	},
/area/lavaland/surface/outdoors)
"A" = (
/obj/structure/statue/uranium/eng{
	icon = 'icons/obj/art/statuelarge.dmi';
	icon_preview = 'icons/obj/fluff/previews.dmi';
	icon_state = "rib";
	icon_state_preview = "rib";
	pixel_y = 10;
	name = "Rib"
	},
/turf/closed/indestructible/meat,
/area/lavaland/surface/outdoors)
"C" = (
/obj/structure/stone_tile/cracked{
	dir = 4
	},
/turf/closed/mineral/volcanic/lava_land_surface,
/area/lavaland/surface/outdoors)
"E" = (
/obj/structure/stone_tile/surrounding_tile/cracked{
	dir = 8
	},
/turf/closed/mineral/volcanic/lava_land_surface,
/area/lavaland/surface/outdoors)
"F" = (
/obj/structure/stone_tile{
	dir = 8
	},
/obj/structure/stone_tile{
	dir = 1
	},
/turf/closed/mineral/volcanic/lava_land_surface,
/area/lavaland/surface/outdoors)
"H" = (
/obj/effect/gibspawner/human,
/obj/structure/meateor_fluff/eyeball,
/turf/open/indestructible/meat{
	initial_gas_mix = "LAVALAND_ATMOS"
	},
/area/ruin/powered)
"I" = (
/mob/living/basic/mining/hivelord/no_wander,
/mob/living/basic/mining/hivelord/no_wander,
/turf/open/misc/asteroid/basalt/lava_land_surface,
/area/template_noop)
"J" = (
/obj/structure/flora/ash/seraka,
/turf/closed/mineral/volcanic/lava_land_surface,
/area/lavaland/surface/outdoors)
"K" = (
/obj/item/food/meat/slab/meatwheat,
/turf/closed/indestructible/meat,
/area/lavaland/surface/outdoors)
"L" = (
/obj/structure/flora/rock/pile/style_random,
/mob/living/basic/mining/hivelord,
/mob/living/basic/mining/hivelord/no_wander,
/turf/closed/mineral/volcanic/lava_land_surface,
/area/lavaland/surface/outdoors)
"M" = (
/turf/template_noop,
/area/template_noop)
"N" = (
/obj/effect/gibspawner/generic,
/obj/item/food/meat/slab/meatproduct,
/turf/open/indestructible/meat{
	initial_gas_mix = "LAVALAND_ATMOS"
	},
/area/ruin/powered)
"O" = (
/obj/structure/stone_tile/surrounding/cracked{
	dir = 6
	},
/obj/effect/gibspawner/human/bodypartless,
/turf/open/misc/asteroid/basalt/lava_land_surface,
/area/lavaland/surface/outdoors)
"P" = (
/obj/structure/punji_sticks/spikes,
/turf/open/misc/asteroid/basalt/lava_land_surface,
/area/lavaland/surface/outdoors)
"Q" = (
/obj/structure/stone_tile/burnt,
/obj/structure/stone_tile/burnt{
	dir = 1
	},
/obj/structure/stone_tile/cracked{
	dir = 4
	},
/mob/living/basic/mining/hivelord,
/mob/living/basic/mining/hivelord/no_wander,
/turf/open/misc/asteroid/basalt/lava_land_surface,
/area/lavaland/surface/outdoors)
"R" = (
/obj/structure/flora/rock/pile/style_random,
/turf/closed/mineral/volcanic/lava_land_surface,
/area/lavaland/surface/outdoors)
"T" = (
/obj/structure/flora/rock/style_random,
/turf/closed/mineral/volcanic/lava_land_surface,
/area/lavaland/surface/outdoors)
"U" = (
/turf/open/indestructible/meat{
	initial_gas_mix = "LAVALAND_ATMOS"
	},
/area/lavaland/surface/outdoors)
"V" = (
/turf/closed/indestructible/meat,
/area/lavaland/surface/outdoors)
"W" = (
/obj/structure/stone_tile/block{
	dir = 8
	},
/obj/structure/stone_tile/block/burnt{
	dir = 4
	},
/turf/closed/mineral/volcanic/lava_land_surface,
/area/lavaland/surface/outdoors)
"X" = (
/obj/item/food/meat/slab/meatproduct,
/mob/living/basic/meteor_heart,
/turf/open/indestructible/meat{
	initial_gas_mix = "LAVALAND_ATMOS"
	},
/area/ruin/powered)
"Y" = (
/mob/living/basic/mining/hivelord,
/obj/effect/gibspawner/human/bodypartless,
/mob/living/basic/mining/hivelord/no_wander,
/turf/open/misc/asteroid/basalt/lava_land_surface,
/area/lavaland/surface/outdoors)
"Z" = (
/mob/living/basic/meteor_heart,
/obj/item/food/meat/slab/meatproduct,
/turf/open/indestructible/meat{
	initial_gas_mix = "LAVALAND_ATMOS"
	},
/area/ruin/powered)

(1,1,1) = {"
M
M
M
M
a
T
n
a
a
M
M
M
"}
(2,1,1) = {"
M
n
T
e
n
k
i
Y
R
a
M
M
"}
(3,1,1) = {"
M
n
n
U
U
x
n
n
k
n
n
M
"}
(4,1,1) = {"
p
L
n
t
f
y
f
t
n
n
l
a
"}
(5,1,1) = {"
q
x
U
f
K
j
V
f
U
n
I
a
"}
(6,1,1) = {"
n
U
f
K
H
X
N
y
U
n
w
a
"}
(7,1,1) = {"
n
U
y
j
Z
b
K
A
x
n
u
a
"}
(8,1,1) = {"
n
U
A
V
j
K
A
U
n
n
a
a
"}
(9,1,1) = {"
k
U
t
A
y
A
t
U
M
n
W
M
"}
(10,1,1) = {"
E
s
n
U
x
U
U
n
o
C
g
M
"}
(11,1,1) = {"
M
n
n
P
c
Q
O
n
h
v
F
M
"}
(12,1,1) = {"
M
M
a
a
J
M
a
a
a
a
M
M
"}
