//MAP CONVERTED BY dmm2tgm.py THIS HEADER COMMENT PREVENTS RECONVERSION, DO NOT REMOVE
"bd" = (
/obj/structure/stone_tile/center/cracked,
/obj/structure/stone_tile/surrounding/cracked{
	dir = 6
	},
/turf/closed/mineral/random/high_chance/volcanic,
/area/lavaland/surface/outdoors)
"bR" = (
/obj/structure/flora/ash/cacti,
/turf/closed/mineral/volcanic/lava_land_surface,
/area/lavaland/surface/outdoors)
"cv" = (
/obj/structure/stone_tile/surrounding,
/obj/structure/stone_tile/center,
/obj/effect/decal/cleanable/blood/gibs/limb{
	pixel_y = 10
	},
/obj/effect/decal/cleanable/blood/old{
	pixel_x = -5;
	pixel_y = 15
	},
/obj/effect/decal/cleanable/blood/old{
	icon_state = "floor4-old";
	pixel_y = 10;
	pixel_x = 5
	},
/obj/effect/decal/cleanable/blood/tracks{
	desc = "Your instincts say you shouldn't be following these.";
	icon_state = "ltrails_1";
	dir = 10;
	pixel_y = 15
	},
/obj/structure/trap/cult,
/turf/open/misc/asteroid/basalt/lava_land_surface,
/area/lavaland/surface/outdoors)
"dk" = (
/obj/structure/stone_tile/block/cracked{
	dir = 4
	},
/obj/structure/stone_tile/cracked{
	dir = 4
	},
/obj/structure/stone_tile{
	dir = 8
	},
/obj/item/organ/internal/tongue/cat/tajaran,
/turf/open/indestructible/necropolis,
/area/ruin/unpowered)
"eD" = (
/obj/structure/stone_tile/slab/burnt,
/obj/effect/gibspawner,
/turf/open/indestructible/boss,
/area/ruin/unpowered)
"eR" = (
/obj/structure/stone_tile/slab/cracked,
/obj/effect/gibspawner,
/turf/open/indestructible/necropolis,
/area/ruin/unpowered)
"fc" = (
/obj/structure/stone_tile/block/cracked,
/obj/effect/decal/cleanable/blood/tracks{
	desc = "Your instincts say you shouldn't be following these.";
	icon_state = "ltrails_1";
	dir = 6
	},
/obj/item/soulstone,
/turf/open/indestructible/necropolis,
/area/ruin/unpowered)
"gs" = (
/obj/structure/stone_tile/block{
	dir = 1
	},
/turf/closed/mineral/random/high_chance/volcanic,
/area/lavaland/surface/outdoors)
"id" = (
/obj/structure/stone_tile/surrounding_tile/cracked,
/obj/structure/stone_tile/center,
/obj/structure/stone_tile/surrounding_tile{
	dir = 1
	},
/obj/structure/stone_tile/surrounding_tile{
	dir = 8
	},
/obj/item/trash/candle{
	pixel_y = 12
	},
/turf/open/indestructible/necropolis,
/area/ruin/unpowered)
"ig" = (
/obj/structure/stone_tile,
/obj/structure/stone_tile{
	dir = 4
	},
/obj/structure/stone_tile{
	dir = 1
	},
/turf/open/misc/asteroid/basalt/lava_land_surface,
/area/lavaland/surface/outdoors)
"ir" = (
/obj/structure/stone_tile/surrounding_tile/cracked,
/obj/structure/stone_tile/surrounding_tile/cracked{
	dir = 4
	},
/obj/structure/stone_tile/center,
/obj/structure/stone_tile/surrounding_tile{
	dir = 8
	},
/obj/item/organ/internal/tongue/dwarven,
/turf/open/indestructible/necropolis,
/area/ruin/unpowered)
"jP" = (
/obj/structure/flora/ash/cap_shroom,
/turf/closed/mineral/volcanic/lava_land_surface,
/area/lavaland/surface/outdoors)
"kt" = (
/turf/closed/mineral/volcanic/lava_land_surface,
/area/lavaland/surface/outdoors)
"kw" = (
/obj/structure/flora/rock/pile/style_random,
/turf/closed/mineral/volcanic/lava_land_surface,
/area/lavaland/surface/outdoors)
"kI" = (
/obj/structure/stone_tile/slab/burnt,
/obj/item/stack/sheet/mineral/runite{
	amount = 5
	},
/turf/open/indestructible/boss,
/area/ruin/unpowered)
"lb" = (
/obj/structure/stone_tile/block,
/obj/structure/stone_tile{
	dir = 1
	},
/obj/structure/stone_tile{
	dir = 4
	},
/obj/item/stack/sheet/mineral/runite{
	amount = 5
	},
/obj/item/organ/internal/tongue/alien,
/turf/open/indestructible/necropolis,
/area/ruin/unpowered)
"lq" = (
/obj/effect/mapping_helpers/bombable_wall,
/turf/closed/indestructible/riveted/boss/wasteland,
/area/lavaland/surface/outdoors)
"lC" = (
/obj/structure/stone_tile/slab/burnt,
/obj/effect/decal/cleanable/blood/gibs/up,
/obj/item/organ/internal/tongue/insect,
/turf/open/indestructible/boss,
/area/ruin/unpowered)
"md" = (
/obj/structure/stone_tile/block,
/obj/structure/punji_sticks/spikes,
/turf/closed/mineral/random/high_chance/volcanic,
/area/lavaland/surface/outdoors)
"my" = (
/obj/structure/stone_tile/slab/burnt,
/obj/effect/decal/cleanable/blood/old{
	icon_state = "gibbl1"
	},
/obj/item/organ/internal/tongue/jelly,
/turf/open/indestructible/boss,
/area/ruin/unpowered)
"nS" = (
/turf/closed/indestructible/riveted/boss,
/area/ruin/unpowered)
"om" = (
/obj/structure/stone_tile,
/turf/closed/mineral/random/high_chance/volcanic,
/area/lavaland/surface/outdoors)
"oA" = (
/obj/structure/stone_tile/block/cracked,
/obj/structure/punji_sticks/spikes,
/turf/closed/mineral/volcanic/lava_land_surface,
/area/lavaland/surface/outdoors)
"qr" = (
/turf/closed/indestructible/riveted/boss,
/area/lavaland/surface/outdoors)
"tn" = (
/obj/structure/stone_tile/block/cracked{
	dir = 8
	},
/turf/closed/mineral/volcanic/lava_land_surface,
/area/lavaland/surface/outdoors)
"tF" = (
/obj/structure/stone_tile,
/turf/closed/mineral/volcanic/lava_land_surface,
/area/lavaland/surface/outdoors)
"ug" = (
/obj/structure/stone_tile/block{
	dir = 4
	},
/obj/structure/stone_tile{
	dir = 8
	},
/obj/structure/stone_tile{
	dir = 4
	},
/obj/effect/decal/cleanable/blood/old{
	icon_state = "floor4-old"
	},
/obj/item/organ/internal/tongue/snail,
/turf/open/indestructible/necropolis,
/area/ruin/unpowered)
"un" = (
/obj/structure/punji_sticks/spikes,
/turf/closed/mineral/random/high_chance/volcanic,
/area/lavaland/surface/outdoors)
"uz" = (
/obj/effect/mapping_helpers/bombable_wall,
/obj/structure/necropolis_arch,
/turf/closed/indestructible/riveted/boss/wasteland,
/area/ruin/unpowered)
"uA" = (
/obj/structure/stone_tile/cracked{
	dir = 4
	},
/turf/closed/mineral/volcanic/lava_land_surface,
/area/lavaland/surface/outdoors)
"vP" = (
/obj/structure/stone_tile/block{
	dir = 8
	},
/obj/item/trash/candle{
	pixel_x = 9;
	pixel_y = -1
	},
/obj/item/soulstone,
/turf/open/indestructible/necropolis,
/area/ruin/unpowered)
"wl" = (
/obj/structure/stone_tile/block{
	dir = 4
	},
/turf/closed/mineral/volcanic/lava_land_surface,
/area/lavaland/surface/outdoors)
"ws" = (
/obj/structure/stone_tile/block{
	dir = 8
	},
/obj/structure/stone_tile,
/obj/structure/stone_tile{
	dir = 1
	},
/obj/item/organ/internal/tongue/golem,
/turf/open/indestructible/necropolis,
/area/ruin/unpowered)
"xc" = (
/obj/structure/stone_tile,
/obj/structure/punji_sticks/spikes,
/turf/closed/mineral/volcanic/lava_land_surface,
/area/lavaland/surface/outdoors)
"yh" = (
/obj/effect/mapping_helpers/bombable_wall,
/turf/closed/indestructible/riveted/boss/wasteland,
/area/ruin/unpowered)
"ys" = (
/obj/structure/stone_tile/block{
	dir = 4
	},
/obj/structure/stone_tile/block/cracked{
	dir = 8
	},
/turf/open/indestructible/boss,
/area/ruin/unpowered)
"yt" = (
/obj/structure/stone_tile{
	dir = 8
	},
/turf/closed/mineral/random/high_chance/volcanic,
/area/lavaland/surface/outdoors)
"yI" = (
/obj/structure/stone_tile/cracked,
/obj/structure/punji_sticks/spikes,
/turf/closed/mineral/random/high_chance/volcanic,
/area/lavaland/surface/outdoors)
"Al" = (
/obj/structure/stone_tile/block/cracked{
	dir = 1
	},
/obj/structure/stone_tile{
	dir = 8
	},
/obj/structure/stone_tile,
/obj/effect/decal/cleanable/blood/old,
/obj/item/organ/internal/tongue/human,
/turf/open/indestructible/necropolis,
/area/ruin/unpowered)
"Bw" = (
/obj/structure/stone_tile/block/cracked,
/obj/structure/punji_sticks/spikes,
/turf/closed/mineral/random/high_chance/volcanic,
/area/lavaland/surface/outdoors)
"BI" = (
/obj/structure/stone_tile/block{
	dir = 1
	},
/obj/structure/stone_tile/cracked,
/obj/structure/stone_tile{
	dir = 8
	},
/obj/effect/decal/cleanable/blood/gibs/down,
/turf/open/indestructible/necropolis,
/area/ruin/unpowered)
"CN" = (
/obj/structure/stone_tile,
/obj/structure/stone_tile{
	dir = 8
	},
/obj/structure/stone_tile/cracked{
	dir = 4
	},
/obj/structure/stone_tile/cracked{
	dir = 1
	},
/obj/structure/fluff/divine/convertaltar,
/obj/structure/mirror/broken/directional/north,
/obj/item/stock_parts/cell/crystal_cell,
/turf/open/indestructible/boss,
/area/ruin/unpowered)
"DQ" = (
/obj/structure/stone_tile/surrounding_tile/cracked,
/obj/structure/punji_sticks/spikes,
/turf/closed/mineral/random/high_chance/volcanic,
/area/lavaland/surface/outdoors)
"Eu" = (
/obj/structure/stone_tile/surrounding_tile/cracked{
	dir = 4
	},
/obj/structure/stone_tile/center/cracked,
/obj/structure/stone_tile/surrounding_tile,
/obj/structure/stone_tile/surrounding_tile{
	dir = 1
	},
/obj/item/trash/candle{
	pixel_x = 9;
	pixel_y = -1
	},
/obj/item/organ/internal/tongue/ethereal,
/turf/open/indestructible/necropolis,
/area/ruin/unpowered)
"EL" = (
/obj/structure/stone_tile/block/cracked{
	dir = 4
	},
/obj/item/soulstone,
/turf/open/indestructible/necropolis,
/area/ruin/unpowered)
"FQ" = (
/obj/structure/flora/ash/seraka,
/turf/closed/mineral/random/high_chance/volcanic,
/area/lavaland/surface/outdoors)
"He" = (
/obj/structure/punji_sticks/spikes,
/turf/closed/mineral/volcanic/lava_land_surface,
/area/lavaland/surface/outdoors)
"Io" = (
/obj/structure/punji_sticks/spikes,
/turf/closed/mineral/strange_rock/volcanic,
/area/lavaland/surface/outdoors)
"Iq" = (
/obj/structure/stone_tile,
/obj/structure/stone_tile{
	dir = 8
	},
/obj/structure/stone_tile/cracked{
	dir = 4
	},
/obj/structure/stone_tile/cracked{
	dir = 1
	},
/obj/structure/fluff/divine/conduit,
/turf/open/indestructible/boss,
/area/ruin/unpowered)
"Ix" = (
/obj/structure/fluff/big_chain{
	pixel_y = 12
	},
/turf/closed/indestructible/riveted/boss,
/area/ruin/unpowered)
"IU" = (
/obj/structure/stone_tile,
/obj/structure/stone_tile{
	dir = 1
	},
/obj/structure/stone_tile/cracked{
	dir = 4
	},
/obj/structure/stone_tile/cracked{
	dir = 8
	},
/obj/structure/fluff/divine/conduit,
/turf/open/indestructible/boss,
/area/ruin/unpowered)
"Kk" = (
/obj/structure/stone_tile/cracked{
	dir = 1
	},
/turf/closed/mineral/random/high_chance/volcanic,
/area/lavaland/surface/outdoors)
"Ky" = (
/obj/structure/stone_tile{
	dir = 8
	},
/obj/structure/punji_sticks/spikes,
/turf/closed/mineral/volcanic/lava_land_surface,
/area/lavaland/surface/outdoors)
"Kz" = (
/obj/structure/stone_tile/slab/burnt,
/obj/effect/decal/cleanable/blood/old{
	icon_state = "gib2"
	},
/obj/effect/decal/cleanable/blood/old{
	icon_state = "gibbl4"
	},
/turf/open/indestructible/boss,
/area/ruin/unpowered)
"KS" = (
/obj/structure/stone_tile/block/cracked{
	dir = 8
	},
/obj/structure/stone_tile/cracked{
	dir = 1
	},
/obj/structure/stone_tile,
/obj/item/stack/sheet/mineral/runite{
	amount = 5
	},
/turf/open/indestructible/necropolis,
/area/ruin/unpowered)
"LA" = (
/obj/structure/stone_tile/surrounding_tile{
	dir = 8
	},
/obj/structure/punji_sticks/spikes,
/turf/closed/mineral/strange_rock/volcanic,
/area/lavaland/surface/outdoors)
"LX" = (
/obj/structure/stone_tile/surrounding_tile{
	dir = 1
	},
/turf/closed/mineral/volcanic/lava_land_surface,
/area/lavaland/surface/outdoors)
"Mo" = (
/obj/structure/stone_tile/cracked{
	dir = 1
	},
/turf/closed/mineral/volcanic/lava_land_surface,
/area/lavaland/surface/outdoors)
"MN" = (
/obj/structure/stone_tile/slab/burnt,
/turf/closed/mineral/random/high_chance/volcanic,
/area/ruin/unpowered)
"NR" = (
/turf/open/misc/asteroid/basalt/lava_land_surface,
/area/lavaland/surface/outdoors)
"Ov" = (
/obj/structure/stone_tile,
/obj/structure/stone_tile{
	dir = 8
	},
/obj/structure/stone_tile{
	dir = 1
	},
/obj/structure/stone_tile/cracked{
	dir = 4
	},
/obj/effect/decal/cleanable/blood/tracks{
	desc = "Your instincts say you shouldn't be following these.";
	dir = 8;
	icon_state = "ltrails_2"
	},
/obj/item/organ/internal/tongue/hemophage,
/turf/open/indestructible/boss,
/area/ruin/unpowered)
"Ps" = (
/obj/structure/stone_tile{
	dir = 4
	},
/obj/structure/stone_tile{
	dir = 8
	},
/obj/structure/stone_tile{
	dir = 1
	},
/obj/item/stack/sheet/animalhide/goliath_hide,
/turf/open/misc/asteroid/basalt/lava_land_surface,
/area/lavaland/surface/outdoors)
"PV" = (
/obj/structure/stone_tile,
/obj/structure/stone_tile{
	dir = 8
	},
/obj/structure/stone_tile{
	dir = 1
	},
/obj/structure/stone_tile{
	dir = 4
	},
/obj/effect/decal/cleanable/blood/gibs,
/turf/open/indestructible/boss,
/area/ruin/unpowered)
"QI" = (
/obj/effect/gibspawner/human/bodypartless,
/turf/open/misc/asteroid/basalt/lava_land_surface,
/area/lavaland/surface/outdoors)
"Sr" = (
/turf/template_noop,
/area/template_noop)
"Ss" = (
/obj/effect/decal/cleanable/blood/tracks{
	desc = "Your instincts say you shouldn't be following these.";
	dir = 8;
	icon_state = "ltrails_2"
	},
/obj/effect/decal/cleanable/grand_remains,
/mob/living/basic/faithless{
	faction = list("mining","boss","hell");
	name = "Eldritch Horror";
	desc = "This creature is terror itself, a manifestation of the raw hunger and avarice of mortals.";
	attack_sound = 'sound/effects/wounds/crackandbleed.ogg';
	attack_verb_continuous = "devours";
	attack_verb_simple = "reaps";
	butcher_results = list(/obj/item/food/grown/mushroom/glowshroom/shadowshroom = 1,/obj/item/food/meat/slab/human/mutant/shadow = 1,/obj/item/organ/internal/eyes/shadow = 1);
	icon = 'modular_nova/master_files/icons/mob/newmobs32x64.dmi';
	icon_dead = "demondead";
	icon_living = "devourdemon";
	icon_state = "devourdemon";
	melee_attack_cooldown = 3;
	speed = -0.9;
	damage_coeff = list("brute" = 1, "burn" = 1, "toxin" = 1, "stamina" = 1, "oxygen" = 1);
	melee_damage_lower = 5;
	health = 900;
	bare_wound_bonus = 5;
	wound_bonus = -1;
	obj_damage = 40;
	attack_vis_effect = "bite";
	guaranteed_butcher_results = list(/obj/item/book/granter/action/spell/true_random = 1);
	armour_penetration = 10;
	health_doll_icon = "bubblegum";
	combat_mode = 1;
	maxHealth = 1200;
	melee_damage_upper = 30;
	light_color = "#640000";
	light_power = 12;
	light_range = 2;
	lighting_cutoff_blue = 35;
	lighting_cutoff_green = 15;
	lighting_cutoff_red = 25
	},
/turf/open/indestructible/necropolis,
/area/ruin/unpowered)
"Sv" = (
/obj/structure/stone_tile/block,
/obj/structure/stone_tile/cracked{
	dir = 1
	},
/obj/structure/stone_tile{
	dir = 4
	},
/obj/item/disk/design_disk/knight_gear,
/turf/open/indestructible/necropolis,
/area/ruin/unpowered)
"SB" = (
/obj/structure/stone_tile/block{
	dir = 1
	},
/turf/closed/mineral/volcanic/lava_land_surface,
/area/lavaland/surface/outdoors)
"Tp" = (
/obj/structure/stone_tile/block{
	dir = 8
	},
/obj/structure/stone_tile/cracked{
	dir = 1
	},
/obj/structure/stone_tile,
/obj/effect/decal/cleanable/blood/gibs/old,
/turf/open/indestructible/necropolis,
/area/ruin/unpowered)
"TF" = (
/obj/structure/stone_tile{
	dir = 4
	},
/turf/closed/mineral/volcanic/lava_land_surface,
/area/lavaland/surface/outdoors)
"TY" = (
/obj/structure/stone_tile/block{
	dir = 1
	},
/obj/item/soulstone,
/turf/open/indestructible/necropolis,
/area/ruin/unpowered)
"Ue" = (
/obj/structure/stone_tile/surrounding_tile/cracked{
	dir = 8
	},
/obj/structure/stone_tile/center,
/obj/structure/stone_tile/surrounding_tile{
	dir = 1
	},
/obj/structure/stone_tile/surrounding_tile{
	dir = 4
	},
/obj/effect/decal/cleanable/blood/tracks{
	desc = "Your instincts say you shouldn't be following these.";
	icon_state = "ltrails_1";
	dir = 10
	},
/obj/item/organ/internal/tongue/lizard/silver,
/turf/open/indestructible/necropolis,
/area/ruin/unpowered)
"Uk" = (
/obj/structure/stone_tile/cracked{
	dir = 4
	},
/turf/closed/mineral/random/high_chance/volcanic,
/area/lavaland/surface/outdoors)
"Ur" = (
/obj/structure/stone_tile/slab/burnt,
/obj/effect/decal/cleanable/blood/gibs/torso,
/obj/effect/decal/cleanable/blood/old{
	icon_state = "gibbl4"
	},
/mob/living/basic/faithless{
	faction = list("mining","boss","hell");
	name = "Ancient Demon";
	desc = "A demonic creature that moves relatively fast, but doesn't do a lot of damage.";
	attack_sound = 'sound/effects/wounds/crackandbleed.ogg';
	attack_verb_simple = "tears";
	butcher_results = list(/obj/item/food/grown/mushroom/glowshroom/shadowshroom = 1,/obj/item/food/meat/slab/human/mutant/shadow = 1,/obj/item/organ/internal/eyes/shadow = 1,/obj/item/organ/external/tail/lizard = 1);
	icon = 'modular_nova/master_files/icons/mob/newmobs32x64.dmi';
	icon_dead = "demondead";
	icon_living = "engorgedemon";
	icon_state = "engorgedemon";
	melee_attack_cooldown = 5;
	speed = -0.1;
	damage_coeff = list("brute" = 1, "burn" = 1, "toxin" = 1, "stamina" = 0.5, "oxygen" = 1);
	melee_damage_lower = 3;
	melee_damage_upper = 7;
	health = 640;
	bare_wound_bonus = 5;
	wound_bonus = -1;
	obj_damage = 40;
	attack_vis_effect = "slash";
	attack_verb_continuous = "maniacally tears";
	maxHealth = 240
	},
/turf/open/indestructible/boss,
/area/ruin/unpowered)
"VK" = (
/obj/structure/flora/rock/pile/style_random,
/turf/closed/mineral/random/high_chance/volcanic,
/area/lavaland/surface/outdoors)
"WI" = (
/obj/structure/stone_tile/block,
/obj/structure/stone_tile{
	dir = 1
	},
/obj/structure/stone_tile{
	dir = 4
	},
/obj/effect/decal/cleanable/blood,
/obj/effect/mob_spawn/corpse/human/wizard,
/turf/open/indestructible/necropolis,
/area/ruin/unpowered)
"Xc" = (
/obj/structure/flora/ash/stem_shroom,
/turf/closed/mineral/random/high_chance/volcanic,
/area/lavaland/surface/outdoors)
"Xo" = (
/turf/closed/mineral/random/high_chance/volcanic,
/area/lavaland/surface/outdoors)
"Xp" = (
/obj/structure/stone_tile/block{
	dir = 4
	},
/obj/structure/stone_tile{
	dir = 8
	},
/obj/structure/stone_tile{
	dir = 4
	},
/obj/effect/decal/cleanable/blood/old{
	icon_state = "gibbl1"
	},
/obj/item/stack/sheet/mineral/runite{
	amount = 5
	},
/turf/open/indestructible/necropolis,
/area/ruin/unpowered)
"XB" = (
/obj/structure/stone_tile,
/obj/structure/punji_sticks/spikes,
/turf/closed/mineral/random/high_chance/volcanic,
/area/lavaland/surface/outdoors)
"Yt" = (
/obj/structure/stone_tile{
	dir = 1
	},
/turf/closed/mineral/random/high_chance/volcanic,
/area/lavaland/surface/outdoors)
"Yw" = (
/obj/structure/stone_tile{
	dir = 8
	},
/turf/closed/mineral/volcanic/lava_land_surface,
/area/lavaland/surface/outdoors)

(1,1,1) = {"
Sr
Sr
Sr
Sr
Sr
Sr
Sr
Sr
Sr
Sr
TF
Ky
Sr
Sr
Sr
"}
(2,1,1) = {"
Sr
Sr
kt
He
tn
qr
qr
qr
Ky
Sr
qr
qr
Yw
Sr
Sr
"}
(3,1,1) = {"
Sr
He
uA
nS
nS
nS
nS
nS
qr
Sr
qr
lq
yI
Sr
Sr
"}
(4,1,1) = {"
kt
Uk
nS
nS
MN
MN
eD
nS
qr
Ky
Kk
XB
Sr
Sr
Sr
"}
(5,1,1) = {"
Xc
lq
nS
nS
MN
lC
Ur
nS
qr
qr
LA
kw
Sr
Sr
Sr
"}
(6,1,1) = {"
kt
gs
nS
Iq
dk
ug
Xp
PV
nS
nS
qr
He
jP
Sr
Sr
"}
(7,1,1) = {"
kt
nS
Ix
lb
id
EL
Eu
BI
nS
nS
nS
md
Bw
Ky
ig
"}
(8,1,1) = {"
He
nS
CN
WI
fc
Ss
TY
eR
ys
yh
uz
cv
bd
NR
QI
"}
(9,1,1) = {"
kt
nS
Ix
Sv
ir
vP
Ue
Al
nS
nS
nS
Bw
oA
xc
Ps
"}
(10,1,1) = {"
kt
SB
nS
IU
KS
ws
Tp
Ov
nS
nS
qr
He
Sr
Sr
Sr
"}
(11,1,1) = {"
kt
qr
nS
nS
MN
Kz
kI
nS
nS
qr
DQ
bR
He
Sr
Sr
"}
(12,1,1) = {"
kt
Yt
nS
nS
MN
my
MN
nS
qr
XB
Uk
Ky
kw
Io
Sr
"}
(13,1,1) = {"
He
FQ
LX
nS
nS
nS
nS
nS
qr
He
qr
qr
yt
He
Sr
"}
(14,1,1) = {"
Sr
kt
Xo
kt
wl
qr
qr
lq
om
kw
qr
qr
tF
kw
Sr
"}
(15,1,1) = {"
Sr
Sr
Sr
Sr
Sr
Sr
He
VK
un
Sr
Mo
tF
Sr
Sr
Sr
"}
