//MAP CONVERTED BY dmm2tgm.py THIS HEADER COMMENT PREVENTS RECONVERSION, DO NOT REMOVE
"a" = (
/obj/structure/flora/rock/pile/style_random,
/turf/closed/mineral/volcanic/lava_land_surface,
/area/lavaland/surface/outdoors)
"b" = (
/obj/structure/trap/fire{
	name = "Anctient runic spikes";
	desc = "A strange carving of some symbols. What's that for?";
	alpha = 180;
	icon = 'icons/obj/service/hydroponics/equipment.dmi';
	icon_state = "woodspike";
	light_color = "#FF1111";
	color = "#FF1111"
	},
/turf/closed/mineral/volcanic/lava_land_surface,
/area/lavaland/surface/outdoors)
"c" = (
/mob/living/basic/mining/bileworm,
/turf/open/misc/asteroid/lavaland_atmos,
/area/lavaland/surface/outdoors)
"g" = (
/obj/structure/water_source/puddle,
/turf/open/misc/asteroid/lavaland_atmos,
/area/ruin/unpowered)
"j" = (
/turf/closed/mineral/random/high_chance/volcanic,
/area/lavaland/surface/outdoors)
"k" = (
/obj/structure/stone_tile/slab/cracked,
/turf/closed/mineral/random/high_chance/volcanic,
/area/lavaland/surface/outdoors)
"l" = (
/obj/effect/decal/cleanable/xenoblood,
/turf/open/misc/asteroid/lavaland_atmos,
/area/lavaland/surface/outdoors)
"m" = (
/obj/structure/flora/rock/pile/style_random,
/obj/structure/trap/fire{
	name = "Anctient runic spikes";
	desc = "A strange carving of some symbols. What's that for?";
	alpha = 180;
	icon = 'icons/obj/service/hydroponics/equipment.dmi';
	icon_state = "woodspike";
	light_color = "#FF1111";
	color = "#FF1111"
	},
/turf/closed/mineral/random/high_chance/volcanic,
/area/lavaland/surface/outdoors)
"r" = (
/turf/closed/indestructible/riveted/boss,
/area/lavaland/surface/outdoors)
"s" = (
/turf/closed/mineral/volcanic/lava_land_surface,
/area/lavaland/surface/outdoors)
"w" = (
/obj/structure/trap/fire{
	name = "Anctient runic spikes";
	desc = "A strange carving of some symbols. What's that for?";
	alpha = 180;
	icon = 'icons/obj/service/hydroponics/equipment.dmi';
	icon_state = "woodspike";
	light_color = "#FF1111";
	color = "#FF1111"
	},
/turf/closed/mineral/random/high_chance/volcanic,
/area/lavaland/surface/outdoors)
"z" = (
/obj/structure/flora/rock/pile/style_random,
/turf/open/misc/asteroid/lavaland_atmos,
/area/lavaland/surface/outdoors)
"C" = (
/obj/item/xenoarch/useless_relic{
	name = "Ancient relic";
	desc = "Sort of relic that can be exported through Cargo."
	},
/turf/closed/mineral/volcanic/lava_land_surface,
/area/lavaland/surface/outdoors)
"F" = (
/obj/structure/stone_tile/slab/cracked,
/turf/closed/mineral/volcanic/lava_land_surface,
/area/lavaland/surface/outdoors)
"G" = (
/obj/structure/stone_tile/slab,
/turf/closed/mineral/volcanic/lava_land_surface,
/area/lavaland/surface/outdoors)
"H" = (
/obj/structure/flora/ash/cacti,
/turf/open/misc/asteroid/lavaland_atmos,
/area/lavaland/surface/outdoors)
"J" = (
/mob/living/basic/mining/bileworm/vileworm,
/turf/open/misc/asteroid/lavaland_atmos,
/area/lavaland/surface/outdoors)
"L" = (
/turf/open/misc/asteroid/lavaland_atmos,
/area/lavaland/surface/outdoors)
"M" = (
/obj/effect/mapping_helpers/bombable_wall,
/turf/closed/indestructible/riveted/boss/wasteland,
/area/lavaland/surface/outdoors)
"P" = (
/obj/effect/decal/cleanable/xenoblood{
	icon_state = "xltrails_1";
	dir = 8
	},
/turf/open/misc/asteroid/lavaland_atmos,
/area/lavaland/surface/outdoors)
"Y" = (
/turf/template_noop,
/area/template_noop)

(1,1,1) = {"
Y
a
r
Y
b
r
r
s
Y
M
Y
Y
"}
(2,1,1) = {"
Y
s
r
r
G
r
r
G
r
r
a
Y
"}
(3,1,1) = {"
r
r
r
j
s
z
L
j
a
r
r
r
"}
(4,1,1) = {"
s
M
a
C
H
c
g
L
s
s
r
Y
"}
(5,1,1) = {"
s
F
s
c
L
J
P
L
H
j
F
a
"}
(6,1,1) = {"
r
r
j
z
J
L
c
z
s
a
w
r
"}
(7,1,1) = {"
r
s
j
c
g
J
L
j
s
Y
r
r
"}
(8,1,1) = {"
Y
G
j
H
L
z
s
s
Y
Y
r
Y
"}
(9,1,1) = {"
Y
r
s
s
l
j
s
Y
Y
Y
r
Y
"}
(10,1,1) = {"
r
r
r
s
j
s
Y
Y
Y
r
r
r
"}
(11,1,1) = {"
s
m
r
M
G
r
r
k
r
r
Y
Y
"}
(12,1,1) = {"
Y
s
r
s
s
r
r
Y
Y
r
Y
Y
"}
