//MAP CONVERTED BY dmm2tgm.py THIS HEADER COMMENT PREVENTS RECONVERSION, DO NOT REMOVE
"ad" = (
/obj/structure/stone_tile/surrounding_tile/cracked{
	dir = 1
	},
/obj/effect/decal/cleanable/plastic,
/obj/effect/decal/cleanable/dirt,
/obj/effect/decal/cleanable/dirt,
/obj/item/food/meat/slab/human/mutant/golem/adamantine,
/obj/effect/turf_decal/trimline/dark/filled/line{
	dir = 1
	},
/turf/open/floor/pod/dark,
/area/ruin/powered)
"at" = (
/obj/structure/stone_tile/surrounding_tile/cracked{
	dir = 1
	},
/obj/effect/decal/cleanable/dirt,
/obj/item/assembly/igniter{
	pixel_y = 12;
	pixel_x = -3
	},
/obj/effect/turf_decal/trimline/dark/filled/line{
	dir = 1
	},
/turf/open/floor/pod,
/area/ruin/powered)
"bj" = (
/obj/structure/fluff/divine/conduit,
/obj/structure/stone_tile/surrounding/cracked{
	dir = 6
	},
/obj/structure/stone_tile/center/cracked,
/obj/effect/decal/cleanable/dirt/dust,
/obj/effect/decal/cleanable/cobweb/cobweb2,
/turf/open/floor/holofloor/hyperspace,
/area/ruin/powered)
"bm" = (
/obj/item/card/id/advanced/mining,
/obj/structure/closet/crate,
/obj/effect/spawner/random/entertainment/musical_instrument,
/obj/effect/spawner/random/food_or_drink/snack,
/obj/effect/turf_decal/tile/dark/full,
/obj/item/stack/sheet/mineral/uranium/half,
/turf/open/floor/pod/dark,
/area/ruin/powered)
"bU" = (
/obj/effect/decal/cleanable/plastic,
/obj/effect/turf_decal/trimline/dark/filled/line{
	dir = 1
	},
/turf/open/floor/pod/dark,
/area/ruin/powered)
"bW" = (
/obj/effect/decal/cleanable/dirt/dust,
/turf/open/floor/pod,
/area/ruin/powered)
"cT" = (
/obj/effect/decal/cleanable/blood/tracks{
	dir = 8
	},
/obj/structure/stone_tile/cracked,
/obj/effect/spawner/random/decoration/glowstick,
/turf/open/misc/asteroid/basalt/lava_land_surface,
/area/lavaland/surface/outdoors)
"dq" = (
/obj/structure/sink/directional/west,
/obj/effect/decal/cleanable/dirt,
/obj/machinery/light/directional/east{
	bulb_colour = "#2C3BFF";
	color = "#aa1200";
	light_color = "#aa1200"
	},
/obj/effect/turf_decal/trimline/dark/filled/line{
	dir = 6
	},
/obj/item/storage/medkit/fire{
	pixel_y = 6;
	pixel_x = -1
	},
/turf/open/floor/pod/dark,
/area/ruin/powered)
"dA" = (
/obj/structure/stone_tile/slab,
/obj/effect/decal/cleanable/dirt/dust,
/obj/item/pestle,
/obj/item/reagent_containers/cup/mortar{
	pixel_y = 12;
	pixel_x = -10
	},
/turf/open/floor/holofloor/hyperspace,
/area/ruin/powered)
"dF" = (
/obj/structure/tubes,
/obj/structure/marker_beacon/olive,
/obj/structure/frame/computer,
/obj/effect/turf_decal/tile/dark/full,
/turf/open/floor/pod/dark,
/area/ruin/powered)
"ed" = (
/obj/structure/stone_tile/surrounding/cracked{
	dir = 4
	},
/obj/effect/decal/cleanable/robot_debris/old,
/obj/effect/decal/cleanable/dirt,
/obj/effect/decal/cleanable/dirt,
/obj/item/stack/ore/iron{
	pixel_y = 7;
	pixel_x = 12
	},
/obj/effect/spawner/random/entertainment/gambling,
/obj/item/bodypart/arm/right/golem,
/obj/effect/turf_decal/trimline/dark/filled/line,
/turf/open/floor/pod/dark,
/area/ruin/powered)
"eg" = (
/obj/effect/turf_decal/trimline/dark/filled/line,
/obj/effect/turf_decal/trimline/dark/filled/line{
	dir = 1
	},
/turf/open/floor/pod,
/area/ruin/powered)
"ei" = (
/obj/effect/decal/cleanable/blood/tracks{
	desc = "Your instincts say you shouldn't be following these.";
	icon_state = "ltrails_1";
	dir = 6
	},
/turf/open/misc/asteroid/basalt/lava_land_surface,
/area/lavaland/surface/outdoors)
"fi" = (
/turf/closed/wall/mineral/titanium/survival/pod,
/area/ruin/powered)
"fq" = (
/obj/structure/stone_tile/block/burnt,
/obj/structure/stone_tile/surrounding_tile/cracked{
	dir = 5
	},
/obj/effect/decal/cleanable/molten_object,
/obj/effect/decal/cleanable/rubble,
/obj/effect/decal/cleanable/dirt,
/obj/effect/decal/cleanable/ash{
	pixel_y = -7;
	pixel_x = 4
	},
/obj/item/bodypart/head/golem,
/obj/effect/turf_decal/tile/dark/full,
/turf/open/floor/pod,
/area/ruin/powered)
"fH" = (
/obj/structure/fans,
/obj/effect/turf_decal/tile/dark/full,
/turf/open/floor/pod/dark,
/area/ruin/powered)
"fO" = (
/obj/structure/stone_tile/block/cracked,
/obj/structure/stone_tile/cracked{
	dir = 1
	},
/obj/structure/stone_tile/surrounding_tile/cracked{
	dir = 5
	},
/turf/open/floor/holofloor/hyperspace,
/area/ruin/powered)
"gk" = (
/turf/template_noop,
/area/template_noop)
"gC" = (
/obj/effect/turf_decal/trimline/dark/filled/line,
/obj/effect/decal/cleanable/dirt/dust,
/turf/open/floor/pod/dark,
/area/ruin/powered)
"gP" = (
/obj/structure/stone_tile/slab,
/turf/open/floor/holofloor/hyperspace,
/area/ruin/powered)
"hd" = (
/obj/structure/stone_tile/cracked{
	dir = 8
	},
/obj/structure/stone_tile/block/cracked{
	dir = 1
	},
/obj/structure/stone_tile,
/turf/open/floor/holofloor/hyperspace,
/area/ruin/powered)
"hr" = (
/obj/structure/stone_tile,
/obj/item/stack/ore/gold{
	pixel_y = 7;
	pixel_x = -11
	},
/obj/structure/trap/damage{
	name = "Anctient runic spikes";
	desc = "A strange carving of some symbols. What's that for?";
	icon = 'icons/obj/service/hydroponics/equipment.dmi';
	icon_state = "woodspike";
	light_color = "#DDFFDD";
	color = "#77FF77";
	alpha = 180
	},
/turf/open/misc/asteroid/basalt/lava_land_surface,
/area/lavaland/surface/outdoors)
"hL" = (
/obj/structure/stone_tile/surrounding/burnt,
/obj/structure/stone_tile/center/burnt,
/obj/effect/decal/cleanable/dirt/dust,
/obj/effect/mob_spawn/ghost_role/human/golem/adamantine{
	name = "Ancient golem";
	flavour_text = "Investigate your surroundings and seek for purpose. You are on your own now.";
	desc = "Motionless guard of this forgotten place.";
	you_are_text = "You are an ancient golem. For ages, you have served your master well, but one day left he never returned. Something terrible has shaken your precious sanctuary and disturbed your eternal slumber.";
	prompt_name = "an ancient golem"
	},
/turf/open/floor/holofloor/hyperspace,
/area/ruin/powered)
"iy" = (
/obj/structure/table,
/obj/item/chisel{
	pixel_y = 8;
	pixel_x = -7
	},
/obj/item/stack/marker_beacon/thirty{
	pixel_y = 10;
	pixel_x = 10
	},
/obj/effect/spawner/random/decoration/glowstick,
/turf/open/floor/pod,
/area/ruin/powered)
"jr" = (
/obj/effect/decal/cleanable/robot_debris,
/obj/effect/turf_decal/trimline/dark/filled/line,
/turf/open/floor/pod/dark,
/area/ruin/powered)
"jO" = (
/obj/structure/reagent_dispensers/plumbed,
/obj/effect/turf_decal/tile/dark/full,
/turf/open/floor/pod/dark,
/area/ruin/powered)
"km" = (
/obj/effect/turf_decal/mining,
/turf/closed/wall/mineral/titanium/survival/pod,
/area/ruin/powered)
"kn" = (
/obj/effect/turf_decal/mining/survival{
	dir = 1
	},
/turf/closed/wall/mineral/titanium/survival/pod,
/area/ruin/powered)
"kZ" = (
/obj/effect/turf_decal/trimline/dark/filled/corner,
/obj/effect/decal/cleanable/dirt,
/turf/open/floor/pod/light,
/area/ruin/powered)
"lR" = (
/obj/effect/decal/cleanable/glass/titanium,
/obj/item/stack/ore/silver,
/turf/open/floor/pod,
/area/ruin/powered)
"mh" = (
/obj/structure/stone_tile/surrounding,
/obj/structure/stone_tile/center,
/obj/structure/fluff/divine/conduit,
/turf/open/floor/holofloor/hyperspace,
/area/ruin/powered)
"mz" = (
/obj/effect/decal/cleanable/blood/tracks{
	dir = 8
	},
/obj/effect/decal/cleanable/blood/tracks{
	dir = 8
	},
/obj/structure/stone_tile/burnt,
/turf/open/misc/asteroid/basalt/lava_land_surface,
/area/lavaland/surface/outdoors)
"nj" = (
/obj/effect/decal/cleanable/blood/tracks{
	dir = 8
	},
/obj/structure/stone_tile/block/cracked{
	dir = 1
	},
/turf/open/misc/asteroid/basalt/lava_land_surface,
/area/lavaland/surface/outdoors)
"nB" = (
/obj/effect/turf_decal/trimline/dark/filled/line,
/obj/effect/turf_decal/trimline/dark/filled/corner{
	dir = 4
	},
/turf/open/floor/pod,
/area/ruin/powered)
"oL" = (
/obj/effect/decal/cleanable/blood/tracks{
	dir = 8
	},
/obj/structure/stone_tile/cracked{
	dir = 8
	},
/turf/open/misc/asteroid/basalt/lava_land_surface,
/area/lavaland/surface/outdoors)
"px" = (
/obj/structure/fans/tiny,
/obj/structure/marker_beacon/burgundy,
/obj/effect/turf_decal/trimline/dark/filled/corner{
	dir = 4
	},
/obj/machinery/door/airlock/survival_pod,
/turf/open/floor/pod/dark,
/area/ruin/powered)
"qf" = (
/obj/structure/stone_tile/block{
	dir = 1
	},
/obj/structure/stone_tile/block,
/obj/item/stack/sheet/mineral/stone{
	pixel_y = 5;
	pixel_x = -8
	},
/turf/open/floor/holofloor/hyperspace,
/area/ruin/powered)
"rF" = (
/obj/machinery/autolathe,
/obj/effect/turf_decal/tile/dark/full,
/turf/open/floor/pod/dark,
/area/ruin/powered)
"rJ" = (
/turf/open/misc/asteroid/basalt/lava_land_surface,
/area/lavaland/surface/outdoors)
"rS" = (
/obj/structure/stone_tile/center/cracked,
/obj/effect/decal/cleanable/rubble,
/obj/effect/decal/cleanable/dirt,
/obj/effect/turf_decal/trimline/dark/filled/line,
/obj/item/organ/internal/liver/golem,
/turf/open/floor/pod/dark,
/area/ruin/powered)
"sm" = (
/obj/effect/decal/cleanable/blood,
/obj/item/shovel{
	throw_speed = 7;
	throwforce = 7;
	tk_throw_range = 18;
	throw_range = 9;
	attack_speed = 24;
	name = "Bladed battle shovel";
	desc = "A large tool for digging, and breaching skulls."
	},
/obj/structure/stone_tile/block/cracked,
/obj/structure/stone_tile/burnt{
	dir = 1
	},
/turf/open/misc/asteroid/basalt/lava_land_surface,
/area/lavaland/surface/outdoors)
"tC" = (
/obj/structure/table/wood/fancy/black,
/obj/item/organ/internal/eyes/golem{
	pixel_y = 4;
	pixel_x = 5
	},
/obj/item/organ/internal/eyes/golem{
	pixel_y = 4;
	pixel_x = -4
	},
/obj/structure/stone_tile/slab,
/obj/structure/marker_beacon/teal,
/obj/structure/stone_tile/slab,
/obj/item/organ/internal/appendix/golem{
	pixel_x = -15;
	pixel_y = 10
	},
/obj/item/organ/internal/stomach/golem{
	pixel_x = -15;
	pixel_y = -5
	},
/turf/open/floor/holofloor/hyperspace,
/area/ruin/powered)
"tG" = (
/obj/effect/decal/cleanable/shreds,
/obj/effect/turf_decal/trimline/dark/filled/corner,
/turf/open/floor/pod/dark,
/area/ruin/powered)
"tK" = (
/obj/structure/stone_tile/surrounding_tile/burnt,
/obj/effect/spawner/random/decoration/glowstick,
/obj/item/bodypart/leg/right/golem,
/obj/effect/turf_decal/trimline/dark/filled/line{
	dir = 1
	},
/turf/open/floor/pod,
/area/ruin/powered)
"tN" = (
/obj/effect/turf_decal/trimline/dark/filled/corner{
	dir = 4
	},
/obj/effect/decal/cleanable/dirt,
/turf/open/floor/pod/light,
/area/ruin/powered)
"uD" = (
/obj/effect/decal/cleanable/dirt,
/obj/effect/spawner/random/animalhide,
/obj/effect/turf_decal/trimline/dark/filled/line,
/turf/open/floor/pod/dark,
/area/ruin/powered)
"uP" = (
/obj/item/stack/cable_coil/five{
	pixel_y = 7;
	pixel_x = 4
	},
/obj/effect/spawner/random/entertainment/money_large,
/obj/effect/turf_decal/trimline/dark/filled/line,
/obj/effect/turf_decal/trimline/dark/filled/line{
	dir = 1
	},
/turf/open/floor/pod,
/area/ruin/powered)
"vn" = (
/obj/effect/decal/cleanable/blood/gibs/core,
/obj/effect/decal/cleanable/blood,
/obj/structure/trap/cult{
	name = "Anctient runic spikes";
	desc = "A strange carving of some symbols. What's that for?";
	alpha = 180;
	icon = 'icons/obj/service/hydroponics/equipment.dmi';
	icon_state = "woodspike";
	light_color = "#FF9911";
	color = "#FF9911"
	},
/turf/open/misc/asteroid/basalt/lava_land_surface,
/area/lavaland/surface/outdoors)
"vq" = (
/obj/machinery/light/directional/east{
	bulb_colour = "#2C3BFF";
	color = "#aa1200";
	light_color = "#aa1200"
	},
/obj/machinery/vending/clothing{
	onstation = 0
	},
/obj/effect/turf_decal/tile/dark/full,
/turf/open/floor/pod,
/area/ruin/powered)
"vu" = (
/obj/structure/fans/tiny,
/obj/structure/marker_beacon/burgundy,
/obj/machinery/door/airlock/survival_pod,
/obj/effect/turf_decal/trimline/dark/filled/corner,
/turf/open/floor/pod/dark,
/area/ruin/powered)
"vx" = (
/obj/structure/stone_tile/center/burnt,
/turf/open/floor/pod,
/area/ruin/powered)
"wb" = (
/obj/item/wrench,
/obj/effect/turf_decal/trimline/dark/filled/line{
	dir = 1
	},
/obj/effect/turf_decal/trimline/dark/filled/line,
/obj/effect/decal/cleanable/dirt,
/turf/open/floor/pod,
/area/ruin/powered)
"wh" = (
/obj/structure/flora/rock/style_random,
/turf/open/misc/asteroid/basalt/lava_land_surface,
/area/lavaland/surface/outdoors)
"wl" = (
/obj/machinery/power/shuttle_engine/heater{
	dir = 4
	},
/turf/closed/wall/mineral/titanium/survival/pod,
/area/ruin/powered)
"wt" = (
/obj/effect/turf_decal/mining/survival,
/turf/closed/wall/mineral/titanium/survival/nodiagonal,
/area/ruin/powered)
"wH" = (
/obj/effect/decal/cleanable/dirt,
/obj/effect/spawner/random/clothing/funny_hats,
/obj/effect/turf_decal/tile/dark/full,
/turf/open/floor/pod/dark,
/area/ruin/powered)
"xF" = (
/obj/structure/extinguisher_cabinet/directional/south,
/obj/effect/turf_decal/trimline/dark/filled/line,
/turf/open/floor/pod/dark,
/area/ruin/powered)
"xT" = (
/obj/structure/stone_tile/slab,
/obj/effect/mob_spawn/ghost_role/human/golem/adamantine{
	name = "Ancient golem";
	flavour_text = "Investigate your surroundings and seek for purpose. You are on your own now.";
	desc = "Motionless guard of this forgotten place.";
	you_are_text = "You are an ancient golem. For ages, you have served your master well, but one day left he never returned. Something terrible has shaken your precious sanctuary and disturbed your eternal slumber.";
	prompt_name = "an ancient golem"
	},
/turf/open/floor/holofloor/hyperspace,
/area/ruin/powered)
"zr" = (
/obj/structure/stone_tile/slab/cracked{
	dir = 10
	},
/obj/effect/turf_decal/trimline/dark/filled/line{
	dir = 1
	},
/obj/effect/decal/cleanable/oil,
/obj/item/stack/sheet/spaceshipglass,
/turf/open/floor/pod/dark,
/area/ruin/powered)
"zw" = (
/obj/structure/ore_box,
/obj/effect/turf_decal/trimline/dark/filled/corner{
	dir = 8
	},
/turf/open/floor/pod/light,
/area/ruin/powered)
"zO" = (
/obj/structure/stone_tile/surrounding/cracked{
	dir = 4
	},
/turf/open/misc/asteroid/basalt/lava_land_surface,
/area/lavaland/surface/outdoors)
"Ab" = (
/obj/effect/decal/cleanable/ash{
	pixel_y = -7;
	pixel_x = 4
	},
/turf/open/misc/asteroid/basalt/lava_land_surface,
/area/lavaland/surface/outdoors)
"Ag" = (
/obj/structure/flora/rock/pile/style_random,
/turf/open/misc/asteroid/basalt/lava_land_surface,
/area/lavaland/surface/outdoors)
"AT" = (
/obj/effect/decal/cleanable/blood/drip,
/turf/open/misc/asteroid/basalt/lava_land_surface,
/area/lavaland/surface/outdoors)
"AY" = (
/obj/structure/stone_tile/surrounding/cracked{
	dir = 1
	},
/obj/structure/stone_tile/center/cracked,
/obj/structure/stone_tile/surrounding_tile/cracked{
	dir = 5
	},
/obj/effect/mob_spawn/ghost_role/human/golem/adamantine{
	name = "Ancient golem";
	flavour_text = "Investigate your surroundings and seek for purpose. You are on your own now.";
	desc = "Motionless guard of this forgotten place.";
	you_are_text = "You are an ancient golem. For ages, you have served your master well, but one day left he never returned. Something terrible has shaken your precious sanctuary and disturbed your eternal slumber.";
	prompt_name = "an ancient golem"
	},
/turf/open/floor/holofloor/hyperspace,
/area/ruin/powered)
"Bu" = (
/obj/effect/spawner/random/exotic/technology,
/obj/effect/turf_decal/trimline/dark/filled/line{
	dir = 1
	},
/obj/effect/turf_decal/trimline/dark/filled/line,
/obj/effect/decal/cleanable/dirt,
/turf/open/floor/pod,
/area/ruin/powered)
"BH" = (
/obj/item/pickaxe,
/obj/structure/flora/rock/pile/style_random,
/turf/open/misc/asteroid/basalt/lava_land_surface,
/area/lavaland/surface/outdoors)
"CV" = (
/obj/structure/stone_tile/burnt{
	dir = 1
	},
/obj/item/reagent_containers/hypospray/medipen/survival,
/turf/open/misc/asteroid/basalt/lava_land_surface,
/area/lavaland/surface/outdoors)
"Dj" = (
/obj/structure/tubes,
/obj/structure/reagent_dispensers/fueltank,
/obj/effect/turf_decal/tile/dark/full,
/turf/open/floor/pod/dark,
/area/ruin/powered)
"Dw" = (
/obj/effect/decal/cleanable/ash{
	pixel_x = -15;
	pixel_y = -3
	},
/turf/open/misc/asteroid/basalt/lava_land_surface,
/area/lavaland/surface/outdoors)
"Dx" = (
/turf/closed/indestructible/riveted/boss,
/area/ruin/powered)
"DF" = (
/obj/item/pickaxe,
/obj/item/storage/bag/ore{
	pixel_x = -5;
	pixel_y = -5
	},
/obj/structure/extinguisher_cabinet/directional/north,
/obj/effect/turf_decal/trimline/dark/filled/line{
	dir = 1
	},
/turf/open/floor/pod/dark,
/area/ruin/powered)
"Ei" = (
/obj/structure/flora/ash/stem_shroom,
/obj/effect/mob_spawn/corpse/human/miner,
/turf/open/misc/asteroid/basalt/lava_land_surface,
/area/lavaland/surface/outdoors)
"EP" = (
/obj/structure/fluff/divine/conduit,
/obj/structure/stone_tile/surrounding,
/obj/structure/stone_tile/center,
/obj/effect/decal/cleanable/cobweb,
/turf/open/floor/holofloor/hyperspace,
/area/ruin/powered)
"EW" = (
/obj/structure/stone_tile/center/cracked,
/turf/open/misc/asteroid/basalt/lava_land_surface,
/area/lavaland/surface/outdoors)
"Fr" = (
/obj/effect/turf_decal/trimline/dark/filled/line{
	dir = 1
	},
/obj/effect/turf_decal/trimline/dark/filled/corner,
/obj/effect/decal/cleanable/dirt/dust,
/obj/item/storage/medkit/brute{
	pixel_y = 7;
	pixel_x = -11
	},
/turf/open/floor/pod,
/area/ruin/powered)
"Ft" = (
/obj/effect/decal/cleanable/blood/tracks{
	desc = "Your instincts say you shouldn't be following these.";
	dir = 8;
	icon_state = "ltrails_1"
	},
/turf/open/misc/asteroid/basalt/lava_land_surface,
/area/lavaland/surface/outdoors)
"FC" = (
/obj/effect/turf_decal/trimline/dark/filled/corner{
	dir = 1
	},
/obj/effect/decal/cleanable/dirt/dust,
/turf/open/floor/pod/light,
/area/ruin/powered)
"Gd" = (
/obj/machinery/computer/order_console/mining/golem{
	name = "Mining equipment vendor"
	},
/obj/effect/turf_decal/tile/dark/full,
/turf/open/floor/pod,
/area/ruin/powered)
"Gf" = (
/obj/structure/flora/ash/seraka,
/obj/effect/spawner/random/food_or_drink/snack,
/turf/open/misc/asteroid/basalt/lava_land_surface,
/area/lavaland/surface/outdoors)
"GQ" = (
/obj/structure/stone_tile/surrounding_tile/cracked,
/obj/effect/decal/cleanable/dirt,
/obj/effect/spawner/random/bureaucracy/pen,
/obj/effect/turf_decal/trimline/dark/filled/corner{
	dir = 8
	},
/turf/open/floor/pod,
/area/ruin/powered)
"Hq" = (
/obj/structure/stone_tile/slab/cracked{
	dir = 5
	},
/obj/structure/stone_tile/slab/cracked{
	dir = 10
	},
/turf/open/floor/holofloor/hyperspace,
/area/ruin/powered)
"HT" = (
/obj/structure/stone_tile/block,
/obj/structure/stone_tile/block{
	dir = 1
	},
/obj/effect/decal/cleanable/dirt/dust,
/turf/open/floor/holofloor/hyperspace,
/area/ruin/powered)
"Is" = (
/obj/structure/tubes,
/obj/effect/turf_decal/trimline/dark/filled/end{
	dir = 4
	},
/obj/item/bedsheet/pirate,
/obj/item/bedsheet/pirate,
/obj/item/bedsheet/pirate,
/obj/item/bedsheet/pirate,
/turf/open/floor/pod,
/area/ruin/powered)
"Jb" = (
/obj/effect/turf_decal/trimline/dark/filled/line{
	dir = 1
	},
/obj/effect/decal/cleanable/dirt,
/turf/open/floor/pod/dark,
/area/ruin/powered)
"Jr" = (
/obj/structure/fluff/divine/nexus,
/obj/structure/showcase/wizard{
	name = "The Great Sculptor";
	desc = "Whoever he was, he definitely looked majestic."
	},
/obj/structure/stone_tile/slab,
/turf/open/floor/holofloor/hyperspace,
/area/ruin/powered)
"Ka" = (
/obj/structure/marker_beacon/jade,
/obj/machinery/stasis/survival_pod,
/obj/effect/turf_decal/tile/dark/full,
/turf/open/floor/pod/dark,
/area/ruin/powered)
"LT" = (
/obj/effect/spawner/random/entertainment/cigar,
/obj/effect/turf_decal/trimline/dark/filled/line,
/turf/open/floor/pod/dark,
/area/ruin/powered)
"Mt" = (
/obj/structure/tubes,
/obj/effect/turf_decal/trimline/dark/filled/end{
	dir = 4
	},
/obj/effect/decal/cleanable/fuel_pool,
/turf/open/floor/pod,
/area/ruin/powered)
"Mz" = (
/obj/effect/turf_decal/trimline/dark/filled/line,
/turf/open/floor/pod/dark,
/area/ruin/powered)
"Nw" = (
/obj/structure/stone_tile/slab/cracked{
	dir = 10
	},
/obj/effect/decal/cleanable/dirt/dust,
/turf/open/floor/pod,
/area/ruin/powered)
"NC" = (
/obj/structure/frame/machine,
/obj/item/circuitboard/machine/ore_redemption/offstation{
	pixel_y = -13;
	pixel_x = 7
	},
/obj/effect/turf_decal/tile/dark/full,
/turf/open/floor/pod,
/area/ruin/powered)
"Of" = (
/obj/machinery/power/shuttle_engine/propulsion{
	dir = 4
	},
/turf/open/misc/asteroid/basalt/lava_land_surface,
/area/ruin/powered)
"Oi" = (
/obj/structure/stone_tile/surrounding/cracked,
/obj/structure/stone_tile/surrounding_tile/burnt,
/obj/effect/decal/cleanable/dirt/dust,
/obj/item/reagent_containers/cup/primitive_centrifuge{
	pixel_x = -14;
	pixel_y = -1
	},
/turf/open/floor/holofloor/hyperspace,
/area/ruin/powered)
"OS" = (
/obj/item/stack/sheet/iron/ten,
/obj/effect/turf_decal/trimline/dark/filled/line{
	dir = 8
	},
/turf/open/floor/pod,
/area/ruin/powered)
"OY" = (
/turf/closed/wall/mineral/titanium/survival/nodiagonal,
/area/ruin/powered)
"PD" = (
/obj/effect/decal/cleanable/blood/tracks{
	desc = "Your instincts say you shouldn't be following these.";
	dir = 8;
	icon_state = "ltrails_2"
	},
/turf/open/misc/asteroid/basalt/lava_land_surface,
/area/lavaland/surface/outdoors)
"PL" = (
/obj/effect/decal/cleanable/oil/streak,
/obj/effect/spawner/random/entertainment/lighter,
/obj/effect/turf_decal/trimline/dark/filled/corner{
	dir = 1
	},
/turf/open/floor/pod,
/area/ruin/powered)
"Qd" = (
/obj/structure/table/wood/fancy/black,
/obj/structure/fluff/divine/convertaltar,
/obj/item/organ/internal/adamantine_resonator,
/obj/item/organ/internal/adamantine_resonator{
	pixel_y = 10
	},
/obj/structure/stone_tile/slab,
/obj/structure/stone_tile/slab,
/turf/open/floor/holofloor/hyperspace,
/area/ruin/powered)
"Qs" = (
/obj/structure/stone_tile/surrounding,
/obj/structure/stone_tile/center,
/obj/effect/mob_spawn/ghost_role/human/golem/adamantine{
	name = "Ancient golem";
	flavour_text = "Investigate your surroundings and seek for purpose. You are on your own now.";
	desc = "Motionless guard of this forgotten place.";
	you_are_text = "You are an ancient golem. For ages, you have served your master well, but one day left he never returned. Something terrible has shaken your precious sanctuary and disturbed your eternal slumber.";
	prompt_name = "an ancient golem"
	},
/turf/open/floor/holofloor/hyperspace,
/area/ruin/powered)
"Qw" = (
/obj/structure/table/survival_pod,
/obj/item/blueprints/golem{
	pixel_y = 3;
	pixel_x = -2
	},
/obj/effect/turf_decal/tile/dark/full,
/turf/open/floor/pod/dark,
/area/ruin/powered)
"QL" = (
/obj/structure/fans/tiny,
/obj/structure/marker_beacon/burgundy,
/obj/machinery/door/airlock/survival_pod,
/obj/effect/turf_decal/trimline/dark/filled/corner{
	dir = 8
	},
/turf/open/floor/pod/dark,
/area/ruin/powered)
"RN" = (
/obj/structure/fans/tiny,
/obj/structure/marker_beacon/burgundy,
/obj/machinery/door/airlock/survival_pod,
/obj/effect/turf_decal/trimline/dark/filled/corner{
	dir = 1
	},
/turf/open/floor/pod/dark,
/area/ruin/powered)
"RW" = (
/obj/structure/stone_tile/slab/cracked{
	dir = 1
	},
/obj/effect/decal/cleanable/dirt,
/obj/effect/turf_decal/tile/dark/full,
/obj/item/stack/sheet/spaceship,
/turf/open/floor/pod,
/area/ruin/powered)
"Sv" = (
/obj/effect/turf_decal/mining/survival,
/turf/closed/wall/mineral/titanium/survival/pod,
/area/ruin/powered)
"Sy" = (
/obj/structure/stone_tile/block/burnt,
/obj/structure/stone_tile/surrounding_tile/cracked{
	dir = 1
	},
/obj/effect/decal/cleanable/dirt,
/obj/effect/decal/cleanable/ash{
	pixel_x = -15;
	pixel_y = -3
	},
/obj/item/bodypart/leg/left/golem,
/obj/effect/turf_decal/trimline/dark/filled/line,
/turf/open/floor/pod,
/area/ruin/powered)
"SU" = (
/obj/structure/geyser,
/turf/open/misc/asteroid/basalt/lava_land_surface,
/area/lavaland/surface/outdoors)
"Tj" = (
/obj/item/wrench/makeshift,
/obj/effect/turf_decal/trimline/dark/filled/line{
	dir = 4
	},
/turf/open/floor/pod,
/area/ruin/powered)
"Ud" = (
/obj/machinery/smartfridge/survival_pod/preloaded,
/obj/effect/turf_decal/tile/dark/full,
/turf/open/floor/pod/dark,
/area/ruin/powered)
"Ug" = (
/obj/structure/table/wood/fancy/black,
/obj/item/organ/internal/vocal_cords/adamantine{
	pixel_x = -5;
	pixel_y = 5
	},
/obj/item/organ/internal/vocal_cords/adamantine{
	pixel_y = 5;
	pixel_x = 5
	},
/obj/structure/stone_tile/slab,
/obj/structure/marker_beacon/teal,
/obj/structure/stone_tile/slab,
/obj/item/organ/internal/appendix/golem{
	pixel_x = 15;
	pixel_y = 10
	},
/obj/item/organ/internal/stomach/golem{
	pixel_x = 15;
	pixel_y = -5
	},
/turf/open/floor/holofloor/hyperspace,
/area/ruin/powered)
"UU" = (
/obj/structure/stone_tile/slab/cracked{
	dir = 8
	},
/obj/structure/stone_tile/surrounding_tile/burnt,
/obj/effect/decal/cleanable/dirt,
/obj/effect/decal/cleanable/ash{
	pixel_x = -15;
	pixel_y = -3
	},
/obj/item/stack/ore/iron{
	pixel_y = -17;
	pixel_x = 10
	},
/obj/item/bodypart/arm/left/golem,
/obj/effect/turf_decal/tile/dark/full,
/turf/open/floor/pod,
/area/ruin/powered)
"UZ" = (
/obj/structure/stone_tile/slab/cracked,
/turf/open/floor/holofloor/hyperspace,
/area/ruin/powered)
"Vl" = (
/obj/structure/stone_tile/slab/cracked{
	dir = 4
	},
/obj/effect/decal/cleanable/shreds,
/obj/effect/decal/cleanable/rubble,
/obj/effect/decal/cleanable/dirt,
/obj/effect/decal/cleanable/dirt,
/obj/effect/decal/cleanable/ash/large{
	pixel_x = 15;
	pixel_y = -5
	},
/obj/item/bodypart/chest/golem{
	pixel_x = -10
	},
/obj/item/stack/ore/plasma{
	pixel_x = -8;
	pixel_y = -8
	},
/obj/effect/turf_decal/trimline/dark/filled/line{
	dir = 1
	},
/turf/open/floor/pod/dark,
/area/ruin/powered)
"Wg" = (
/obj/effect/decal/cleanable/dirt,
/turf/open/floor/pod,
/area/ruin/powered)
"WZ" = (
/obj/structure/stone_tile/surrounding_tile/cracked,
/obj/item/stock_parts/cell/crystal_cell,
/obj/item/stack/rods/two,
/obj/structure/stone_tile/surrounding/cracked{
	pixel_x = 1;
	pixel_y = -1
	},
/turf/open/floor/holofloor/hyperspace,
/area/ruin/powered)
"Yn" = (
/obj/structure/table,
/obj/item/stock_parts/micro_laser{
	pixel_x = -2
	},
/obj/item/screwdriver{
	pixel_y = 10
	},
/turf/open/floor/pod,
/area/ruin/powered)
"YO" = (
/obj/structure/stone_tile/slab,
/obj/effect/decal/cleanable/dirt/dust,
/obj/item/disk/design_disk/golem_shell{
	pixel_y = 2;
	pixel_x = 6
	},
/turf/open/floor/holofloor/hyperspace,
/area/ruin/powered)

(1,1,1) = {"
gk
Dx
Dx
Dx
gk
gk
Dx
Dx
Dx
gk
"}
(2,1,1) = {"
Dx
Dx
mh
Dx
Dx
Dx
Dx
Vl
Dx
Dx
"}
(3,1,1) = {"
Dx
EP
HT
Qs
qf
hL
fq
ad
ed
Dx
"}
(4,1,1) = {"
Dx
Dx
Ug
dA
gP
Hq
UU
tK
rS
Dx
"}
(5,1,1) = {"
Dx
Jr
Qd
YO
xT
Sy
RW
at
uD
wt
"}
(6,1,1) = {"
Dx
Dx
tC
UZ
hd
GQ
OS
PL
LT
OY
"}
(7,1,1) = {"
Dx
bj
fO
AY
Oi
lR
vx
Nw
jr
OY
"}
(8,1,1) = {"
Dx
Dx
WZ
Dx
Dx
zr
bW
tG
dq
wt
"}
(9,1,1) = {"
gk
Dx
Dx
Dx
OY
bU
Wg
Mz
OY
OY
"}
(10,1,1) = {"
gk
gk
hr
sm
QL
FC
Wg
zw
RN
gk
"}
(11,1,1) = {"
gk
gk
AT
ei
vu
tN
bW
kZ
px
gk
"}
(12,1,1) = {"
gk
wh
Ft
fi
fi
DF
Yn
xF
fi
fi
"}
(13,1,1) = {"
gk
PD
CV
kn
fH
Jb
iy
gC
rF
Sv
"}
(14,1,1) = {"
gk
vn
EW
fi
Ka
Fr
Tj
nB
wH
fi
"}
(15,1,1) = {"
gk
oL
Ag
fi
Qw
Bu
NC
uP
bm
km
"}
(16,1,1) = {"
gk
mz
zO
fi
Ud
wb
Gd
eg
jO
fi
"}
(17,1,1) = {"
gk
nj
Gf
kn
dF
Is
vq
Mt
Dj
Sv
"}
(18,1,1) = {"
gk
cT
BH
fi
fi
wl
wl
wl
fi
fi
"}
(19,1,1) = {"
gk
Ei
gk
fi
fi
Of
Of
Of
fi
fi
"}
(20,1,1) = {"
gk
gk
gk
SU
Ag
rJ
Dw
rJ
Ab
gk
"}
