//MAP CONVERTED BY dmm2tgm.py THIS HEADER COMMENT PREVENTS RECONVERSION, DO NOT REMOVE
"a" = (
/turf/template_noop,
/area/template_noop)
"c" = (
/obj/structure/stone_tile/slab/cracked,
/obj/effect/spawner/random/entertainment/coin{
	pixel_x = 7;
	pixel_y = -4
	},
/turf/closed/mineral/volcanic/lava_land_surface,
/area/lavaland/surface/outdoors)
"e" = (
/obj/structure/stone_tile/block/cracked{
	dir = 8
	},
/turf/open/lava/smooth/lava_land_surface{
	slowdown = 0
	},
/area/lavaland/surface/outdoors)
"f" = (
/obj/structure/stone_tile/block{
	dir = 4
	},
/turf/closed/mineral/volcanic/lava_land_surface,
/area/lavaland/surface/outdoors)
"g" = (
/obj/effect/mapping_helpers/bombable_wall,
/turf/closed/indestructible/riveted/boss/wasteland,
/area/lavaland/surface/outdoors)
"h" = (
/obj/structure/stone_tile/block,
/obj/effect/spawner/random/mob/necropolis_mob,
/turf/closed/mineral/volcanic/lava_land_surface,
/area/lavaland/surface/outdoors)
"j" = (
/obj/structure/stone_tile/block{
	dir = 1
	},
/obj/item/xenoarch/useless_relic{
	name = "Ancient relic";
	desc = "Sort of relic that can be exported through Cargo."
	},
/turf/closed/mineral/random/high_chance/volcanic,
/area/lavaland/surface/outdoors)
"k" = (
/obj/structure/stone_tile/block/cracked{
	dir = 1
	},
/turf/open/lava/smooth/lava_land_surface{
	slowdown = 0
	},
/area/lavaland/surface/outdoors)
"l" = (
/obj/structure/stone_tile{
	dir = 4
	},
/obj/structure/stone_tile{
	dir = 1
	},
/obj/structure/stone_tile/burnt{
	dir = 8
	},
/turf/open/lava/smooth/lava_land_surface{
	slowdown = 0
	},
/area/lavaland/surface/outdoors)
"o" = (
/obj/structure/stone_tile/block{
	dir = 8
	},
/obj/effect/spawner/random/mob/necropolis_mob,
/turf/closed/mineral/volcanic/lava_land_surface,
/area/lavaland/surface/outdoors)
"p" = (
/obj/structure/stone_tile,
/obj/structure/stone_tile{
	dir = 8
	},
/obj/structure/stone_tile{
	dir = 1
	},
/obj/effect/spawner/random/mob/necropolis_mob,
/turf/open/misc/asteroid/basalt/lava_land_surface,
/area/lavaland/surface/outdoors)
"r" = (
/obj/structure/stone_tile/slab/cracked{
	dir = 4
	},
/obj/structure/stone_tile/slab/cracked{
	dir = 8
	},
/turf/closed/mineral/volcanic/lava_land_surface,
/area/lavaland/surface/outdoors)
"v" = (
/obj/structure/stone_tile/burnt{
	dir = 1
	},
/turf/open/lava/smooth/lava_land_surface{
	slowdown = 0
	},
/area/lavaland/surface/outdoors)
"x" = (
/obj/structure/stone_tile/slab,
/turf/closed/mineral/random/high_chance/volcanic,
/area/lavaland/surface/outdoors)
"C" = (
/obj/structure/stone_tile,
/obj/structure/stone_tile{
	dir = 8
	},
/obj/structure/stone_tile{
	dir = 1
	},
/obj/item/xenoarch/useless_relic{
	name = "Ancient relic";
	desc = "Sort of relic that can be exported through Cargo."
	},
/turf/closed/mineral/random/high_chance/volcanic,
/area/lavaland/surface/outdoors)
"D" = (
/obj/structure/stone_tile,
/obj/structure/stone_tile{
	dir = 1
	},
/obj/structure/stone_tile/cracked{
	dir = 8
	},
/turf/closed/mineral/volcanic/lava_land_surface,
/area/lavaland/surface/outdoors)
"J" = (
/obj/structure/stone_tile/block{
	dir = 4
	},
/obj/effect/spawner/random/mob/necropolis_mob,
/turf/closed/mineral/volcanic/lava_land_surface,
/area/lavaland/surface/outdoors)
"N" = (
/turf/closed/indestructible/riveted/boss,
/area/lavaland/surface/outdoors)
"O" = (
/obj/structure/stone_tile/block/cracked,
/turf/open/lava/smooth/lava_land_surface{
	slowdown = 0
	},
/area/lavaland/surface/outdoors)
"Q" = (
/obj/structure/stone_tile,
/obj/structure/stone_tile{
	dir = 4
	},
/obj/structure/stone_tile/cracked{
	dir = 8
	},
/obj/item/xenoarch/useless_relic{
	name = "Ancient relic";
	desc = "Sort of relic that can be exported through Cargo."
	},
/turf/closed/mineral/random/high_chance/volcanic,
/area/lavaland/surface/outdoors)
"R" = (
/obj/structure/stone_tile/block{
	dir = 1
	},
/turf/open/lava/smooth/lava_land_surface{
	slowdown = 0
	},
/area/lavaland/surface/outdoors)
"U" = (
/obj/structure/stone_tile/block,
/turf/closed/mineral/volcanic/lava_land_surface,
/area/lavaland/surface/outdoors)
"Y" = (
/turf/open/lava/smooth/lava_land_surface{
	slowdown = 0
	},
/area/lavaland/surface/outdoors)
"Z" = (
/obj/structure/stone_tile/block{
	dir = 8
	},
/turf/closed/mineral/volcanic/lava_land_surface,
/area/lavaland/surface/outdoors)

(1,1,1) = {"
a
a
N
N
N
a
a
a
a
a
a
a
"}
(2,1,1) = {"
Z
a
g
C
J
a
a
a
a
a
a
a
"}
(3,1,1) = {"
N
N
N
U
a
a
a
a
a
a
a
a
"}
(4,1,1) = {"
a
a
D
a
c
N
N
a
R
N
a
a
"}
(5,1,1) = {"
N
h
a
a
x
N
p
a
k
N
a
a
"}
(6,1,1) = {"
N
a
Z
a
j
N
O
a
v
N
a
a
"}
(7,1,1) = {"
N
a
N
N
N
N
a
a
N
N
a
a
"}
(8,1,1) = {"
N
a
a
f
a
r
a
a
a
f
a
a
"}
(9,1,1) = {"
a
a
a
a
a
a
a
a
a
a
a
a
"}
(10,1,1) = {"
N
N
N
a
a
N
h
a
Y
a
o
a
"}
(11,1,1) = {"
a
J
a
a
N
N
Q
a
e
l
N
N
"}
(12,1,1) = {"
a
a
a
a
N
N
N
g
N
N
N
N
"}
