//MAP CONVERTED BY dmm2tgm.py THIS HEADER COMMENT PREVENTS RECONVERSION, DO NOT REMOVE
"a" = (
/turf/template_noop,
/area/template_noop)
"b" = (
/obj/structure/cannon{
	dir = 4;
	anchored = 0
	},
/obj/effect/turf_decal/siding/wood{
	dir = 1
	},
/turf/open/floor/wood/lavaland,
/area/ruin/unpowered)
"c" = (
/turf/closed/indestructible/riveted/boss,
/area/lavaland/surface/outdoors)
"i" = (
/obj/effect/decal/cleanable/ash{
	pixel_y = -7;
	pixel_x = 4
	},
/obj/structure/table/wood/shuttle_bar,
/obj/structure/fluff{
	density = 1;
	desc = "Ha ha ha, you fool!";
	icon = 'icons/obj/stack_objects.dmi';
	icon_state = "sheet-gold_3";
	name = "fool's gold"
	},
/turf/open/floor/wood/lavaland,
/area/ruin/unpowered)
"j" = (
/obj/structure/rack/wooden,
/obj/item/stack/cannonball/fourteen,
/obj/effect/turf_decal/siding/wood{
	dir = 9
	},
/obj/item/clothing/mask/cigarette/cigar{
	pixel_x = 4
	},
/turf/open/floor/wood/lavaland,
/area/ruin/unpowered)
"o" = (
/obj/item/chair/wood,
/obj/effect/turf_decal/siding/wood{
	dir = 9
	},
/obj/effect/mapping_helpers/broken_floor,
/turf/open/floor/wood/lavaland,
/area/ruin/unpowered)
"p" = (
/obj/effect/decal/cleanable/ash/large{
	pixel_x = 15;
	pixel_y = -5
	},
/obj/effect/turf_decal/siding/wood,
/turf/open/floor/wood/lavaland,
/area/lavaland/surface/outdoors)
"r" = (
/obj/structure/barricade/wooden/crude,
/obj/structure/barricade/wooden,
/obj/effect/turf_decal/siding/wood{
	dir = 1
	},
/obj/effect/mapping_helpers/broken_floor,
/obj/item/feather,
/turf/open/floor/wood/lavaland,
/area/ruin/unpowered)
"s" = (
/obj/structure/barricade/wooden,
/obj/effect/turf_decal/siding/wood{
	dir = 1
	},
/obj/effect/decal/cleanable/dirt,
/turf/open/floor/wood/lavaland,
/area/ruin/unpowered)
"u" = (
/obj/effect/mapping_helpers/broken_floor,
/turf/open/floor/wood/lavaland,
/area/ruin/unpowered)
"x" = (
/obj/effect/decal/cleanable/ash/large,
/obj/effect/turf_decal/siding/wood{
	dir = 1
	},
/turf/open/floor/wood/lavaland,
/area/ruin/unpowered)
"y" = (
/obj/effect/turf_decal/siding/wood,
/obj/effect/decal/cleanable/dirt,
/turf/open/floor/wood/lavaland,
/area/lavaland/surface/outdoors)
"z" = (
/obj/structure/barricade/wooden/crude,
/obj/structure/barricade/wooden,
/obj/effect/turf_decal/siding/wood,
/turf/open/floor/wood/lavaland,
/area/ruin/unpowered)
"A" = (
/obj/effect/decal/cleanable/ants/fire,
/obj/effect/decal/cleanable/ash{
	pixel_x = -10;
	pixel_y = 3
	},
/obj/effect/turf_decal/siding/wood/corner{
	dir = 1
	},
/turf/open/floor/wood/lavaland,
/area/ruin/unpowered)
"B" = (
/turf/closed/mineral/volcanic/lava_land_surface,
/area/lavaland/surface/outdoors)
"C" = (
/turf/closed/wall/mineral/wood/nonmetal,
/area/lavaland/surface/outdoors)
"D" = (
/obj/effect/turf_decal/siding/wood,
/obj/structure/mineral_door/wood{
	color = "#6b6536"
	},
/obj/effect/turf_decal/siding/wood{
	dir = 1
	},
/obj/effect/decal/cleanable/dirt/dust,
/turf/open/floor/wood/lavaland,
/area/ruin/unpowered)
"E" = (
/obj/item/claymore/cutlass,
/obj/effect/turf_decal/siding/wood/corner{
	dir = 8
	},
/turf/open/floor/wood/lavaland,
/area/ruin/unpowered)
"F" = (
/obj/effect/mapping_helpers/broken_floor,
/turf/open/floor/wood/lavaland,
/area/lavaland/surface/outdoors)
"G" = (
/obj/item/stack/cannonball/shellball/seven,
/obj/effect/turf_decal/siding/wood{
	dir = 1
	},
/obj/effect/turf_decal/siding/wood,
/obj/effect/turf_decal/siding/wood{
	dir = 8
	},
/obj/effect/decal/cleanable/dirt/dust,
/obj/item/bedsheet/pirate,
/turf/open/floor/wood/lavaland,
/area/ruin/unpowered)
"H" = (
/obj/effect/decal/cleanable/ash{
	pixel_y = 7
	},
/turf/open/floor/wood/lavaland,
/area/ruin/unpowered)
"I" = (
/obj/effect/mapping_helpers/broken_floor,
/obj/structure/mineral_door/wood{
	color = "#6b6536"
	},
/turf/open/floor/wood/lavaland,
/area/ruin/unpowered)
"J" = (
/obj/structure/barricade/wooden,
/obj/structure/barricade/wooden/crude,
/obj/effect/decal/cleanable/ash{
	pixel_x = -15;
	pixel_y = -7
	},
/turf/open/floor/wood/lavaland,
/area/ruin/unpowered)
"K" = (
/obj/structure/barricade/wooden,
/obj/effect/turf_decal/siding/wood{
	dir = 10
	},
/turf/open/floor/wood/lavaland,
/area/ruin/unpowered)
"O" = (
/obj/effect/decal/remains/human/smokey,
/turf/open/floor/wood/lavaland,
/area/ruin/unpowered)
"P" = (
/obj/structure/barricade/wooden,
/obj/effect/turf_decal/siding/wood{
	dir = 10
	},
/obj/effect/spawner/random/clothing/pirate_or_bandana,
/turf/open/floor/wood/lavaland,
/area/ruin/unpowered)
"Q" = (
/obj/structure/barricade/wooden/crude,
/obj/item/ship_in_a_bottle,
/turf/closed/wall/mineral/wood/nonmetal,
/area/lavaland/surface/outdoors)
"R" = (
/obj/effect/turf_decal/siding/wood{
	dir = 4
	},
/obj/effect/mapping_helpers/broken_floor,
/obj/effect/decal/cleanable/ash{
	pixel_y = 3;
	pixel_x = 12
	},
/obj/effect/decal/cleanable/glass/titanium,
/obj/item/clothing/under/costume/sailor,
/turf/open/floor/wood/lavaland,
/area/ruin/unpowered)
"V" = (
/obj/structure/barricade/wooden,
/obj/structure/barricade/wooden/crude,
/obj/effect/decal/cleanable/ash{
	pixel_x = 15;
	pixel_y = -7
	},
/obj/effect/turf_decal/siding/wood/corner{
	dir = 8
	},
/obj/effect/turf_decal/siding/wood/corner{
	dir = 1
	},
/obj/effect/decal/cleanable/dirt,
/obj/item/clothing/shoes/pirate/armored,
/turf/open/floor/wood/lavaland,
/area/ruin/unpowered)
"X" = (
/obj/structure/barricade/wooden,
/obj/structure/barricade/wooden/crude,
/obj/effect/decal/cleanable/ash{
	pixel_x = -15;
	pixel_y = -3
	},
/turf/open/floor/wood/lavaland,
/area/ruin/unpowered)
"Y" = (
/turf/closed/mineral/random/high_chance/volcanic,
/area/lavaland/surface/outdoors)
"Z" = (
/obj/effect/decal/remains/human,
/obj/effect/turf_decal/siding/wood,
/obj/effect/decal/cleanable/glass/titanium,
/turf/open/floor/wood/lavaland,
/area/ruin/unpowered)

(1,1,1) = {"
a
c
a
C
Y
a
a
"}
(2,1,1) = {"
a
c
Y
C
Y
B
c
"}
(3,1,1) = {"
a
c
C
C
C
B
a
"}
(4,1,1) = {"
B
B
C
G
C
B
B
"}
(5,1,1) = {"
B
C
C
D
C
C
Y
"}
(6,1,1) = {"
c
C
j
V
K
C
Y
"}
(7,1,1) = {"
B
C
s
X
z
C
c
"}
(8,1,1) = {"
Y
Q
b
J
Z
C
C
"}
(9,1,1) = {"
Y
o
A
i
E
P
C
"}
(10,1,1) = {"
C
x
O
H
u
y
C
"}
(11,1,1) = {"
C
r
R
I
a
p
C
"}
(12,1,1) = {"
C
B
C
a
a
F
a
"}
