//MAP CONVERTED BY dmm2tgm.py THIS HEADER COMMENT PREVENTS RECONVERSION, DO NOT REMOVE
"a" = (
/turf/open/lava/smooth/lava_land_surface,
/area/lavaland/surface/outdoors)
"b" = (
/obj/structure/stone_tile/block{
	dir = 4
	},
/turf/closed/mineral/random/high_chance/volcanic,
/area/lavaland/surface/outdoors)
"c" = (
/turf/closed/wall/mineral/abductor,
/area/lavaland/surface/outdoors)
"d" = (
/obj/structure/stone_tile/block/cracked,
/turf/open/lava/smooth/lava_land_surface,
/area/lavaland/surface/outdoors)
"e" = (
/obj/structure/flora/rock/pile/style_random,
/turf/closed/mineral/volcanic/lava_land_surface,
/area/lavaland/surface/outdoors)
"f" = (
/obj/machinery/abductor/pad{
	team_number = 100
	},
/obj/item/cautery/alien,
/turf/open/floor/plating/abductor{
	initial_gas_mix = "LAVALAND_ATMOS"
	},
/area/ruin/unpowered)
"g" = (
/obj/item/bodypart/arm/left/abductor,
/turf/open/floor/plating/abductor{
	initial_gas_mix = "LAVALAND_ATMOS"
	},
/area/ruin/unpowered)
"h" = (
/obj/structure/stone_tile/burnt{
	dir = 4
	},
/obj/structure/stone_tile/block/cracked,
/turf/closed/mineral/random/high_chance/volcanic,
/area/lavaland/surface/outdoors)
"i" = (
/obj/structure/flora/rock/pile/style_random,
/turf/open/misc/asteroid/basalt/lava_land_surface,
/area/lavaland/surface/outdoors)
"j" = (
/obj/structure/stone_tile/cracked,
/turf/closed/mineral/volcanic/lava_land_surface,
/area/lavaland/surface/outdoors)
"k" = (
/obj/structure/stone_tile/surrounding/cracked,
/turf/open/lava/smooth/lava_land_surface,
/area/lavaland/surface/outdoors)
"l" = (
/turf/closed/indestructible/riveted/boss,
/area/lavaland/surface/outdoors)
"m" = (
/obj/structure/stone_tile/cracked,
/obj/structure/stone_tile/burnt{
	dir = 4
	},
/obj/structure/stone_tile{
	dir = 8
	},
/turf/closed/mineral/random/high_chance/volcanic,
/area/lavaland/surface/outdoors)
"n" = (
/turf/closed/indestructible/riveted/boss,
/area/ruin/unpowered)
"o" = (
/obj/machinery/abductor/experiment{
	team_number = 100
	},
/obj/item/circular_saw/alien,
/turf/open/floor/plating/abductor{
	initial_gas_mix = "LAVALAND_ATMOS"
	},
/area/ruin/unpowered)
"p" = (
/turf/closed/mineral/random/high_chance/volcanic,
/area/ruin/unpowered)
"q" = (
/obj/structure/stone_tile/surrounding/cracked{
	dir = 8
	},
/obj/structure/stone_tile/center/burnt,
/obj/structure/stone_tile/surrounding_tile/cracked{
	dir = 5
	},
/turf/open/lava/smooth/lava_land_surface,
/area/lavaland/surface/outdoors)
"r" = (
/obj/machinery/abductor/gland_dispenser,
/turf/open/floor/plating/abductor{
	initial_gas_mix = "LAVALAND_ATMOS"
	},
/area/ruin/unpowered)
"s" = (
/obj/structure/stone_tile/slab/cracked,
/turf/closed/mineral/random/high_chance/volcanic,
/area/lavaland/surface/outdoors)
"t" = (
/obj/item/stack/sheet/mineral/abductor,
/turf/closed/mineral/random/high_chance/volcanic,
/area/ruin/unpowered)
"u" = (
/obj/structure/stone_tile/block{
	dir = 8
	},
/turf/closed/mineral/volcanic/lava_land_surface,
/area/lavaland/surface/outdoors)
"v" = (
/obj/structure/table/abductor,
/turf/open/floor/plating/abductor{
	initial_gas_mix = "LAVALAND_ATMOS"
	},
/area/ruin/unpowered)
"w" = (
/obj/structure/bed/abductor,
/turf/open/floor/plating/abductor{
	initial_gas_mix = "LAVALAND_ATMOS"
	},
/area/ruin/unpowered)
"x" = (
/obj/structure/stone_tile/surrounding_tile/cracked{
	dir = 5
	},
/obj/structure/stone_tile/surrounding_tile/cracked,
/turf/closed/mineral/random/high_chance/volcanic,
/area/lavaland/surface/outdoors)
"y" = (
/turf/template_noop,
/area/template_noop)
"z" = (
/obj/item/hemostat/alien,
/turf/open/floor/plating/abductor{
	initial_gas_mix = "LAVALAND_ATMOS"
	},
/area/ruin/unpowered)
"A" = (
/turf/closed/wall/mineral/abductor,
/area/ruin/unpowered)
"B" = (
/obj/structure/stone_tile/block/cracked{
	dir = 1
	},
/obj/structure/stone_tile/block/burnt,
/turf/open/lava/smooth/lava_land_surface,
/area/lavaland/surface/outdoors)
"C" = (
/obj/item/retractor/alien,
/turf/open/floor/plating/abductor{
	initial_gas_mix = "LAVALAND_ATMOS"
	},
/area/ruin/unpowered)
"D" = (
/obj/structure/stone_tile/surrounding_tile/cracked{
	dir = 8
	},
/turf/closed/mineral/volcanic/lava_land_surface,
/area/lavaland/surface/outdoors)
"E" = (
/obj/item/bodypart/head/abductor,
/mob/living/basic/alien,
/turf/open/floor/plating/abductor{
	initial_gas_mix = "LAVALAND_ATMOS"
	},
/area/ruin/unpowered)
"F" = (
/turf/closed/mineral/random/high_chance/volcanic,
/area/lavaland/surface/outdoors)
"G" = (
/obj/structure/stone_tile/block/cracked,
/turf/closed/mineral/volcanic/lava_land_surface,
/area/lavaland/surface/outdoors)
"H" = (
/obj/structure/stone_tile/burnt,
/turf/closed/mineral/random/high_chance/volcanic,
/area/lavaland/surface/outdoors)
"I" = (
/obj/structure/table/optable/abductor,
/obj/effect/decal/cleanable/xenoblood,
/obj/item/clothing/mask/facehugger/impregnated,
/turf/open/floor/plating/abductor{
	initial_gas_mix = "LAVALAND_ATMOS"
	},
/area/ruin/unpowered)
"J" = (
/obj/structure/table/abductor,
/obj/item/stock_parts/cell/infinite/abductor,
/obj/item/storage/box/alienhandcuffs,
/turf/open/floor/plating/abductor{
	initial_gas_mix = "LAVALAND_ATMOS"
	},
/area/ruin/unpowered)
"K" = (
/obj/item/organ/internal/heart/gland/ventcrawling,
/turf/closed/mineral/volcanic/lava_land_surface,
/area/ruin/unpowered)
"L" = (
/obj/item/surgical_drapes,
/obj/item/paper/guides/antag/abductor,
/obj/item/scalpel/alien,
/turf/open/floor/plating/abductor{
	initial_gas_mix = "LAVALAND_ATMOS"
	},
/area/ruin/unpowered)
"M" = (
/obj/effect/mob_spawn/corpse/human/abductor,
/turf/open/floor/plating/abductor{
	initial_gas_mix = "LAVALAND_ATMOS"
	},
/area/ruin/unpowered)
"N" = (
/obj/structure/stone_tile/slab/cracked{
	dir = 8
	},
/turf/open/lava/smooth/lava_land_surface,
/area/lavaland/surface/outdoors)
"O" = (
/obj/structure/stone_tile/surrounding_tile/cracked{
	dir = 9
	},
/turf/open/lava/smooth/lava_land_surface,
/area/lavaland/surface/outdoors)
"P" = (
/obj/structure/stone_tile/slab/cracked{
	dir = 1
	},
/turf/open/lava/smooth/lava_land_surface,
/area/lavaland/surface/outdoors)
"Q" = (
/obj/structure/flora/rock/style_random,
/turf/open/misc/asteroid/basalt/lava_land_surface,
/area/lavaland/surface/outdoors)
"R" = (
/obj/structure/stone_tile/block,
/obj/structure/stone_tile/cracked{
	dir = 1
	},
/turf/closed/mineral/random/high_chance/volcanic,
/area/lavaland/surface/outdoors)
"S" = (
/obj/structure/stone_tile/burnt,
/turf/open/lava/smooth/lava_land_surface,
/area/lavaland/surface/outdoors)
"T" = (
/obj/structure/closet/abductor,
/turf/open/floor/plating/abductor{
	initial_gas_mix = "LAVALAND_ATMOS"
	},
/area/ruin/unpowered)
"U" = (
/obj/structure/stone_tile/burnt,
/obj/structure/stone_tile{
	dir = 8
	},
/obj/structure/stone_tile/cracked{
	dir = 4
	},
/turf/closed/mineral/volcanic/lava_land_surface,
/area/lavaland/surface/outdoors)
"V" = (
/obj/item/surgicaldrill/alien,
/turf/open/floor/plating/abductor{
	initial_gas_mix = "LAVALAND_ATMOS"
	},
/area/ruin/unpowered)
"W" = (
/obj/structure/stone_tile/cracked,
/obj/structure/stone_tile/block/cracked{
	dir = 1
	},
/turf/closed/mineral/random/high_chance/volcanic,
/area/lavaland/surface/outdoors)
"X" = (
/obj/effect/mapping_helpers/bombable_wall,
/turf/closed/indestructible/riveted/boss/wasteland,
/area/lavaland/surface/outdoors)
"Y" = (
/turf/closed/mineral/volcanic/lava_land_surface,
/area/lavaland/surface/outdoors)
"Z" = (
/obj/item/organ/internal/tongue/abductor,
/turf/open/floor/plating/abductor{
	initial_gas_mix = "LAVALAND_ATMOS"
	},
/area/ruin/unpowered)

(1,1,1) = {"
y
l
U
s
W
X
G
y
y
"}
(2,1,1) = {"
y
l
l
l
m
b
F
u
y
"}
(3,1,1) = {"
l
l
A
l
l
l
l
l
l
"}
(4,1,1) = {"
l
A
A
K
t
p
p
X
h
"}
(5,1,1) = {"
l
A
o
L
C
n
r
l
l
"}
(6,1,1) = {"
l
A
J
z
I
M
v
A
l
"}
(7,1,1) = {"
l
A
f
E
V
Z
w
A
l
"}
(8,1,1) = {"
l
c
A
T
g
T
A
c
l
"}
(9,1,1) = {"
l
a
c
A
A
A
c
a
l
"}
(10,1,1) = {"
X
a
a
a
a
a
a
a
D
"}
(11,1,1) = {"
P
a
a
a
a
a
a
q
s
"}
(12,1,1) = {"
X
d
a
a
a
a
N
l
R
"}
(13,1,1) = {"
l
S
O
a
a
i
a
B
H
"}
(14,1,1) = {"
x
a
Q
a
a
F
k
X
e
"}
(15,1,1) = {"
F
a
F
a
F
F
F
j
y
"}
(16,1,1) = {"
e
F
F
a
a
F
y
l
y
"}
(17,1,1) = {"
y
Y
F
a
F
e
y
y
y
"}
(18,1,1) = {"
y
y
e
a
Y
y
y
y
y
"}
