//MAP CONVERTED BY dmm2tgm.py THIS HEADER COMMENT PREVENTS RECONVERSION, DO NOT REMOVE
"a" = (
/obj/effect/mob_spawn/corpse/human/miner/explorer{
	brute_damage = 150;
	oxy_damage = 50
	},
/obj/effect/decal/cleanable/blood,
/obj/effect/decal/cleanable/blood/drip,
/obj/effect/decal/cleanable/blood/footprints{
	dir = 1
	},
/obj/effect/decal/cleanable/cum,
/obj/effect/spawner/random/mob/goliath,
/turf/open/floor/pod/dark,
/area/ruin/powered)
"b" = (
/obj/structure/marker_beacon/burgundy,
/obj/effect/decal/cleanable/blood,
/obj/effect/decal/cleanable/blood/splatter{
	pixel_y = -18
	},
/obj/effect/decal/cleanable/cum{
	pixel_y = -10;
	pixel_x = -10
	},
/obj/machinery/door/airlock/survival_pod,
/turf/open/floor/pod/dark,
/area/ruin/powered)
"c" = (
/obj/structure/fans,
/turf/open/floor/pod/dark,
/area/ruin/powered)
"h" = (
/obj/effect/turf_decal/mining/survival,
/turf/closed/wall/mineral/titanium/survival/pod,
/area/ruin/powered)
"l" = (
/obj/machinery/stasis/survival_pod,
/turf/open/floor/pod/dark,
/area/ruin/powered)
"p" = (
/obj/effect/turf_decal/mining/survival{
	dir = 4
	},
/turf/closed/wall/mineral/titanium/survival/pod,
/area/ruin/powered)
"t" = (
/turf/closed/wall/mineral/titanium/survival/pod,
/area/ruin/powered)
"w" = (
/obj/structure/tubes,
/obj/item/crowbar,
/obj/effect/decal/cleanable/blood/drip,
/obj/effect/spawner/random/engineering/material_cheap,
/turf/open/floor/pod/dark,
/area/ruin/powered)
"z" = (
/obj/effect/turf_decal/mining/survival{
	dir = 1
	},
/turf/closed/wall/mineral/titanium/survival/pod,
/area/ruin/powered)
"A" = (
/obj/effect/turf_decal/mining/survival{
	dir = 8
	},
/turf/closed/wall/mineral/titanium/survival/pod,
/area/ruin/powered)
"G" = (
/obj/item/pickaxe,
/obj/effect/decal/cleanable/blood,
/obj/effect/spawner/random/entertainment/cigarette,
/obj/item/wormhole_jaunter,
/turf/open/floor/pod/dark,
/area/ruin/powered)
"L" = (
/obj/structure/table/survival_pod,
/obj/item/knife/combat/survival,
/obj/effect/spawner/random/engineering/tool_advanced,
/turf/open/floor/pod/dark,
/area/ruin/powered)
"P" = (
/obj/machinery/smartfridge/survival_pod{
	desc = "A heated storage unit. This one's seen better days.";
	name = "dusty survival pod storage"
	},
/turf/open/floor/pod/dark,
/area/ruin/powered)
"Q" = (
/obj/structure/bed/pod,
/obj/structure/tubes,
/obj/machinery/light/small/broken/directional/east,
/obj/effect/spawner/random/entertainment/cigarette_pack,
/obj/structure/sign/poster/contraband/lusty_xenomorph/directional/east,
/obj/item/bedsheet/black,
/obj/item/kheiral_cuffs,
/turf/open/floor/pod/dark,
/area/ruin/powered)
"R" = (
/obj/item/gps/computer,
/obj/structure/tubes,
/turf/open/floor/pod/dark,
/area/ruin/powered)
"V" = (
/obj/effect/turf_decal/mining,
/turf/closed/wall/mineral/titanium/survival/pod,
/area/ruin/powered)

(1,1,1) = {"
t
t
A
t
t
"}
(2,1,1) = {"
t
c
l
L
h
"}
(3,1,1) = {"
z
P
G
a
b
"}
(4,1,1) = {"
t
R
Q
w
V
"}
(5,1,1) = {"
t
t
p
t
t
"}
