//MAP CONVERTED BY dmm2tgm.py THIS HEADER COMMENT PREVENTS RECONVERSION, DO NOT REMOVE
"af" = (
/obj/structure/fluff/clockwork/clockgolem_remains,
/turf/open/floor/bronze/filled/lavaland,
/area/ruin/powered)
"aD" = (
/obj/structure/stone_tile{
	dir = 4
	},
/obj/structure/fluff/clockwork/alloy_shards/medium_gearbit{
	pixel_x = 12;
	pixel_y = 7
	},
/obj/structure/girder/bronze,
/turf/closed/mineral/strong{
	base_icon_state = "smoothrocks";
	icon = 'modular_nova/modules/liquids/icons/turf/smoothrocks.dmi';
	icon_state = "smoothrocks-55"
	},
/area/lavaland/surface/outdoors)
"aT" = (
/obj/structure/stone_tile,
/turf/closed/mineral/volcanic/lava_land_surface,
/area/lavaland/surface/outdoors)
"bj" = (
/obj/structure/girder/bronze,
/turf/closed/wall/mineral/bronze,
/area/lavaland/surface/outdoors)
"cw" = (
/obj/structure/stone_tile/block/cracked{
	dir = 1
	},
/turf/closed/mineral/volcanic/lava_land_surface,
/area/lavaland/surface/outdoors)
"cy" = (
/obj/structure/stone_tile/block{
	dir = 1
	},
/mob/living/basic/mining/brimdemon,
/turf/open/misc/asteroid/basalt/lava_land_surface,
/area/ruin/powered)
"ds" = (
/turf/closed/indestructible/riveted/boss,
/area/lavaland/surface/outdoors)
"dN" = (
/obj/structure/girder/bronze,
/turf/closed/wall/mineral/bronze,
/area/ruin/powered)
"el" = (
/obj/structure/stone_tile/surrounding/cracked{
	dir = 1
	},
/turf/closed/mineral/volcanic/lava_land_surface,
/area/lavaland/surface/outdoors)
"ep" = (
/obj/structure/stone_tile/slab,
/turf/closed/mineral/strong{
	base_icon_state = "smoothrocks";
	icon = 'modular_nova/modules/liquids/icons/turf/smoothrocks.dmi';
	icon_state = "smoothrocks-55"
	},
/area/lavaland/surface/outdoors)
"eL" = (
/obj/structure/stone_tile{
	dir = 1
	},
/turf/closed/mineral/volcanic/lava_land_surface,
/area/lavaland/surface/outdoors)
"eX" = (
/obj/structure/railing/stone,
/obj/structure/stone_tile{
	dir = 1
	},
/turf/closed/mineral/volcanic/lava_land_surface,
/area/lavaland/surface/outdoors)
"fI" = (
/obj/structure/stone_tile,
/obj/structure/stone_tile/cracked{
	dir = 4
	},
/turf/closed/mineral/volcanic/lava_land_surface,
/area/lavaland/surface/outdoors)
"gZ" = (
/obj/structure/stone_tile/surrounding_tile/burnt{
	dir = 8
	},
/turf/closed/mineral/volcanic/lava_land_surface,
/area/lavaland/surface/outdoors)
"hr" = (
/obj/structure/stone_tile/surrounding_tile{
	dir = 8
	},
/turf/closed/mineral/volcanic/lava_land_surface,
/area/lavaland/surface/outdoors)
"im" = (
/obj/structure/window/bronze/fulltile,
/obj/structure/destructible/clockwork/trap/skewer,
/turf/open/floor/bronze/filled/lavaland,
/area/ruin/powered)
"iX" = (
/obj/item/stack/sheet/bronze,
/turf/open/floor/bronze/filled/lavaland,
/area/ruin/powered)
"ji" = (
/obj/structure/fluff/clockwork/alloy_shards/medium{
	pixel_x = -7;
	pixel_y = 7
	},
/obj/structure/window/bronze/fulltile,
/obj/structure/girder/bronze,
/obj/item/crowbar/brass,
/obj/item/stack/sheet/bronze,
/obj/structure/trap/cult,
/turf/open/floor/bronze/filled/lavaland,
/area/ruin/powered)
"jG" = (
/obj/structure/stone_tile{
	dir = 4
	},
/turf/closed/mineral/strong{
	base_icon_state = "smoothrocks";
	icon = 'modular_nova/modules/liquids/icons/turf/smoothrocks.dmi';
	icon_state = "smoothrocks-55"
	},
/area/lavaland/surface/outdoors)
"jL" = (
/obj/structure/flora/ash/leaf_shroom,
/turf/closed/mineral/volcanic/lava_land_surface,
/area/lavaland/surface/outdoors)
"jO" = (
/obj/structure/stone_tile,
/obj/structure/stone_tile{
	dir = 8
	},
/obj/structure/stone_tile{
	dir = 1
	},
/turf/closed/mineral/volcanic/lava_land_surface,
/area/lavaland/surface/outdoors)
"kD" = (
/obj/item/coin/silver,
/turf/closed/mineral/volcanic/lava_land_surface,
/area/lavaland/surface/outdoors)
"kN" = (
/obj/structure/stone_tile{
	dir = 4
	},
/turf/open/misc/asteroid/basalt/lava_land_surface,
/area/ruin/powered)
"lj" = (
/obj/item/antag_granter/clock_cultist{
	name = "Compressed truth"
	},
/obj/structure/girder/bronze,
/obj/item/stack/sheet/bronze,
/obj/effect/spawner/random/environmentally_safe_anomaly/immobile,
/obj/structure/fluff/clockwork/fallen_armor,
/obj/structure/window/bronze/fulltile,
/obj/structure/marker_beacon/purple,
/obj/item/stock_parts/cell/crystal_cell,
/obj/effect/spawner/random/environmentally_safe_anomaly,
/obj/effect/spawner/random/environmentally_safe_anomaly,
/obj/effect/spawner/random/environmentally_safe_anomaly,
/turf/open/floor/bronze/filled/lavaland,
/area/ruin/powered)
"mf" = (
/obj/item/stack/sheet/bronze,
/turf/closed/mineral/volcanic/lava_land_surface,
/area/lavaland/surface/outdoors)
"mk" = (
/obj/structure/stone_tile/surrounding/burnt,
/obj/structure/stone_tile/center/burnt,
/turf/closed/mineral/volcanic/lava_land_surface,
/area/lavaland/surface/outdoors)
"mn" = (
/turf/open/floor/bronze/filled/lavaland,
/area/lavaland/surface/outdoors)
"ok" = (
/obj/structure/lattice,
/obj/item/stack/sheet/bronze,
/turf/open/misc/asteroid/basalt/lava_land_surface,
/area/ruin/powered)
"oX" = (
/obj/structure/stone_tile/surrounding_tile{
	dir = 8
	},
/obj/structure/stone_tile/block/burnt{
	dir = 4
	},
/turf/closed/mineral/volcanic/lava_land_surface,
/area/lavaland/surface/outdoors)
"pQ" = (
/obj/structure/railing/stone,
/obj/structure/stone_tile/burnt,
/turf/closed/mineral/volcanic/lava_land_surface,
/area/lavaland/surface/outdoors)
"si" = (
/obj/structure/stone_tile{
	dir = 1
	},
/obj/structure/stone_tile/burnt,
/obj/structure/flora/ash/tall_shroom,
/turf/closed/mineral/volcanic/lava_land_surface,
/area/lavaland/surface/outdoors)
"sp" = (
/obj/structure/stone_tile{
	dir = 8
	},
/obj/structure/stone_tile{
	dir = 1
	},
/obj/structure/stone_tile/burnt,
/turf/closed/wall/mineral/bronze,
/area/ruin/powered)
"tw" = (
/obj/structure/stone_tile/center/cracked,
/obj/structure/fluff/clockwork/alloy_shards/medium{
	pixel_x = 7;
	pixel_y = 3
	},
/obj/structure/trap/cult,
/turf/open/misc/asteroid/basalt/lava_land_surface,
/area/ruin/powered)
"tD" = (
/obj/structure/fluff/clockwork/alloy_shards/medium,
/mob/living/basic/clockwork_marauder,
/turf/open/floor/bronze/filled/lavaland,
/area/ruin/powered)
"tT" = (
/obj/structure/stone_tile{
	dir = 4
	},
/obj/structure/stone_tile{
	dir = 8
	},
/turf/closed/mineral/volcanic/lava_land_surface,
/area/lavaland/surface/outdoors)
"uR" = (
/turf/open/floor/bronze/filled/lavaland,
/area/ruin/powered)
"vt" = (
/obj/structure/stone_tile/surrounding_tile,
/turf/closed/mineral/volcanic/lava_land_surface,
/area/lavaland/surface/outdoors)
"vv" = (
/obj/structure/stone_tile/block/cracked,
/mob/living/basic/clockwork_marauder,
/turf/open/misc/asteroid/basalt/lava_land_surface,
/area/ruin/powered)
"wJ" = (
/obj/structure/stone_tile/block/cracked,
/turf/closed/wall/mineral/bronze,
/area/ruin/powered)
"xo" = (
/obj/structure/stone_tile/block/cracked,
/obj/structure/window/bronze/fulltile,
/obj/structure/destructible/clockwork/trap/skewer,
/obj/item/clockwork/weapon/brass_battlehammer,
/obj/structure/marker_beacon/burgundy,
/obj/structure/trap/cult,
/turf/open/misc/asteroid/basalt/lava_land_surface,
/area/ruin/powered)
"xr" = (
/obj/structure/flora/rock/pile/style_random,
/turf/closed/mineral/volcanic/lava_land_surface,
/area/lavaland/surface/outdoors)
"xQ" = (
/obj/structure/stone_tile/block/cracked{
	dir = 4
	},
/turf/closed/mineral/volcanic/lava_land_surface,
/area/lavaland/surface/outdoors)
"xR" = (
/turf/closed/wall/mineral/bronze,
/area/lavaland/surface/outdoors)
"yi" = (
/obj/structure/stone_tile{
	dir = 8
	},
/obj/structure/stone_tile{
	dir = 1
	},
/obj/structure/stone_tile/cracked{
	dir = 4
	},
/turf/closed/mineral/volcanic/lava_land_surface,
/area/lavaland/surface/outdoors)
"yz" = (
/obj/structure/punji_sticks/spikes,
/turf/closed/mineral/volcanic/lava_land_surface,
/area/lavaland/surface/outdoors)
"yO" = (
/obj/structure/flora/ash/tall_shroom,
/turf/closed/mineral/volcanic/lava_land_surface,
/area/lavaland/surface/outdoors)
"zl" = (
/obj/structure/stone_tile{
	dir = 8
	},
/obj/structure/stone_tile{
	dir = 4
	},
/turf/closed/mineral/volcanic/lava_land_surface,
/area/lavaland/surface/outdoors)
"zE" = (
/obj/structure/stone_tile{
	dir = 8
	},
/obj/structure/stone_tile{
	dir = 1
	},
/obj/structure/stone_tile/burnt,
/turf/closed/mineral/strong{
	base_icon_state = "smoothrocks";
	icon = 'modular_nova/modules/liquids/icons/turf/smoothrocks.dmi';
	icon_state = "smoothrocks-55"
	},
/area/lavaland/surface/outdoors)
"zN" = (
/obj/structure/stone_tile/surrounding/cracked{
	dir = 1
	},
/turf/closed/mineral/strong{
	base_icon_state = "smoothrocks";
	icon = 'modular_nova/modules/liquids/icons/turf/smoothrocks.dmi';
	icon_state = "smoothrocks-55"
	},
/area/lavaland/surface/outdoors)
"Ac" = (
/obj/item/stack/sheet/bronze,
/obj/structure/window/bronze/fulltile,
/obj/structure/trap/cult,
/turf/open/floor/bronze/filled/lavaland,
/area/lavaland/surface/outdoors)
"Ah" = (
/obj/structure/stone_tile/surrounding/cracked{
	dir = 6
	},
/obj/structure/stone_tile/center/cracked,
/turf/closed/mineral/volcanic/lava_land_surface,
/area/lavaland/surface/outdoors)
"AH" = (
/obj/structure/window/bronze/fulltile,
/obj/structure/marker_beacon/bronze,
/turf/open/floor/bronze/filled/lavaland,
/area/ruin/powered)
"Bj" = (
/obj/structure/stone_tile/slab,
/turf/closed/mineral/volcanic/lava_land_surface,
/area/lavaland/surface/outdoors)
"BA" = (
/obj/structure/stone_tile/surrounding/cracked{
	dir = 6
	},
/obj/structure/stone_tile/center/cracked,
/obj/item/flashlight/flare/torch,
/turf/closed/mineral/volcanic/lava_land_surface,
/area/lavaland/surface/outdoors)
"BF" = (
/obj/structure/railing/stone/left,
/turf/closed/mineral/volcanic/lava_land_surface,
/area/lavaland/surface/outdoors)
"BQ" = (
/obj/structure/stone_tile{
	dir = 8
	},
/turf/closed/mineral/volcanic/lava_land_surface,
/area/lavaland/surface/outdoors)
"Cm" = (
/obj/structure/girder/bronze,
/obj/structure/trap/cult,
/turf/open/floor/bronze/filled/lavaland,
/area/lavaland/surface/outdoors)
"Cx" = (
/turf/template_noop,
/area/template_noop)
"CU" = (
/obj/structure/punji_sticks/spikes,
/obj/structure/stone_tile/surrounding_tile/cracked{
	dir = 9
	},
/obj/structure/stone_tile/surrounding_tile/cracked{
	dir = 5
	},
/turf/closed/mineral/volcanic/lava_land_surface,
/area/lavaland/surface/outdoors)
"CX" = (
/obj/structure/window/bronze/fulltile,
/obj/structure/destructible/clockwork/trap/skewer,
/turf/open/floor/bronze/filled/lavaland,
/area/lavaland/surface/outdoors)
"CY" = (
/obj/structure/stone_tile{
	dir = 8
	},
/obj/structure/stone_tile{
	dir = 1
	},
/obj/structure/stone_tile/burnt,
/turf/closed/mineral/volcanic/lava_land_surface,
/area/lavaland/surface/outdoors)
"De" = (
/obj/structure/railing/stone,
/obj/structure/flora/rock/pile/style_random,
/turf/closed/mineral/volcanic/lava_land_surface,
/area/lavaland/surface/outdoors)
"Dy" = (
/obj/structure/stone_tile,
/obj/structure/marker_beacon/bronze,
/obj/item/coin/silver,
/turf/open/misc/asteroid/basalt/lava_land_surface,
/area/ruin/powered)
"DJ" = (
/obj/structure/railing/stone,
/turf/closed/mineral/volcanic/lava_land_surface,
/area/lavaland/surface/outdoors)
"DV" = (
/obj/structure/stone_tile/burnt,
/obj/structure/railing/stone,
/turf/closed/mineral/volcanic/lava_land_surface,
/area/lavaland/surface/outdoors)
"EK" = (
/obj/structure/stone_tile/block/burnt,
/obj/structure/punji_sticks/spikes,
/turf/closed/mineral/volcanic/lava_land_surface,
/area/lavaland/surface/outdoors)
"Fd" = (
/obj/structure/destructible/clockwork/trap/lever,
/turf/closed/wall/mineral/bronze,
/area/ruin/powered)
"FX" = (
/obj/structure/lattice,
/mob/living/basic/clockwork_marauder,
/turf/open/misc/asteroid/basalt/lava_land_surface,
/area/ruin/powered)
"FZ" = (
/obj/structure/flora/rock/pile/style_random,
/turf/open/misc/asteroid/basalt/lava_land_surface,
/area/ruin/powered)
"GO" = (
/obj/structure/stone_tile/block/cracked,
/turf/closed/mineral/volcanic/lava_land_surface,
/area/lavaland/surface/outdoors)
"GZ" = (
/obj/effect/mapping_helpers/bombable_wall,
/turf/closed/indestructible/riveted/boss/wasteland,
/area/lavaland/surface/outdoors)
"Hb" = (
/obj/structure/window/bronze/fulltile,
/obj/structure/marker_beacon/burgundy,
/obj/structure/destructible/clockwork/trap/skewer,
/obj/structure/trap/cult,
/turf/open/floor/bronze/filled/lavaland,
/area/lavaland/surface/outdoors)
"HX" = (
/turf/closed/wall/mineral/bronze,
/area/ruin/powered)
"HY" = (
/obj/structure/punji_sticks/spikes,
/obj/structure/stone_tile/surrounding_tile/cracked{
	dir = 4
	},
/turf/closed/mineral/volcanic/lava_land_surface,
/area/lavaland/surface/outdoors)
"Jg" = (
/obj/structure/girder/bronze,
/turf/closed/mineral/strong{
	base_icon_state = "smoothrocks";
	icon = 'modular_nova/modules/liquids/icons/turf/smoothrocks.dmi';
	icon_state = "smoothrocks-55"
	},
/area/lavaland/surface/outdoors)
"JI" = (
/obj/structure/stone_tile/surrounding/cracked,
/turf/closed/mineral/volcanic/lava_land_surface,
/area/lavaland/surface/outdoors)
"JU" = (
/obj/structure/flora/ash/stem_shroom,
/obj/structure/lattice,
/turf/open/misc/asteroid/basalt/lava_land_surface,
/area/lavaland/surface/outdoors)
"Kd" = (
/obj/structure/stone_tile/block/cracked{
	dir = 4
	},
/mob/living/basic/clockwork_marauder,
/turf/open/misc/asteroid/basalt/lava_land_surface,
/area/ruin/powered)
"Kj" = (
/obj/structure/stone_tile/slab/cracked,
/turf/closed/mineral/volcanic/lava_land_surface,
/area/lavaland/surface/outdoors)
"Ks" = (
/obj/structure/stone_tile/slab/burnt,
/turf/closed/mineral/volcanic/lava_land_surface,
/area/lavaland/surface/outdoors)
"Lg" = (
/obj/structure/destructible/clockwork/trap/skewer,
/obj/structure/window/bronze/fulltile,
/obj/structure/trap/cult,
/turf/open/floor/bronze/filled/lavaland,
/area/lavaland/surface/outdoors)
"Ng" = (
/obj/structure/fluff/clockwork/alloy_shards,
/obj/structure/window/bronze/fulltile,
/obj/structure/girder/bronze,
/obj/item/wirecutters/brass,
/obj/item/stack/sheet/bronze,
/turf/open/floor/bronze/filled/lavaland,
/area/ruin/powered)
"Or" = (
/obj/structure/stone_tile/slab/cracked{
	dir = 6
	},
/turf/closed/mineral/volcanic/lava_land_surface,
/area/lavaland/surface/outdoors)
"OY" = (
/obj/structure/destructible/clockwork/trap/flipper,
/obj/structure/fluff/clockwork/blind_eye,
/turf/open/floor/bronze/filled/lavaland,
/area/ruin/powered)
"Qq" = (
/obj/structure/stone_tile/slab/cracked{
	dir = 6
	},
/obj/structure/fluff/clockwork/alloy_shards/small,
/turf/closed/wall/mineral/bronze,
/area/ruin/powered)
"RH" = (
/obj/structure/trap/cult,
/turf/open/floor/bronze/filled/lavaland,
/area/lavaland/surface/outdoors)
"SJ" = (
/obj/structure/stone_tile/surrounding_tile/cracked{
	dir = 5
	},
/turf/closed/mineral/strong{
	base_icon_state = "smoothrocks";
	icon = 'modular_nova/modules/liquids/icons/turf/smoothrocks.dmi';
	icon_state = "smoothrocks-55"
	},
/area/lavaland/surface/outdoors)
"Ut" = (
/obj/structure/stone_tile{
	dir = 1
	},
/obj/structure/fluff/clockwork/alloy_shards/medium_gearbit,
/turf/closed/wall/mineral/bronze,
/area/ruin/powered)
"Vf" = (
/obj/structure/window/bronze/fulltile,
/obj/structure/girder/bronze,
/obj/item/screwdriver/brass,
/obj/item/stack/sheet/bronze,
/turf/open/floor/bronze/filled/lavaland,
/area/ruin/powered)
"VE" = (
/obj/structure/stone_tile/slab/cracked{
	dir = 6
	},
/obj/item/stack/sheet/bronze,
/turf/closed/mineral/volcanic/lava_land_surface,
/area/lavaland/surface/outdoors)
"VI" = (
/obj/structure/window/bronze/fulltile,
/obj/item/stack/sheet/bronze,
/turf/open/floor/bronze/filled/lavaland,
/area/ruin/powered)
"Wa" = (
/obj/structure/stone_tile/surrounding/cracked{
	dir = 1
	},
/obj/structure/stone_tile/center/cracked,
/turf/closed/mineral/volcanic/lava_land_surface,
/area/lavaland/surface/outdoors)
"Wx" = (
/obj/structure/flora/rock/pile/style_random,
/obj/structure/stone_tile/surrounding_tile,
/turf/closed/mineral/volcanic/lava_land_surface,
/area/lavaland/surface/outdoors)
"WD" = (
/obj/structure/stone_tile/block/burnt{
	dir = 4
	},
/obj/structure/fluff/clockwork/alloy_shards/medium_gearbit{
	pixel_x = -12;
	pixel_y = -7
	},
/mob/living/basic/clockwork_marauder{
	speed = 0.7;
	light_color = "#FF7777";
	color = "#FF7777";
	name = "clockwork praetorian";
	light_power = 12;
	light_range = 2;
	lighting_cutoff_blue = 35;
	lighting_cutoff_green = 15;
	lighting_cutoff_red = 25;
	health = 420
	},
/turf/open/misc/asteroid/basalt/lava_land_surface,
/area/ruin/powered)
"WL" = (
/obj/structure/stone_tile/block/burnt,
/obj/structure/stone_tile/block/cracked{
	dir = 1
	},
/turf/closed/mineral/strong{
	base_icon_state = "smoothrocks";
	icon = 'modular_nova/modules/liquids/icons/turf/smoothrocks.dmi';
	icon_state = "smoothrocks-55"
	},
/area/lavaland/surface/outdoors)
"Xe" = (
/obj/structure/railing/stone/right,
/turf/closed/mineral/volcanic/lava_land_surface,
/area/lavaland/surface/outdoors)
"Ya" = (
/turf/closed/mineral/volcanic/lava_land_surface,
/area/lavaland/surface/outdoors)
"YG" = (
/obj/structure/window/bronze/fulltile,
/obj/structure/destructible/clockwork/trap/skewer,
/obj/item/wrench/brass,
/obj/structure/trap/cult,
/turf/open/floor/bronze/filled/lavaland,
/area/ruin/powered)
"YX" = (
/obj/structure/stone_tile/surrounding/cracked{
	dir = 1
	},
/obj/structure/stone_tile/center/cracked,
/turf/closed/mineral/strong{
	base_icon_state = "smoothrocks";
	icon = 'modular_nova/modules/liquids/icons/turf/smoothrocks.dmi';
	icon_state = "smoothrocks-55"
	},
/area/lavaland/surface/outdoors)
"ZC" = (
/obj/structure/stone_tile/surrounding/cracked{
	dir = 1
	},
/obj/structure/stone_tile/center/cracked,
/obj/structure/door_assembly/door_assembly_bronze,
/turf/open/misc/asteroid/basalt/lava_land_surface,
/area/ruin/powered)
"ZK" = (
/obj/structure/fluff/clockwork/alloy_shards/large,
/obj/structure/window/bronze/fulltile,
/obj/structure/girder/bronze,
/obj/item/weldingtool/experimental/brass,
/obj/item/stack/sheet/bronze,
/turf/open/floor/bronze/filled/lavaland,
/area/ruin/powered)

(1,1,1) = {"
Cx
ds
Cx
Cx
JI
kD
fI
Bj
JI
Cx
Cx
Cx
"}
(2,1,1) = {"
Cx
Cx
Cx
gZ
Ah
Kj
jO
Ks
BA
BQ
Cx
Cx
"}
(3,1,1) = {"
Cx
Cx
aT
tT
HY
mn
xR
JU
xr
zl
ds
Cx
"}
(4,1,1) = {"
BF
xr
Bj
Wx
Ya
SJ
YX
RH
VE
CU
ds
Cx
"}
(5,1,1) = {"
DJ
Bj
Ks
yz
ds
VI
aD
dN
GZ
xR
yz
GO
"}
(6,1,1) = {"
De
JI
mk
Jg
im
AH
ZC
Fd
dN
HX
Cm
oX
"}
(7,1,1) = {"
eX
Or
ep
zN
jG
ok
cy
Kd
kN
HX
GZ
xQ
"}
(8,1,1) = {"
pQ
cw
WL
Lg
FZ
vv
OY
tw
iX
xo
ds
si
"}
(9,1,1) = {"
DJ
Ya
ep
Hb
uR
af
WD
Dy
tD
HX
ds
aT
"}
(10,1,1) = {"
DJ
yi
zE
xR
FX
Ut
ji
Qq
uR
YG
ds
eL
"}
(11,1,1) = {"
DV
cw
EK
Ac
GZ
Vf
lj
ZK
ds
ds
ds
aT
"}
(12,1,1) = {"
Xe
Ya
Bj
CX
ds
sp
Ng
wJ
ds
bj
mf
Cx
"}
(13,1,1) = {"
ds
yi
CY
xR
ds
ds
ds
ds
ds
xR
el
Cx
"}
(14,1,1) = {"
Cx
vt
jL
ds
bj
xR
xR
CX
ds
xR
ds
Cx
"}
(15,1,1) = {"
Cx
yz
ds
ds
CY
Ya
RH
Ya
ds
Ya
Cx
Cx
"}
(16,1,1) = {"
Cx
Cx
GZ
Cx
Wa
hr
Ya
yO
Cx
Cx
Cx
Cx
"}
