//MAP CONVERTED BY dmm2tgm.py THIS HEADER COMMENT PREVENTS RECONVERSION, DO NOT REMOVE
"a" = (
/turf/template_noop,
/area/template_noop)
"f" = (
/obj/structure/lattice,
/obj/structure/fluff/clockwork/alloy_shards,
/obj/effect/spawner/random/environmentally_safe_anomaly,
/turf/open/misc/asteroid/basalt/lava_land_surface,
/area/lavaland/surface/outdoors)
"g" = (
/obj/structure/fluff/clockwork/alloy_shards/small,
/obj/structure/trap/cult,
/turf/open/floor/bronze/filled/lavaland,
/area/ruin/unpowered/ratvar)
"j" = (
/obj/structure/fluff/clockwork/clockgolem_remains,
/obj/structure/grille/broken,
/obj/structure/trap/cult,
/turf/open/floor/bronze/filled/lavaland,
/area/ruin/unpowered/ratvar)
"l" = (
/obj/structure/girder/bronze,
/turf/open/floor/bronze/filled/lavaland,
/area/ruin/unpowered/ratvar)
"o" = (
/obj/structure/fluff/clockwork/alloy_shards,
/turf/open/floor/bronze/filled/lavaland,
/area/ruin/unpowered/ratvar)
"t" = (
/obj/structure/fluff/clockwork/alloy_shards/medium_gearbit{
	pixel_x = -12;
	pixel_y = -7
	},
/obj/structure/fluff/clockwork/alloy_shards/small,
/obj/structure/door_assembly/door_assembly_bronze,
/turf/open/floor/bronze/filled/lavaland,
/area/ruin/unpowered/ratvar)
"v" = (
/obj/structure/girder/bronze,
/obj/structure/fluff/clockwork/alloy_shards/large,
/obj/structure/trap/cult,
/turf/open/floor/bronze/filled/lavaland,
/area/ruin/unpowered/ratvar)
"x" = (
/obj/item/xenoarch/useless_relic{
	name = "Ancient relic";
	desc = "Sort of relic that can be exported through Cargo."
	},
/turf/closed/mineral/volcanic/lava_land_surface,
/area/lavaland/surface/outdoors)
"y" = (
/obj/structure/grille,
/turf/open/floor/bronze/filled/lavaland,
/area/ruin/unpowered/ratvar)
"C" = (
/obj/structure/fluff/clockwork/alloy_shards/small,
/obj/structure/grille/broken,
/obj/structure/fluff/clockwork/blind_eye,
/obj/effect/spawner/random/environmentally_safe_anomaly,
/turf/open/floor/bronze/filled/lavaland,
/area/ruin/unpowered/ratvar)
"G" = (
/obj/structure/fluff/clockwork/alloy_shards/medium{
	pixel_x = -7;
	pixel_y = 7
	},
/obj/structure/fluff/clockwork/alloy_shards/large,
/turf/open/floor/bronze/filled/lavaland,
/area/ruin/unpowered/ratvar)
"H" = (
/turf/closed/mineral/volcanic/lava_land_surface,
/area/lavaland/surface/outdoors)
"I" = (
/obj/structure/fluff/clockwork/alloy_shards/medium{
	pixel_x = -7;
	pixel_y = 7
	},
/obj/structure/door_assembly/door_assembly_bronze,
/obj/structure/trap/cult,
/turf/open/floor/bronze/filled/lavaland,
/area/ruin/unpowered/ratvar)
"J" = (
/turf/closed/mineral/random/high_chance/volcanic,
/area/lavaland/surface/outdoors)
"K" = (
/obj/structure/fluff/clockwork/clockgolem_remains,
/turf/open/floor/bronze/filled/lavaland,
/area/ruin/unpowered/ratvar)
"L" = (
/turf/closed/wall/mineral/bronze,
/area/ruin/unpowered/ratvar)
"P" = (
/obj/structure/fluff/clockwork/alloy_shards/medium_gearbit{
	pixel_x = -12;
	pixel_y = -7
	},
/obj/item/stock_parts/cell/crystal_cell,
/obj/effect/spawner/random/environmentally_safe_anomaly/immobile,
/obj/structure/window/bronze/fulltile,
/obj/item/gun/ballistic/bow/clockwork,
/obj/item/weldingtool/experimental/brass,
/obj/item/xenoarch/broken_item/tech,
/turf/open/floor/bronze/filled/lavaland,
/area/ruin/unpowered/ratvar)
"Q" = (
/obj/item/stack/sheet/bronze,
/turf/closed/wall/mineral/bronze,
/area/ruin/unpowered/ratvar)
"W" = (
/obj/structure/fluff/clockwork/alloy_shards/medium{
	pixel_x = -7;
	pixel_y = 7
	},
/obj/item/stock_parts/cell/crystal_cell,
/obj/item/stack/sheet/bronze/thirty,
/obj/structure/window/bronze/fulltile,
/turf/open/floor/bronze/filled/lavaland,
/area/ruin/unpowered/ratvar)

(1,1,1) = {"
a
C
J
a
a
"}
(2,1,1) = {"
a
K
J
o
a
"}
(3,1,1) = {"
H
l
I
L
x
"}
(4,1,1) = {"
J
L
P
Q
H
"}
(5,1,1) = {"
a
L
y
g
J
"}
(6,1,1) = {"
x
J
v
J
J
"}
(7,1,1) = {"
H
W
L
l
H
"}
(8,1,1) = {"
J
L
L
K
f
"}
(9,1,1) = {"
H
H
l
G
H
"}
(10,1,1) = {"
a
j
t
J
x
"}
(11,1,1) = {"
a
L
J
H
a
"}
(12,1,1) = {"
a
f
H
a
a
"}
