//MAP CONVERTED BY dmm2tgm.py THIS HEADER COMMENT PREVENTS RECONVERSION, DO NOT REMOVE
"a" = (
/obj/structure/stone_tile/cracked{
	dir = 4
	},
/turf/closed/mineral/volcanic/lava_land_surface,
/area/lavaland/surface/outdoors)
"b" = (
/obj/structure/punji_sticks/spikes,
/turf/closed/mineral/volcanic/lava_land_surface,
/area/lavaland/surface/outdoors)
"c" = (
/obj/structure/stone_tile{
	dir = 1
	},
/turf/closed/mineral/volcanic/lava_land_surface,
/area/lavaland/surface/outdoors)
"d" = (
/obj/structure/railing/stone{
	layer = -6
	},
/turf/closed/mineral/volcanic/lava_land_surface,
/area/lavaland/surface/outdoors)
"e" = (
/obj/structure/stone_tile/slab/burnt,
/mob/living/basic/mining/brimdemon,
/turf/closed/mineral/volcanic/lava_land_surface,
/area/lavaland/surface/outdoors)
"f" = (
/obj/structure/railing/stone/left{
	layer = -6
	},
/turf/closed/mineral/volcanic/lava_land_surface,
/area/lavaland/surface/outdoors)
"g" = (
/turf/closed/indestructible/riveted/boss,
/area/lavaland/surface/outdoors)
"h" = (
/obj/structure/stone_tile/slab/cracked{
	dir = 4
	},
/obj/structure/stone_tile/slab/cracked{
	dir = 8
	},
/obj/item/goliath_saddle,
/turf/closed/mineral/volcanic/lava_land_surface,
/area/lavaland/surface/outdoors)
"i" = (
/obj/structure/stone_tile/block,
/obj/structure/stone_tile/block/cracked{
	dir = 1
	},
/turf/closed/mineral/volcanic/lava_land_surface,
/area/lavaland/surface/outdoors)
"j" = (
/obj/structure/stone_tile/surrounding/cracked,
/turf/closed/mineral/volcanic/lava_land_surface,
/area/lavaland/surface/outdoors)
"k" = (
/obj/structure/stone_tile/center/burnt,
/turf/closed/mineral/volcanic/lava_land_surface,
/area/lavaland/surface/outdoors)
"l" = (
/obj/structure/stone_tile/block/burnt{
	dir = 1
	},
/turf/closed/mineral/volcanic/lava_land_surface,
/area/lavaland/surface/outdoors)
"m" = (
/obj/structure/stone_tile/center/cracked,
/turf/closed/mineral/volcanic/lava_land_surface,
/area/lavaland/surface/outdoors)
"n" = (
/obj/structure/stone_tile/surrounding_tile/burnt{
	dir = 1
	},
/obj/structure/railing/stone/left{
	layer = -6
	},
/turf/closed/mineral/volcanic/lava_land_surface,
/area/lavaland/surface/outdoors)
"o" = (
/obj/structure/flora/rock/style_random,
/turf/closed/mineral/volcanic/lava_land_surface,
/area/lavaland/surface/outdoors)
"q" = (
/obj/structure/stone_tile/block/burnt{
	dir = 1
	},
/obj/structure/stone_tile/block,
/turf/closed/mineral/volcanic/lava_land_surface,
/area/lavaland/surface/outdoors)
"r" = (
/obj/structure/stone_tile/block{
	dir = 8
	},
/turf/closed/mineral/volcanic/lava_land_surface,
/area/lavaland/surface/outdoors)
"s" = (
/obj/structure/stone_tile/surrounding_tile/cracked{
	dir = 4
	},
/obj/structure/stone_tile/surrounding_tile/burnt,
/turf/closed/mineral/volcanic/lava_land_surface,
/area/lavaland/surface/outdoors)
"t" = (
/obj/structure/stone_tile,
/obj/structure/stone_tile{
	dir = 1
	},
/obj/structure/stone_tile/burnt{
	dir = 4
	},
/turf/closed/mineral/volcanic/lava_land_surface,
/area/lavaland/surface/outdoors)
"x" = (
/obj/structure/stone_tile/surrounding_tile/cracked{
	dir = 1
	},
/turf/closed/mineral/volcanic/lava_land_surface,
/area/lavaland/surface/outdoors)
"y" = (
/obj/structure/stone_tile/surrounding_tile{
	dir = 8
	},
/turf/closed/mineral/volcanic/lava_land_surface,
/area/lavaland/surface/outdoors)
"z" = (
/turf/template_noop,
/area/template_noop)
"A" = (
/obj/structure/stone_tile/surrounding_tile/burnt{
	dir = 1
	},
/turf/closed/mineral/volcanic/lava_land_surface,
/area/lavaland/surface/outdoors)
"B" = (
/obj/structure/stone_tile/slab/cracked{
	dir = 8
	},
/obj/structure/stone_tile/slab/cracked{
	dir = 4
	},
/turf/closed/mineral/volcanic/lava_land_surface,
/area/lavaland/surface/outdoors)
"C" = (
/obj/structure/stone_tile/slab/cracked{
	dir = 6
	},
/mob/living/basic/mining/wolf{
	desc = "A baby goliath. Do it. Stomp it.";
	faction = list("mining","boss","hell");
	name = "Biter";
	attack_sound = 'sound/effects/wounds/crackandbleed.ogg';
	attack_verb_continuous = "maniacally tears";
	attack_verb_simple = "tears";
	attack_vis_effect = "slash";
	bare_wound_bonus = 5;
	butcher_results = list(/obj/item/food/meat/slab/goliath = 1);
	can_tame = 0;
	health = 35;
	icon = 'icons/mob/simple/lavaland/lavaland_monsters.dmi';
	icon_dead = "goliath_baby_dead";
	icon_living = "goliath_baby";
	icon_state = "goliath_baby";
	maxHealth = 35;
	melee_damage_lower = 1;
	melee_attack_cooldown = 5;
	speed = 0.2;
	wound_bonus = -1;
	icon_gib = "syndicate_gib";
	melee_damage_upper = 2;
	damage_coeff = list("brute" = 1, "burn" = 1, "toxin" = 1, "stamina" = 1, "oxygen" = 1)
	},
/turf/closed/mineral/volcanic/lava_land_surface,
/area/lavaland/surface/outdoors)
"D" = (
/obj/structure/stone_tile/surrounding_tile,
/turf/closed/mineral/volcanic/lava_land_surface,
/area/lavaland/surface/outdoors)
"E" = (
/obj/structure/stone_tile/slab/cracked{
	dir = 4
	},
/obj/structure/stone_tile/slab/cracked{
	dir = 8
	},
/turf/closed/mineral/volcanic/lava_land_surface,
/area/lavaland/surface/outdoors)
"G" = (
/obj/structure/stone_tile/surrounding/cracked{
	dir = 1
	},
/turf/closed/mineral/volcanic/lava_land_surface,
/area/lavaland/surface/outdoors)
"H" = (
/obj/structure/railing/stone/right{
	layer = -6
	},
/obj/structure/stone_tile/surrounding/burnt,
/obj/structure/stone_tile/center/burnt,
/turf/closed/mineral/volcanic/lava_land_surface,
/area/lavaland/surface/outdoors)
"I" = (
/turf/closed/mineral/volcanic/lava_land_surface,
/area/lavaland/surface/outdoors)
"J" = (
/obj/structure/flora/rock/pile/style_random,
/mob/living/basic/mining/wolf{
	desc = "A baby goliath. Do it. Stomp it.";
	faction = list("mining","boss","hell");
	name = "Biter";
	attack_sound = 'sound/effects/wounds/crackandbleed.ogg';
	attack_verb_continuous = "maniacally tears";
	attack_verb_simple = "tears";
	attack_vis_effect = "slash";
	bare_wound_bonus = 5;
	butcher_results = list(/obj/item/food/meat/slab/goliath = 1);
	can_tame = 0;
	health = 35;
	icon = 'icons/mob/simple/lavaland/lavaland_monsters.dmi';
	icon_dead = "goliath_baby_dead";
	icon_living = "goliath_baby";
	icon_state = "goliath_baby";
	maxHealth = 35;
	melee_damage_lower = 1;
	melee_attack_cooldown = 5;
	speed = 0.2;
	wound_bonus = -1;
	icon_gib = "syndicate_gib";
	melee_damage_upper = 2;
	damage_coeff = list("brute" = 1, "burn" = 1, "toxin" = 1, "stamina" = 1, "oxygen" = 1)
	},
/turf/closed/mineral/volcanic/lava_land_surface,
/area/lavaland/surface/outdoors)
"K" = (
/obj/structure/stone_tile,
/obj/item/xenoarch/useless_relic/magnified{
	name = "Ancient relic";
	desc = "Sort of relic that can be exported through Cargo."
	},
/turf/closed/mineral/volcanic/lava_land_surface,
/area/lavaland/surface/outdoors)
"L" = (
/obj/structure/stone_tile/slab/burnt,
/turf/closed/mineral/volcanic/lava_land_surface,
/area/lavaland/surface/outdoors)
"M" = (
/obj/structure/stone_tile,
/obj/structure/punji_sticks/spikes,
/turf/closed/mineral/volcanic/lava_land_surface,
/area/lavaland/surface/outdoors)
"N" = (
/obj/structure/stone_tile/block{
	dir = 8
	},
/obj/structure/stone_tile/block{
	dir = 4
	},
/turf/closed/mineral/volcanic/lava_land_surface,
/area/lavaland/surface/outdoors)
"O" = (
/obj/structure/stone_tile/slab/cracked,
/turf/closed/mineral/volcanic/lava_land_surface,
/area/lavaland/surface/outdoors)
"P" = (
/obj/structure/stone_tile/surrounding/cracked{
	dir = 8
	},
/mob/living/basic/mining/wolf{
	desc = "A baby goliath. Do it. Stomp it.";
	faction = list("mining","boss","hell");
	name = "Biter";
	attack_sound = 'sound/effects/wounds/crackandbleed.ogg';
	attack_verb_continuous = "maniacally tears";
	attack_verb_simple = "tears";
	attack_vis_effect = "slash";
	bare_wound_bonus = 5;
	butcher_results = list(/obj/item/food/meat/slab/goliath = 1);
	can_tame = 0;
	health = 35;
	icon = 'icons/mob/simple/lavaland/lavaland_monsters.dmi';
	icon_dead = "goliath_baby_dead";
	icon_living = "goliath_baby";
	icon_state = "goliath_baby";
	maxHealth = 35;
	melee_damage_lower = 1;
	melee_attack_cooldown = 5;
	speed = 0.2;
	wound_bonus = -1;
	icon_gib = "syndicate_gib";
	melee_damage_upper = 2;
	damage_coeff = list("brute" = 1, "burn" = 1, "toxin" = 1, "stamina" = 1, "oxygen" = 1)
	},
/turf/closed/mineral/volcanic/lava_land_surface,
/area/lavaland/surface/outdoors)
"Q" = (
/obj/structure/stone_tile/burnt,
/obj/structure/trap/fire{
	name = "Anctient runic spikes";
	desc = "A strange carving of some symbols. What's that for?";
	alpha = 180;
	icon = 'icons/obj/service/hydroponics/equipment.dmi';
	icon_state = "woodspike";
	light_color = "#FF1111";
	color = "#FF1111"
	},
/obj/item/xenoarch/useless_relic{
	name = "Ancient relic";
	desc = "Sort of relic that can be exported through Cargo."
	},
/turf/closed/mineral/volcanic/lava_land_surface,
/area/lavaland/surface/outdoors)
"R" = (
/obj/structure/stone_tile/burnt,
/obj/structure/stone_tile/burnt{
	dir = 1
	},
/obj/structure/stone_tile/cracked{
	dir = 4
	},
/turf/closed/mineral/volcanic/lava_land_surface,
/area/lavaland/surface/outdoors)
"S" = (
/obj/structure/stone_tile,
/obj/structure/trap/fire{
	name = "Anctient runic spikes";
	desc = "A strange carving of some symbols. What's that for?";
	alpha = 180;
	icon = 'icons/obj/service/hydroponics/equipment.dmi';
	icon_state = "woodspike";
	light_color = "#FF1111";
	color = "#FF1111"
	},
/turf/closed/mineral/volcanic/lava_land_surface,
/area/lavaland/surface/outdoors)
"T" = (
/obj/structure/stone_tile,
/turf/closed/mineral/volcanic/lava_land_surface,
/area/lavaland/surface/outdoors)
"U" = (
/obj/structure/stone_tile/block/burnt{
	dir = 4
	},
/turf/closed/mineral/volcanic/lava_land_surface,
/area/lavaland/surface/outdoors)
"V" = (
/obj/structure/stone_tile/block{
	dir = 8
	},
/obj/item/xenoarch/useless_relic{
	name = "Ancient relic";
	desc = "Sort of relic that can be exported through Cargo."
	},
/turf/closed/mineral/volcanic/lava_land_surface,
/area/lavaland/surface/outdoors)
"W" = (
/obj/structure/stone_tile/surrounding_tile/cracked,
/turf/closed/mineral/volcanic/lava_land_surface,
/area/lavaland/surface/outdoors)
"X" = (
/obj/structure/stone_tile/surrounding_tile/burnt{
	dir = 8
	},
/turf/closed/mineral/volcanic/lava_land_surface,
/area/lavaland/surface/outdoors)
"Y" = (
/obj/structure/railing/stone{
	layer = -6
	},
/obj/item/xenoarch/useless_relic{
	name = "Ancient relic";
	desc = "Sort of relic that can be exported through Cargo."
	},
/turf/closed/mineral/volcanic/lava_land_surface,
/area/lavaland/surface/outdoors)
"Z" = (
/obj/structure/stone_tile,
/obj/structure/stone_tile{
	dir = 8
	},
/obj/structure/stone_tile{
	dir = 1
	},
/obj/structure/railing/stone/right{
	layer = -6
	},
/turf/closed/mineral/volcanic/lava_land_surface,
/area/lavaland/surface/outdoors)

(1,1,1) = {"
z
z
z
z
z
c
O
y
z
z
z
z
"}
(2,1,1) = {"
n
g
z
g
o
N
V
z
z
z
g
z
"}
(3,1,1) = {"
Y
m
z
O
l
s
I
z
z
O
g
z
"}
(4,1,1) = {"
H
L
t
e
X
z
W
z
z
g
g
z
"}
(5,1,1) = {"
P
G
U
r
b
z
z
z
z
g
K
T
"}
(6,1,1) = {"
f
x
B
L
D
z
z
g
z
S
a
y
"}
(7,1,1) = {"
d
a
A
R
z
z
z
g
z
z
z
C
"}
(8,1,1) = {"
Z
I
q
T
z
z
z
g
z
h
z
z
"}
(9,1,1) = {"
z
g
J
j
k
z
z
g
z
g
z
z
"}
(10,1,1) = {"
z
g
I
L
O
X
z
g
z
g
g
z
"}
(11,1,1) = {"
z
g
g
M
i
Q
g
g
z
z
g
z
"}
(12,1,1) = {"
z
z
g
E
z
z
g
z
z
z
z
z
"}
