//MAP CONVERTED BY dmm2tgm.py THIS HEADER COMMENT PREVENTS RECONVERSION, DO NOT REMOVE
"a" = (
/obj/item/flashlight/flare/torch{
	start_on = 1
	},
/obj/item/kheiral_cuffs,
/turf/closed/indestructible/riveted/boss,
/area/lavaland/surface/outdoors)

(1,1,1) = {"
a
"}
