//MAP CONVERTED BY dmm2tgm.py THIS HEADER COMMENT PREVENTS RECONVERSION, DO NOT REMOVE
"aB" = (
/turf/template_noop,
/area/template_noop)
"be" = (
/obj/structure/stone_tile{
	dir = 8
	},
/obj/structure/stone_tile/burnt,
/obj/structure/stone_tile/cracked{
	dir = 4
	},
/turf/closed/mineral/volcanic/lava_land_surface,
/area/lavaland/surface/outdoors)
"bI" = (
/obj/structure/wall_torch/mount_only,
/turf/closed/indestructible/riveted/boss,
/area/lavaland/surface/outdoors)
"bW" = (
/obj/structure/stone_tile/slab/cracked{
	dir = 6
	},
/turf/closed/mineral/volcanic/lava_land_surface,
/area/lavaland/surface/outdoors)
"dC" = (
/obj/structure/stone_tile{
	dir = 1
	},
/turf/closed/mineral/volcanic/lava_land_surface,
/area/lavaland/surface/outdoors)
"fr" = (
/obj/structure/stone_tile/slab,
/obj/effect/spawner/random/mob/necropolis_mob,
/turf/closed/mineral/volcanic/lava_land_surface,
/area/lavaland/surface/outdoors)
"fx" = (
/obj/structure/flora/rock/style_random,
/turf/closed/mineral/volcanic/lava_land_surface,
/area/lavaland/surface/outdoors)
"fQ" = (
/obj/structure/flora/rock/pile/style_random,
/turf/open/misc/asteroid/basalt/lava_land_surface,
/area/lavaland/surface/outdoors)
"fX" = (
/obj/structure/stone_tile/surrounding_tile,
/turf/open/misc/asteroid/basalt/lava_land_surface,
/area/lavaland/surface/outdoors)
"fY" = (
/obj/structure/stone_tile/slab/cracked{
	dir = 6
	},
/obj/effect/spawner/random/mob/necropolis_mob,
/turf/closed/mineral/volcanic/lava_land_surface,
/area/lavaland/surface/outdoors)
"gO" = (
/obj/structure/stone_tile/surrounding_tile/burnt{
	dir = 4
	},
/turf/closed/mineral/volcanic/lava_land_surface,
/area/lavaland/surface/outdoors)
"lK" = (
/obj/structure/stone_tile/block,
/obj/structure/stone_tile/block/cracked{
	dir = 1
	},
/turf/open/misc/asteroid/basalt/lava_land_surface,
/area/lavaland/surface/outdoors)
"md" = (
/obj/item/xenoarch/useless_relic{
	name = "Ancient relic";
	desc = "Sort of relic that can be exported through Cargo."
	},
/turf/closed/mineral/volcanic/lava_land_surface,
/area/lavaland/surface/outdoors)
"nj" = (
/obj/structure/stone_tile/block/cracked{
	dir = 8
	},
/turf/open/misc/asteroid/basalt/lava_land_surface,
/area/lavaland/surface/outdoors)
"nT" = (
/obj/structure/stone_tile/slab,
/obj/item/reagent_containers/cup/bowl/wood_bowl{
	pixel_x = -6;
	pixel_y = -5
	},
/turf/closed/mineral/volcanic/lava_land_surface,
/area/lavaland/surface/outdoors)
"ob" = (
/obj/structure/stone_tile/surrounding_tile/cracked{
	dir = 4
	},
/turf/closed/mineral/volcanic/lava_land_surface,
/area/lavaland/surface/outdoors)
"oc" = (
/obj/structure/stone_tile/surrounding_tile{
	dir = 1
	},
/turf/open/misc/asteroid/basalt/lava_land_surface,
/area/lavaland/surface/outdoors)
"oo" = (
/obj/structure/stone_tile{
	dir = 8
	},
/obj/effect/spawner/random/structure/spikes,
/turf/closed/mineral/volcanic/lava_land_surface,
/area/lavaland/surface/outdoors)
"oJ" = (
/obj/structure/stone_tile/block{
	dir = 8
	},
/obj/structure/stone_tile/block/burnt{
	dir = 4
	},
/turf/closed/mineral/volcanic/lava_land_surface,
/area/lavaland/surface/outdoors)
"rj" = (
/obj/structure/stone_tile/block/burnt{
	dir = 4
	},
/turf/closed/mineral/volcanic/lava_land_surface,
/area/lavaland/surface/outdoors)
"tt" = (
/obj/structure/stone_tile/block/cracked{
	dir = 4
	},
/turf/closed/mineral/volcanic/lava_land_surface,
/area/lavaland/surface/outdoors)
"ty" = (
/obj/structure/stone_tile/block,
/turf/closed/mineral/volcanic/lava_land_surface,
/area/lavaland/surface/outdoors)
"tF" = (
/obj/item/xenoarch/useless_relic/magnified{
	name = "Ancient relic";
	desc = "Sort of relic that can be exported through Cargo."
	},
/turf/closed/mineral/volcanic/lava_land_surface,
/area/lavaland/surface/outdoors)
"vu" = (
/turf/closed/indestructible/riveted/boss,
/area/lavaland/surface/outdoors)
"zv" = (
/obj/structure/stone_tile/slab/burnt,
/turf/open/misc/asteroid/basalt/lava_land_surface,
/area/lavaland/surface/outdoors)
"Cm" = (
/obj/structure/stone_tile{
	dir = 4
	},
/obj/structure/stone_tile/burnt,
/turf/closed/mineral/volcanic/lava_land_surface,
/area/lavaland/surface/outdoors)
"Cq" = (
/obj/effect/spawner/random/structure/orevein_longregen,
/turf/closed/mineral/volcanic/lava_land_surface,
/area/lavaland/surface/outdoors)
"Dd" = (
/obj/structure/stone_tile{
	dir = 8
	},
/turf/closed/mineral/volcanic/lava_land_surface,
/area/lavaland/surface/outdoors)
"Fk" = (
/obj/structure/stone_tile/slab/cracked{
	dir = 6
	},
/obj/item/xenoarch/useless_relic{
	name = "Ancient relic";
	desc = "Sort of relic that can be exported through Cargo."
	},
/turf/closed/mineral/volcanic/lava_land_surface,
/area/lavaland/surface/outdoors)
"GZ" = (
/obj/structure/stone_tile/surrounding_tile{
	dir = 1
	},
/obj/structure/stone_tile/center/burnt,
/mob/living/basic/mining/goliath/gigachonk,
/turf/open/misc/asteroid/basalt/lava_land_surface,
/area/lavaland/surface/outdoors)
"Hz" = (
/obj/effect/spawner/random/structure/spikes,
/turf/closed/mineral/volcanic/lava_land_surface,
/area/lavaland/surface/outdoors)
"IT" = (
/obj/structure/stone_tile/surrounding_tile/cracked{
	dir = 1
	},
/turf/open/misc/asteroid/basalt/lava_land_surface,
/area/lavaland/surface/outdoors)
"Jn" = (
/obj/structure/stone_tile/slab,
/turf/open/misc/asteroid/basalt/lava_land_surface,
/area/lavaland/surface/outdoors)
"JQ" = (
/obj/structure/stone_tile,
/turf/closed/mineral/volcanic/lava_land_surface,
/area/lavaland/surface/outdoors)
"KB" = (
/obj/structure/stone_tile/slab/burnt,
/obj/item/xenoarch/useless_relic{
	name = "Ancient relic";
	desc = "Sort of relic that can be exported through Cargo."
	},
/turf/closed/mineral/volcanic/lava_land_surface,
/area/lavaland/surface/outdoors)
"Ms" = (
/obj/structure/stone_tile/surrounding/cracked{
	dir = 1
	},
/turf/closed/mineral/volcanic/lava_land_surface,
/area/lavaland/surface/outdoors)
"My" = (
/obj/structure/stone_tile/block{
	dir = 1
	},
/turf/closed/mineral/volcanic/lava_land_surface,
/area/lavaland/surface/outdoors)
"Nx" = (
/obj/structure/stone_tile/surrounding/cracked,
/turf/closed/mineral/volcanic/lava_land_surface,
/area/lavaland/surface/outdoors)
"OM" = (
/obj/structure/stone_tile/surrounding/burnt,
/obj/structure/stone_tile/center/burnt,
/turf/closed/mineral/volcanic/lava_land_surface,
/area/lavaland/surface/outdoors)
"Pu" = (
/obj/structure/stone_tile/burnt,
/obj/effect/spawner/random/structure/spikes,
/turf/closed/mineral/volcanic/lava_land_surface,
/area/lavaland/surface/outdoors)
"PF" = (
/obj/effect/mapping_helpers/bombable_wall,
/turf/closed/indestructible/riveted/boss/wasteland,
/area/lavaland/surface/outdoors)
"Qy" = (
/obj/structure/stone_tile/slab,
/turf/closed/mineral/volcanic/lava_land_surface,
/area/lavaland/surface/outdoors)
"RM" = (
/obj/structure/stone_tile/block/burnt,
/turf/open/misc/asteroid/basalt/lava_land_surface,
/area/lavaland/surface/outdoors)
"Sf" = (
/obj/structure/stone_tile{
	dir = 1
	},
/obj/structure/stone_tile/burnt,
/turf/closed/mineral/volcanic/lava_land_surface,
/area/lavaland/surface/outdoors)
"TJ" = (
/obj/structure/stone_tile/surrounding_tile,
/turf/closed/mineral/volcanic/lava_land_surface,
/area/lavaland/surface/outdoors)
"VH" = (
/obj/structure/flora/rock/pile/style_random,
/turf/closed/mineral/volcanic/lava_land_surface,
/area/lavaland/surface/outdoors)
"WO" = (
/obj/structure/stone_tile{
	dir = 4
	},
/turf/closed/mineral/volcanic/lava_land_surface,
/area/lavaland/surface/outdoors)
"Xc" = (
/obj/structure/stone_tile/surrounding/cracked{
	dir = 6
	},
/turf/open/misc/asteroid/basalt/lava_land_surface,
/area/lavaland/surface/outdoors)
"XA" = (
/obj/structure/stone_tile/block{
	dir = 4
	},
/obj/structure/stone_tile/block/burnt{
	dir = 8
	},
/turf/closed/mineral/volcanic/lava_land_surface,
/area/lavaland/surface/outdoors)
"YA" = (
/obj/structure/stone_tile/slab/cracked,
/turf/closed/mineral/volcanic/lava_land_surface,
/area/lavaland/surface/outdoors)
"YO" = (
/obj/structure/stone_tile,
/obj/structure/stone_tile{
	dir = 4
	},
/turf/closed/mineral/volcanic/lava_land_surface,
/area/lavaland/surface/outdoors)
"ZB" = (
/obj/structure/stone_tile/surrounding_tile{
	dir = 4
	},
/obj/structure/stone_tile/surrounding_tile,
/obj/structure/stone_tile/center/burnt,
/obj/item/kitchen/fork{
	pixel_x = 9;
	pixel_y = -1
	},
/turf/closed/mineral/volcanic/lava_land_surface,
/area/lavaland/surface/outdoors)
"ZH" = (
/turf/closed/mineral/volcanic/lava_land_surface,
/area/lavaland/surface/outdoors)
"ZJ" = (
/obj/structure/stone_tile/surrounding/cracked{
	dir = 6
	},
/obj/structure/stone_tile/center/cracked,
/turf/closed/mineral/volcanic/lava_land_surface,
/area/lavaland/surface/outdoors)

(1,1,1) = {"
aB
PF
aB
Fk
My
Pu
tt
YA
Nx
fr
aB
aB
"}
(2,1,1) = {"
aB
Dd
Cm
JQ
ty
bW
XA
fr
ZJ
YA
tt
aB
"}
(3,1,1) = {"
aB
ob
fY
VH
bI
vu
PF
ZH
vu
vu
vu
aB
"}
(4,1,1) = {"
gO
OM
tt
rj
fx
ZH
aB
aB
Hz
md
vu
PF
"}
(5,1,1) = {"
fQ
lK
fX
aB
aB
aB
aB
aB
aB
Cq
tF
PF
"}
(6,1,1) = {"
Jn
RM
GZ
ZB
aB
aB
aB
aB
aB
aB
Hz
ZH
"}
(7,1,1) = {"
IT
Xc
nj
oJ
Ms
aB
aB
aB
aB
aB
aB
aB
"}
(8,1,1) = {"
VH
oc
zv
aB
TJ
VH
aB
aB
nT
aB
aB
aB
"}
(9,1,1) = {"
Dd
bI
be
oo
dC
aB
aB
WO
Hz
aB
aB
aB
"}
(10,1,1) = {"
aB
JQ
Qy
KB
PF
aB
aB
aB
aB
aB
aB
aB
"}
(11,1,1) = {"
aB
aB
Nx
OM
vu
vu
aB
aB
tt
oo
aB
aB
"}
(12,1,1) = {"
aB
aB
fY
aB
aB
PF
Fk
ZH
Sf
YO
aB
aB
"}
