//MAP CONVERTED BY dmm2tgm.py THIS HEADER COMMENT PREVENTS RECONVERSION, DO NOT REMOVE
"a" = (
/turf/open/water/hot_spring{
	initial_gas_mix = "LAVALAND_ATMOS"
	},
/area/ruin/unpowered)
"b" = (
/obj/structure/stone_tile,
/obj/structure/stone_tile{
	dir = 1
	},
/obj/structure/stone_tile/cracked{
	dir = 8
	},
/turf/open/misc/asteroid/basalt/lava_land_surface,
/area/ruin/unpowered)
"c" = (
/obj/structure/stone_tile/surrounding_tile/burnt{
	dir = 4
	},
/turf/closed/mineral/volcanic/lava_land_surface,
/area/lavaland/surface/outdoors)
"d" = (
/turf/closed/mineral/volcanic/lava_land_surface,
/area/lavaland/surface/outdoors)
"e" = (
/obj/structure/stone_tile/slab/burnt,
/turf/open/lava/smooth/lava_land_surface,
/area/ruin/unpowered)
"f" = (
/obj/structure/stone_tile/surrounding_tile/cracked{
	dir = 9
	},
/obj/structure/stone_tile/surrounding_tile/cracked{
	dir = 5
	},
/turf/closed/mineral/volcanic/lava_land_surface,
/area/lavaland/surface/outdoors)
"g" = (
/obj/structure/stone_tile/burnt,
/obj/structure/stone_tile/cracked{
	dir = 4
	},
/obj/structure/stone_tile{
	dir = 1
	},
/turf/closed/mineral/volcanic/lava_land_surface,
/area/lavaland/surface/outdoors)
"h" = (
/obj/structure/stone_tile/block/cracked{
	dir = 1
	},
/turf/closed/mineral/volcanic/lava_land_surface,
/area/lavaland/surface/outdoors)
"i" = (
/obj/structure/stone_tile/block{
	dir = 8
	},
/obj/item/ceramic/bowl,
/obj/item/food/grown/bluecherries{
	pixel_y = 10
	},
/turf/open/misc/asteroid/basalt/lava_land_surface,
/area/ruin/unpowered)
"k" = (
/obj/structure/stone_tile/block{
	dir = 1
	},
/obj/structure/stone_tile{
	dir = 8
	},
/turf/open/misc/asteroid/basalt/lava_land_surface,
/area/ruin/unpowered)
"l" = (
/obj/structure/stone_tile/surrounding_tile/burnt,
/obj/structure/ore_vein,
/turf/closed/mineral/volcanic/lava_land_surface,
/area/ruin/unpowered)
"m" = (
/obj/structure/stone_tile/block{
	dir = 4
	},
/obj/structure/stone_tile{
	dir = 8
	},
/turf/closed/mineral/volcanic/lava_land_surface,
/area/ruin/unpowered)
"n" = (
/mob/living/basic/lightgeist{
	light_color = "#42ECFF"
	},
/turf/open/water/hot_spring{
	initial_gas_mix = "LAVALAND_ATMOS"
	},
/area/ruin/unpowered)
"o" = (
/obj/structure/stone_tile/block,
/turf/closed/mineral/volcanic/lava_land_surface,
/area/ruin/unpowered)
"p" = (
/obj/structure/stone_tile/slab,
/obj/item/stack/marker_beacon/ten,
/turf/open/misc/asteroid/basalt/lava_land_surface,
/area/ruin/unpowered)
"r" = (
/obj/structure/stone_tile/block/cracked,
/obj/structure/stone_tile/burnt{
	dir = 1
	},
/turf/open/lava/smooth/lava_land_surface,
/area/lavaland/surface/outdoors)
"s" = (
/obj/structure/stone_tile/slab/cracked{
	dir = 5
	},
/obj/structure/stone_tile/slab/cracked{
	dir = 10
	},
/turf/open/lava/smooth/lava_land_surface,
/area/ruin/unpowered)
"t" = (
/obj/structure/stone_tile/block{
	dir = 8
	},
/turf/open/misc/asteroid/basalt/lava_land_surface,
/area/ruin/unpowered)
"u" = (
/obj/structure/stone_tile/surrounding_tile{
	dir = 8
	},
/obj/item/xenoarch/useless_relic{
	name = "Ancient relic";
	desc = "Sort of relic that can be exported through Cargo."
	},
/turf/open/misc/asteroid/basalt/lava_land_surface,
/area/ruin/unpowered)
"v" = (
/obj/structure/stone_tile/burnt{
	dir = 1
	},
/turf/open/lava/smooth/lava_land_surface,
/area/lavaland/surface/outdoors)
"w" = (
/turf/template_noop,
/area/template_noop)
"x" = (
/obj/structure/stone_tile/burnt{
	dir = 8
	},
/obj/structure/stone_tile/cracked,
/obj/structure/stone_tile/block/burnt{
	dir = 1
	},
/turf/open/lava/smooth/lava_land_surface,
/area/ruin/unpowered)
"y" = (
/obj/structure/stone_tile/block/cracked{
	dir = 1
	},
/turf/closed/mineral/volcanic/lava_land_surface,
/area/ruin/unpowered)
"z" = (
/obj/structure/stone_tile/slab,
/turf/closed/mineral/volcanic/lava_land_surface,
/area/ruin/unpowered)
"A" = (
/obj/structure/flora/rock/pile/style_random,
/obj/structure/stone_tile/surrounding_tile/cracked,
/turf/closed/mineral/volcanic/lava_land_surface,
/area/ruin/unpowered)
"B" = (
/obj/structure/stone_tile/slab/cracked{
	dir = 4
	},
/turf/closed/mineral/volcanic/lava_land_surface,
/area/ruin/unpowered)
"C" = (
/obj/structure/stone_tile/block/cracked{
	dir = 4
	},
/turf/closed/mineral/volcanic/lava_land_surface,
/area/ruin/unpowered)
"D" = (
/obj/structure/stone_tile/burnt,
/obj/structure/stone_tile/cracked{
	dir = 4
	},
/obj/structure/stone_tile{
	dir = 8
	},
/turf/closed/mineral/volcanic/lava_land_surface,
/area/lavaland/surface/outdoors)
"E" = (
/obj/structure/stone_tile/block{
	dir = 1
	},
/turf/open/misc/asteroid/basalt/lava_land_surface,
/area/ruin/unpowered)
"F" = (
/obj/structure/stone_tile/block{
	dir = 1
	},
/obj/structure/stone_tile,
/obj/item/reagent_containers/cup/bowl/wood_bowl{
	pixel_x = 7;
	pixel_y = 7
	},
/turf/open/misc/asteroid/basalt/lava_land_surface,
/area/ruin/unpowered)
"G" = (
/obj/effect/mapping_helpers/bombable_wall,
/turf/closed/indestructible/riveted/boss/wasteland,
/area/lavaland/surface/outdoors)
"J" = (
/turf/open/lava/smooth/lava_land_surface,
/area/lavaland/surface/outdoors)
"K" = (
/obj/structure/stone_tile/surrounding,
/obj/structure/stone_tile/center,
/turf/open/misc/asteroid/basalt/lava_land_surface,
/area/ruin/unpowered)
"L" = (
/obj/structure/stone_tile/center/burnt,
/obj/structure/stone_tile/surrounding/cracked{
	dir = 4
	},
/turf/closed/mineral/volcanic/lava_land_surface,
/area/ruin/unpowered)
"M" = (
/turf/closed/indestructible/riveted/boss,
/area/lavaland/surface/outdoors)
"N" = (
/obj/structure/flora/rock/pile/style_random,
/obj/structure/stone_tile/surrounding_tile/cracked{
	dir = 1
	},
/turf/closed/mineral/volcanic/lava_land_surface,
/area/ruin/unpowered)
"O" = (
/obj/structure/stone_tile/block{
	dir = 8
	},
/obj/item/reagent_containers/cup/beaker/large/ceramic,
/turf/open/misc/asteroid/basalt/lava_land_surface,
/area/ruin/unpowered)
"P" = (
/obj/structure/stone_tile/block/cracked,
/turf/closed/mineral/volcanic/lava_land_surface,
/area/ruin/unpowered)
"R" = (
/obj/structure/stone_tile/slab/cracked,
/obj/item/stack/marker_beacon/ten,
/turf/closed/mineral/volcanic/lava_land_surface,
/area/ruin/unpowered)
"S" = (
/obj/structure/stone_tile/block/cracked{
	dir = 4
	},
/obj/structure/stone_tile/cracked{
	dir = 8
	},
/obj/structure/stone_tile/burnt{
	dir = 4
	},
/turf/closed/mineral/volcanic/lava_land_surface,
/area/ruin/unpowered)
"T" = (
/obj/structure/stone_tile/surrounding_tile{
	dir = 4
	},
/turf/open/misc/asteroid/basalt/lava_land_surface,
/area/ruin/unpowered)
"V" = (
/obj/structure/stone_tile/burnt{
	dir = 8
	},
/obj/structure/stone_tile/surrounding_tile/cracked{
	dir = 1
	},
/turf/open/lava/smooth/lava_land_surface,
/area/ruin/unpowered)
"W" = (
/obj/structure/stone_tile/surrounding_tile/burnt{
	dir = 8
	},
/turf/closed/mineral/volcanic/lava_land_surface,
/area/ruin/unpowered)
"X" = (
/obj/structure/stone_tile/block/cracked{
	dir = 8
	},
/turf/closed/mineral/volcanic/lava_land_surface,
/area/lavaland/surface/outdoors)
"Y" = (
/turf/open/lava/smooth/lava_land_surface,
/area/ruin/unpowered)
"Z" = (
/obj/item/toy/seashell,
/turf/open/water/hot_spring{
	initial_gas_mix = "LAVALAND_ATMOS"
	},
/area/ruin/unpowered)

(1,1,1) = {"
w
f
M
D
X
w
w
G
w
"}
(2,1,1) = {"
c
M
M
M
M
M
M
M
M
"}
(3,1,1) = {"
G
M
T
i
t
t
O
u
M
"}
(4,1,1) = {"
g
M
E
a
Z
n
a
o
M
"}
(5,1,1) = {"
h
M
k
n
a
a
a
o
M
"}
(6,1,1) = {"
w
M
K
p
a
a
a
o
J
"}
(7,1,1) = {"
w
M
F
a
a
b
C
A
M
"}
(8,1,1) = {"
J
M
y
a
a
P
L
z
M
"}
(9,1,1) = {"
J
v
N
m
S
l
Y
B
J
"}
(10,1,1) = {"
d
J
Y
R
W
Y
Y
Y
J
"}
(11,1,1) = {"
d
G
M
V
e
s
x
r
d
"}
(12,1,1) = {"
w
w
M
J
J
M
J
M
w
"}
