//MAP CONVERTED BY dmm2tgm.py THIS HEADER COMMENT PREVENTS RECONVERSION, DO NOT REMOVE
"bC" = (
/obj/structure/stone_tile/surrounding_tile{
	dir = 8
	},
/obj/structure/flora/rock/pile/style_random,
/turf/closed/mineral/random/high_chance/volcanic,
/area/lavaland/surface/outdoors)
"bI" = (
/obj/structure/stone_tile/burnt{
	dir = 4
	},
/obj/structure/stone_tile/block/cracked,
/obj/item/ammo_casing/arrow/bone,
/turf/closed/mineral/random/high_chance/volcanic,
/area/lavaland/surface/outdoors)
"bL" = (
/obj/structure/stone_tile/slab/burnt,
/turf/closed/mineral/volcanic/lava_land_surface,
/area/lavaland/surface/outdoors)
"cX" = (
/turf/template_noop,
/area/template_noop)
"es" = (
/obj/structure/stone_tile/surrounding_tile/cracked{
	dir = 1
	},
/turf/closed/mineral/random/high_chance/volcanic,
/area/lavaland/surface/outdoors)
"fF" = (
/obj/structure/stone_tile/block/cracked,
/obj/structure/stone_tile/block/burnt{
	dir = 1
	},
/mob/living/basic/mining/ancient_demon/ancient_demon_lesser,
/turf/closed/mineral/volcanic/lava_land_surface,
/area/lavaland/surface/outdoors)
"fY" = (
/obj/structure/stone_tile/slab/cracked{
	dir = 4
	},
/obj/item/xenoarch/useless_relic{
	name = "Ancient relic";
	desc = "Sort of relic that can be exported through Cargo."
	},
/turf/closed/mineral/volcanic/lava_land_surface,
/area/lavaland/surface/outdoors)
"jd" = (
/obj/structure/stone_tile/surrounding_tile/cracked,
/obj/structure/stone_tile/slab/cracked{
	dir = 1
	},
/obj/structure/stone_tile/slab/cracked{
	dir = 8
	},
/turf/closed/mineral/volcanic/lava_land_surface,
/area/lavaland/surface/outdoors)
"jD" = (
/obj/structure/stone_tile/surrounding_tile,
/obj/structure/stone_tile/surrounding_tile{
	dir = 4
	},
/turf/closed/mineral/volcanic/lava_land_surface,
/area/lavaland/surface/outdoors)
"kh" = (
/obj/structure/rack/shelf{
	icon = 'modular_nova/modules/mapping/icons/unique/furniture.dmi';
	icon_state = "empty_shelf_1"
	},
/obj/structure/stone_tile/slab,
/obj/item/reagent_containers/cup/bowl/mushroom_bowl{
	pixel_y = 7;
	pixel_x = -5
	},
/obj/item/reagent_containers/cup/bowl/mushroom_bowl{
	pixel_y = 7;
	pixel_x = 7
	},
/obj/item/smelling_salts{
	pixel_y = -9;
	pixel_x = -5
	},
/obj/structure/stone_tile/slab,
/turf/open/misc/asteroid/basalt/lava_land_surface,
/area/ruin/unpowered)
"kv" = (
/obj/structure/stone_tile/surrounding_tile{
	dir = 4
	},
/obj/structure/stone_tile/surrounding_tile,
/turf/closed/mineral/volcanic/lava_land_surface,
/area/lavaland/surface/outdoors)
"kQ" = (
/obj/structure/stone_tile/surrounding/burnt,
/obj/structure/stone_tile/center/cracked,
/mob/living/basic/mining/ancient_demon/ancient_demon_lesser,
/turf/closed/mineral/volcanic/lava_land_surface,
/area/lavaland/surface/outdoors)
"ln" = (
/obj/structure/wall_torch/mount_only,
/turf/closed/indestructible/riveted/boss,
/area/ruin/unpowered)
"lz" = (
/obj/structure/stone_tile/block/burnt,
/obj/item/ammo_casing/arrow/bone,
/obj/effect/spawner/random/structure/spikes,
/turf/closed/mineral/random/high_chance/volcanic,
/area/lavaland/surface/outdoors)
"mE" = (
/obj/structure/stone_tile/slab/cracked{
	dir = 4
	},
/turf/closed/mineral/random/high_chance/volcanic,
/area/lavaland/surface/outdoors)
"nk" = (
/obj/structure/stone_tile/surrounding,
/obj/structure/stone_tile/center,
/turf/closed/mineral/volcanic/lava_land_surface,
/area/lavaland/surface/outdoors)
"nz" = (
/obj/structure/stone_tile/center/burnt,
/obj/structure/stone_tile/surrounding/cracked{
	dir = 1
	},
/turf/closed/mineral/volcanic/lava_land_surface,
/area/lavaland/surface/outdoors)
"on" = (
/obj/structure/stone_tile/block,
/obj/structure/stone_tile/block{
	dir = 1
	},
/obj/item/reagent_containers/cup/bowl/wood_bowl,
/turf/closed/mineral/random/high_chance/volcanic,
/area/lavaland/surface/outdoors)
"qg" = (
/obj/structure/stone_tile/surrounding_tile{
	dir = 8
	},
/obj/structure/flora/rock/pile/style_random,
/turf/closed/mineral/volcanic/lava_land_surface,
/area/lavaland/surface/outdoors)
"qt" = (
/obj/structure/stone_tile/surrounding_tile{
	dir = 8
	},
/obj/structure/stone_tile/surrounding_tile{
	dir = 1
	},
/turf/closed/mineral/random/high_chance/volcanic,
/area/lavaland/surface/outdoors)
"qH" = (
/obj/structure/stone_tile{
	dir = 8
	},
/obj/structure/stone_tile/burnt{
	dir = 1
	},
/obj/item/flashlight/flare/torch,
/turf/closed/mineral/volcanic/lava_land_surface,
/area/lavaland/surface/outdoors)
"sd" = (
/obj/structure/stone_tile/block/cracked{
	dir = 1
	},
/obj/structure/stone_tile/block,
/turf/closed/mineral/random/high_chance/volcanic,
/area/lavaland/surface/outdoors)
"sr" = (
/obj/structure/stone_tile/slab,
/obj/item/flashlight/flare/torch,
/obj/item/xenoarch/useless_relic{
	name = "Ancient relic";
	desc = "Sort of relic that can be exported through Cargo."
	},
/turf/closed/mineral/volcanic/lava_land_surface,
/area/ruin/unpowered)
"sV" = (
/obj/structure/stone_tile/block,
/obj/structure/stone_tile/block{
	dir = 1
	},
/turf/closed/mineral/volcanic/lava_land_surface,
/area/lavaland/surface/outdoors)
"tP" = (
/obj/structure/stone_tile/surrounding,
/obj/structure/stone_tile/center,
/mob/living/basic/mining/ancient_demon,
/turf/closed/mineral/random/high_chance/volcanic,
/area/ruin/unpowered)
"uZ" = (
/turf/closed/indestructible/riveted/boss,
/area/ruin/unpowered)
"vE" = (
/obj/structure/stone_tile/surrounding_tile{
	dir = 1
	},
/obj/structure/stone_tile/surrounding_tile{
	dir = 8
	},
/turf/closed/mineral/volcanic/lava_land_surface,
/area/lavaland/surface/outdoors)
"vI" = (
/obj/structure/wall_torch/mount_only,
/turf/closed/indestructible/riveted/boss,
/area/lavaland/surface/outdoors)
"vV" = (
/obj/effect/mapping_helpers/bombable_wall,
/turf/closed/indestructible/riveted/boss/wasteland,
/area/lavaland/surface/outdoors)
"we" = (
/obj/effect/mapping_helpers/bombable_wall,
/turf/closed/indestructible/riveted/boss/wasteland,
/area/ruin/unpowered)
"wg" = (
/obj/structure/stone_tile/block/cracked{
	dir = 1
	},
/turf/closed/mineral/volcanic/lava_land_surface,
/area/lavaland/surface/outdoors)
"wC" = (
/obj/structure/stone_tile/block,
/obj/structure/stone_tile/cracked{
	dir = 4
	},
/obj/structure/stone_tile{
	dir = 1
	},
/turf/closed/mineral/random/high_chance/volcanic,
/area/lavaland/surface/outdoors)
"yd" = (
/obj/structure/stone_tile/surrounding,
/obj/structure/stone_tile/center/cracked,
/turf/closed/mineral/volcanic/lava_land_surface,
/area/lavaland/surface/outdoors)
"Bm" = (
/obj/structure/stone_tile/slab,
/obj/structure/table/wood,
/obj/item/food/rootroll{
	pixel_x = -3;
	pixel_y = -1
	},
/turf/closed/mineral/random/high_chance/volcanic,
/area/ruin/unpowered)
"BB" = (
/obj/structure/stone_tile/slab/cracked,
/turf/closed/mineral/random/high_chance/volcanic,
/area/lavaland/surface/outdoors)
"Cs" = (
/obj/structure/stone_tile/block,
/obj/structure/stone_tile/block/cracked{
	dir = 1
	},
/turf/closed/mineral/random/high_chance/volcanic,
/area/lavaland/surface/outdoors)
"CK" = (
/obj/structure/stone_tile/surrounding_tile/cracked,
/obj/structure/stone_tile/cracked{
	dir = 4
	},
/obj/item/xenoarch/useless_relic{
	name = "Ancient relic";
	desc = "Sort of relic that can be exported through Cargo."
	},
/turf/closed/mineral/volcanic/lava_land_surface,
/area/lavaland/surface/outdoors)
"CS" = (
/obj/structure/flora/rock/pile/style_random,
/mob/living/basic/mining/ancient_demon/demoraptor,
/turf/closed/mineral/volcanic/lava_land_surface,
/area/lavaland/surface/outdoors)
"CZ" = (
/obj/structure/stone_tile/slab,
/mob/living/basic/mining/ancient_demon/ancient_demon_lesser,
/turf/closed/mineral/random/high_chance/volcanic,
/area/lavaland/surface/outdoors)
"FR" = (
/turf/closed/indestructible/riveted/boss,
/area/lavaland/surface/outdoors)
"FY" = (
/obj/structure/stone_tile/slab/cracked,
/turf/closed/mineral/volcanic/lava_land_surface,
/area/lavaland/surface/outdoors)
"IC" = (
/obj/structure/stone_tile/slab,
/turf/closed/mineral/volcanic/lava_land_surface,
/area/lavaland/surface/outdoors)
"IX" = (
/obj/structure/stone_tile/slab,
/obj/structure/stone_tile/slab,
/obj/item/xenoarch/useless_relic/magnified{
	name = "Ancient relic";
	desc = "Sort of relic that can be exported through Cargo."
	},
/turf/closed/mineral/random/high_chance/volcanic,
/area/ruin/unpowered)
"JT" = (
/obj/structure/stone_tile/slab/cracked{
	dir = 1
	},
/obj/structure/stone_tile/surrounding_tile/cracked,
/obj/effect/spawner/random/structure/spikes,
/turf/closed/mineral/random/high_chance/volcanic,
/area/lavaland/surface/outdoors)
"KH" = (
/obj/structure/stone_tile/slab,
/obj/structure/table/wood,
/obj/item/clothing/suit/hooded/cloak/drake,
/turf/closed/mineral/random/high_chance/volcanic,
/area/ruin/unpowered)
"KW" = (
/obj/structure/stone_tile/slab,
/turf/closed/mineral/random/high_chance/volcanic,
/area/lavaland/surface/outdoors)
"Lw" = (
/obj/structure/stone_tile/surrounding/cracked,
/obj/structure/stone_tile/center/burnt,
/turf/closed/mineral/volcanic/lava_land_surface,
/area/lavaland/surface/outdoors)
"LF" = (
/obj/structure/stone_tile/slab/cracked,
/turf/closed/mineral/random/high_chance/volcanic,
/area/ruin/unpowered)
"Rx" = (
/obj/structure/stone_tile/surrounding_tile/cracked{
	dir = 1
	},
/turf/closed/mineral/volcanic/lava_land_surface,
/area/lavaland/surface/outdoors)
"UA" = (
/obj/structure/stone_tile/block/cracked,
/obj/effect/spawner/random/structure/spikes,
/turf/closed/mineral/volcanic/lava_land_surface,
/area/lavaland/surface/outdoors)
"VG" = (
/obj/item/screwdriver/ashwalker,
/obj/item/hatchet/wooden,
/obj/structure/stone_tile/slab,
/turf/closed/mineral/volcanic/lava_land_surface,
/area/ruin/unpowered)
"VP" = (
/obj/structure/stone_tile/slab,
/turf/closed/mineral/volcanic/lava_land_surface,
/area/ruin/unpowered)
"Wj" = (
/obj/structure/stone_tile/cracked{
	dir = 4
	},
/turf/closed/mineral/volcanic/lava_land_surface,
/area/lavaland/surface/outdoors)
"Yp" = (
/obj/structure/stone_tile/block/cracked,
/obj/effect/spawner/random/structure/spikes,
/turf/closed/mineral/random/high_chance/volcanic,
/area/lavaland/surface/outdoors)

(1,1,1) = {"
cX
cX
cX
FR
FR
cX
cX
cX
"}
(2,1,1) = {"
cX
vV
FR
FR
CK
qg
cX
cX
"}
(3,1,1) = {"
Lw
sd
bI
BB
Cs
jD
vE
Yp
"}
(4,1,1) = {"
kQ
FY
wC
JT
KW
qt
kv
qH
"}
(5,1,1) = {"
cX
FR
FR
FR
Rx
CZ
bL
cX
"}
(6,1,1) = {"
uZ
uZ
uZ
uZ
uZ
BB
IC
vI
"}
(7,1,1) = {"
uZ
VG
IX
kh
uZ
sV
sV
cX
"}
(8,1,1) = {"
ln
VP
tP
LF
we
nz
yd
cX
"}
(9,1,1) = {"
we
sr
Bm
KH
uZ
on
UA
cX
"}
(10,1,1) = {"
we
uZ
uZ
uZ
uZ
mE
bL
FR
"}
(11,1,1) = {"
FR
FR
FR
FR
jd
nk
nz
cX
"}
(12,1,1) = {"
FR
fY
cX
vV
FR
fF
cX
vV
"}
(13,1,1) = {"
vV
cX
cX
cX
FR
cX
cX
cX
"}
(14,1,1) = {"
cX
cX
cX
cX
Wj
bC
cX
cX
"}
(15,1,1) = {"
cX
cX
cX
wg
FR
lz
cX
cX
"}
(16,1,1) = {"
cX
cX
cX
es
CS
cX
cX
cX
"}
