//MAP CONVERTED BY dmm2tgm.py THIS HEADER COMMENT PREVENTS RECONVERSION, DO NOT REMOVE
"ab" = (
/obj/effect/decal/cleanable/dirt,
/mob/living/basic/mining/wolf{
	desc = "A baby goliath. Do it. Stomp it.";
	faction = list("mining","boss","hell");
	name = "Biter";
	attack_sound = 'sound/effects/wounds/crackandbleed.ogg';
	attack_verb_continuous = "maniacally tears";
	attack_verb_simple = "tears";
	attack_vis_effect = "slash";
	bare_wound_bonus = 5;
	butcher_results = list(/obj/item/food/meat/slab/goliath = 1);
	can_tame = 0;
	health = 35;
	icon = 'icons/mob/simple/lavaland/lavaland_monsters.dmi';
	icon_dead = "goliath_baby_dead";
	icon_living = "goliath_baby";
	icon_state = "goliath_baby";
	maxHealth = 35;
	melee_damage_lower = 1;
	melee_attack_cooldown = 5;
	speed = 0.2;
	wound_bonus = -1;
	icon_gib = "syndicate_gib";
	melee_damage_upper = 2;
	damage_coeff = list("brute" = 1, "burn" = 1, "toxin" = 1, "stamina" = 1, "oxygen" = 1);
	crusher_loot = null
	},
/mob/living/basic/mining/wolf{
	desc = "A baby goliath. Do it. Stomp it.";
	faction = list("mining","boss","hell");
	name = "Biter";
	attack_sound = 'sound/effects/wounds/crackandbleed.ogg';
	attack_verb_continuous = "maniacally tears";
	attack_verb_simple = "tears";
	attack_vis_effect = "slash";
	bare_wound_bonus = 5;
	butcher_results = list(/obj/item/food/meat/slab/goliath = 1);
	can_tame = 0;
	health = 35;
	icon = 'icons/mob/simple/lavaland/lavaland_monsters.dmi';
	icon_dead = "goliath_baby_dead";
	icon_living = "goliath_baby";
	icon_state = "goliath_baby";
	maxHealth = 35;
	melee_damage_lower = 1;
	melee_attack_cooldown = 5;
	speed = 0.2;
	wound_bonus = -1;
	icon_gib = "syndicate_gib";
	melee_damage_upper = 2;
	damage_coeff = list("brute" = 1, "burn" = 1, "toxin" = 1, "stamina" = 1, "oxygen" = 1);
	crusher_loot = null
	},
/turf/open/misc/hay/lavaland,
/area/ruin/unpowered)
"aj" = (
/obj/structure/railing/stone{
	layer = -6
	},
/obj/structure/stone_tile/slab,
/obj/item/xenoarch/useless_relic{
	name = "Ancient relic";
	desc = "Sort of relic that can be exported through Cargo."
	},
/turf/closed/mineral/random/high_chance/volcanic,
/area/lavaland/surface/outdoors)
"aF" = (
/obj/structure/stone_tile/block/burnt{
	dir = 8
	},
/turf/open/lava/smooth/lava_land_surface,
/area/lavaland/surface/outdoors)
"aO" = (
/turf/closed/mineral/random/high_chance/volcanic,
/area/ruin/unpowered)
"cH" = (
/turf/template_noop,
/area/template_noop)
"dB" = (
/obj/structure/stone_tile/slab/burnt,
/mob/living/basic/mining/wolf{
	desc = "A baby goliath. Do it. Stomp it.";
	faction = list("mining","boss","hell");
	name = "Biter";
	attack_sound = 'sound/effects/wounds/crackandbleed.ogg';
	attack_verb_continuous = "maniacally tears";
	attack_verb_simple = "tears";
	attack_vis_effect = "slash";
	bare_wound_bonus = 5;
	butcher_results = list(/obj/item/food/meat/slab/goliath = 1);
	can_tame = 0;
	health = 35;
	icon = 'icons/mob/simple/lavaland/lavaland_monsters.dmi';
	icon_dead = "goliath_baby_dead";
	icon_living = "goliath_baby";
	icon_state = "goliath_baby";
	maxHealth = 35;
	melee_damage_lower = 1;
	melee_attack_cooldown = 5;
	speed = 0.2;
	wound_bonus = -1;
	icon_gib = "syndicate_gib";
	melee_damage_upper = 2;
	damage_coeff = list("brute" = 1, "burn" = 1, "toxin" = 1, "stamina" = 1, "oxygen" = 1);
	crusher_loot = null
	},
/turf/open/misc/asteroid/basalt/lava_land_surface,
/area/ruin/unpowered)
"dN" = (
/obj/structure/stone_tile/surrounding/cracked{
	dir = 6
	},
/obj/item/xenoarch/useless_relic{
	name = "Ancient relic";
	desc = "Sort of relic that can be exported through Cargo."
	},
/turf/closed/mineral/volcanic/lava_land_surface,
/area/lavaland/surface/outdoors)
"fB" = (
/turf/closed/indestructible/riveted/boss,
/area/ruin/unpowered)
"fZ" = (
/obj/structure/flora/rock/pile/style_random,
/turf/closed/mineral/random/high_chance/volcanic,
/area/ruin/unpowered)
"hA" = (
/obj/effect/mapping_helpers/bombable_wall,
/turf/closed/indestructible/riveted/boss/wasteland,
/area/lavaland/surface/outdoors)
"hV" = (
/obj/machinery/hydroponics/soil,
/turf/closed/mineral/random/high_chance/volcanic,
/area/ruin/unpowered)
"it" = (
/obj/item/stack/sheet/animalhide/goliath_hide,
/obj/effect/decal/cleanable/dirt,
/turf/open/misc/hay/lavaland,
/area/ruin/unpowered)
"iw" = (
/mob/living/basic/mining/wolf{
	desc = "A baby goliath. Do it. Stomp it.";
	faction = list("mining","boss","hell");
	name = "Biter";
	attack_sound = 'sound/effects/wounds/crackandbleed.ogg';
	attack_verb_continuous = "maniacally tears";
	attack_verb_simple = "tears";
	attack_vis_effect = "slash";
	bare_wound_bonus = 5;
	butcher_results = list(/obj/item/food/meat/slab/goliath = 1);
	can_tame = 0;
	health = 35;
	icon = 'icons/mob/simple/lavaland/lavaland_monsters.dmi';
	icon_dead = "goliath_baby_dead";
	icon_living = "goliath_baby";
	icon_state = "goliath_baby";
	maxHealth = 35;
	melee_damage_lower = 1;
	melee_attack_cooldown = 5;
	speed = 0.2;
	wound_bonus = -1;
	icon_gib = "syndicate_gib";
	melee_damage_upper = 2;
	damage_coeff = list("brute" = 1, "burn" = 1, "toxin" = 1, "stamina" = 1, "oxygen" = 1);
	crusher_loot = null
	},
/turf/closed/mineral/volcanic/lava_land_surface,
/area/ruin/unpowered)
"iB" = (
/obj/item/stack/sheet/bone,
/obj/structure/flora/rock/pile/style_random,
/turf/closed/mineral/volcanic/lava_land_surface,
/area/ruin/unpowered)
"iN" = (
/obj/machinery/hydroponics/soil,
/turf/closed/mineral/volcanic/lava_land_surface,
/area/ruin/unpowered)
"js" = (
/obj/structure/stone_tile/surrounding/cracked,
/obj/structure/stone_tile/center/burnt,
/obj/effect/decal/cleanable/dirt,
/turf/open/misc/asteroid/basalt/lava_land_surface,
/area/ruin/unpowered)
"jD" = (
/obj/structure/stone_tile/cracked{
	dir = 4
	},
/turf/closed/mineral/volcanic/lava_land_surface,
/area/lavaland/surface/outdoors)
"jX" = (
/obj/structure/stone_tile/slab/cracked{
	dir = 5
	},
/obj/effect/decal/cleanable/dirt,
/turf/open/misc/asteroid/basalt/lava_land_surface,
/area/lavaland/surface/outdoors)
"kn" = (
/mob/living/basic/mining/goliath,
/obj/structure/flora/rock/pile/style_random,
/turf/closed/mineral/random/high_chance/volcanic,
/area/ruin/unpowered)
"kr" = (
/obj/structure/stone_tile/surrounding_tile/cracked{
	dir = 4
	},
/turf/closed/mineral/random/high_chance/volcanic,
/area/ruin/unpowered)
"lS" = (
/obj/structure/stone_tile/slab/burnt,
/turf/closed/mineral/volcanic/lava_land_surface,
/area/lavaland/surface/outdoors)
"lV" = (
/obj/item/hatchet/wooden,
/obj/structure/stone_tile/surrounding/cracked{
	dir = 4
	},
/obj/effect/decal/cleanable/dirt/dust,
/turf/open/misc/hay/lavaland,
/area/ruin/unpowered)
"ms" = (
/obj/item/stack/sheet/animalhide/goliath_hide,
/turf/open/misc/hay/lavaland,
/area/ruin/unpowered)
"my" = (
/obj/structure/railing/stone{
	layer = -6
	},
/turf/closed/mineral/random/high_chance/volcanic,
/area/lavaland/surface/outdoors)
"nx" = (
/obj/structure/railing/stone{
	layer = -6
	},
/obj/structure/trap/fire{
	name = "Anctient runic spikes";
	desc = "A strange carving of some symbols. What's that for?";
	alpha = 180;
	icon = 'icons/obj/service/hydroponics/equipment.dmi';
	icon_state = "woodspike";
	light_color = "#FF1111";
	color = "#FF1111";
	max_integrity = 30
	},
/turf/closed/mineral/random/high_chance/volcanic,
/area/lavaland/surface/outdoors)
"nI" = (
/obj/structure/flora/rock/pile/style_random,
/turf/closed/mineral/volcanic/lava_land_surface,
/area/ruin/unpowered)
"oL" = (
/obj/structure/flora/rock/pile/style_random,
/turf/closed/mineral/volcanic/lava_land_surface,
/area/lavaland/surface/outdoors)
"pd" = (
/obj/machinery/hydroponics/soil,
/obj/effect/decal/cleanable/dirt,
/turf/open/misc/hay/lavaland,
/area/ruin/unpowered)
"qd" = (
/obj/structure/stone_tile/surrounding_tile/cracked{
	dir = 1
	},
/mob/living/basic/mining/wolf{
	desc = "A baby goliath. Do it. Stomp it.";
	faction = list("mining","boss","hell");
	name = "Biter";
	attack_sound = 'sound/effects/wounds/crackandbleed.ogg';
	attack_verb_continuous = "maniacally tears";
	attack_verb_simple = "tears";
	attack_vis_effect = "slash";
	bare_wound_bonus = 5;
	butcher_results = list(/obj/item/food/meat/slab/goliath = 1);
	can_tame = 0;
	health = 35;
	icon = 'icons/mob/simple/lavaland/lavaland_monsters.dmi';
	icon_dead = "goliath_baby_dead";
	icon_living = "goliath_baby";
	icon_state = "goliath_baby";
	maxHealth = 35;
	melee_damage_lower = 1;
	melee_attack_cooldown = 5;
	speed = 0.2;
	wound_bonus = -1;
	icon_gib = "syndicate_gib";
	melee_damage_upper = 2;
	damage_coeff = list("brute" = 1, "burn" = 1, "toxin" = 1, "stamina" = 1, "oxygen" = 1);
	crusher_loot = null
	},
/turf/closed/mineral/volcanic/lava_land_surface,
/area/ruin/unpowered)
"ql" = (
/obj/structure/stone_tile/burnt{
	dir = 4
	},
/turf/open/lava/smooth/lava_land_surface,
/area/lavaland/surface/outdoors)
"qp" = (
/obj/structure/stone_tile/block/cracked,
/obj/effect/decal/cleanable/dirt,
/turf/open/misc/hay/lavaland,
/area/ruin/unpowered)
"qu" = (
/turf/closed/mineral/volcanic/lava_land_surface,
/area/lavaland/surface/outdoors)
"rv" = (
/obj/structure/stone_tile/slab,
/mob/living/basic/mining/wolf{
	desc = "A baby goliath. Do it. Stomp it.";
	faction = list("mining","boss","hell");
	name = "Biter";
	attack_sound = 'sound/effects/wounds/crackandbleed.ogg';
	attack_verb_continuous = "maniacally tears";
	attack_verb_simple = "tears";
	attack_vis_effect = "slash";
	bare_wound_bonus = 5;
	butcher_results = list(/obj/item/food/meat/slab/goliath = 1);
	can_tame = 0;
	health = 35;
	icon = 'icons/mob/simple/lavaland/lavaland_monsters.dmi';
	icon_dead = "goliath_baby_dead";
	icon_living = "goliath_baby";
	icon_state = "goliath_baby";
	maxHealth = 35;
	melee_damage_lower = 1;
	melee_attack_cooldown = 5;
	speed = 0.2;
	wound_bonus = -1;
	icon_gib = "syndicate_gib";
	melee_damage_upper = 2;
	damage_coeff = list("brute" = 1, "burn" = 1, "toxin" = 1, "stamina" = 1, "oxygen" = 1);
	crusher_loot = null
	},
/turf/closed/mineral/volcanic/lava_land_surface,
/area/ruin/unpowered)
"sn" = (
/obj/machinery/hydroponics/soil,
/obj/item/stack/sheet/bone,
/turf/closed/mineral/volcanic/lava_land_surface,
/area/ruin/unpowered)
"tb" = (
/obj/structure/stone_tile/block,
/obj/structure/stone_tile/block{
	dir = 1
	},
/obj/effect/decal/cleanable/dirt,
/mob/living/basic/mining/wolf{
	desc = "A baby goliath. Do it. Stomp it.";
	faction = list("mining","boss","hell");
	name = "Biter";
	attack_sound = 'sound/effects/wounds/crackandbleed.ogg';
	attack_verb_continuous = "maniacally tears";
	attack_verb_simple = "tears";
	attack_vis_effect = "slash";
	bare_wound_bonus = 5;
	butcher_results = list(/obj/item/food/meat/slab/goliath = 1);
	can_tame = 0;
	health = 35;
	icon = 'icons/mob/simple/lavaland/lavaland_monsters.dmi';
	icon_dead = "goliath_baby_dead";
	icon_living = "goliath_baby";
	icon_state = "goliath_baby";
	maxHealth = 35;
	melee_damage_lower = 1;
	melee_attack_cooldown = 5;
	speed = 0.2;
	wound_bonus = -1;
	icon_gib = "syndicate_gib";
	melee_damage_upper = 2;
	damage_coeff = list("brute" = 1, "burn" = 1, "toxin" = 1, "stamina" = 1, "oxygen" = 1);
	crusher_loot = null
	},
/turf/open/misc/asteroid/basalt/lava_land_surface,
/area/lavaland/surface/outdoors)
"vx" = (
/obj/structure/trap/damage{
	name = "Anctient runic spikes";
	desc = "A strange carving of some symbols. What's that for?";
	icon = 'icons/obj/service/hydroponics/equipment.dmi';
	icon_state = "woodspike";
	light_color = "#DDFFDD";
	color = "#77FF77";
	alpha = 180;
	max_integrity = 30
	},
/turf/closed/mineral/volcanic/lava_land_surface,
/area/lavaland/surface/outdoors)
"vF" = (
/obj/structure/railing/stone/right{
	layer = -6
	},
/obj/structure/railing/stone/left{
	layer = -6
	},
/obj/effect/decal/cleanable/dirt,
/obj/structure/trap/fire{
	name = "Anctient runic spikes";
	desc = "A strange carving of some symbols. What's that for?";
	alpha = 180;
	icon = 'icons/obj/service/hydroponics/equipment.dmi';
	icon_state = "woodspike";
	light_color = "#FF1111";
	color = "#FF1111";
	max_integrity = 30
	},
/turf/open/misc/hay/lavaland,
/area/lavaland/surface/outdoors)
"wk" = (
/obj/structure/stone_tile/block,
/obj/structure/stone_tile/block{
	dir = 1
	},
/turf/closed/mineral/volcanic/lava_land_surface,
/area/lavaland/surface/outdoors)
"wU" = (
/obj/structure/stone_tile/block{
	dir = 1
	},
/obj/structure/stone_tile/surrounding_tile/cracked,
/obj/effect/decal/cleanable/dirt,
/turf/open/misc/asteroid/basalt/lava_land_surface,
/area/lavaland/surface/outdoors)
"xq" = (
/obj/structure/stone_tile/slab/cracked,
/obj/effect/decal/cleanable/dirt,
/turf/open/misc/asteroid/basalt/lava_land_surface,
/area/lavaland/surface/outdoors)
"xR" = (
/obj/structure/stone_tile/surrounding_tile/cracked{
	dir = 4
	},
/obj/structure/stone_tile/surrounding_tile/cracked,
/obj/structure/stone_tile/surrounding_tile/cracked{
	dir = 8
	},
/obj/structure/stone_tile/surrounding_tile/cracked{
	dir = 1
	},
/obj/structure/stone_tile/center,
/turf/closed/mineral/volcanic/lava_land_surface,
/area/ruin/unpowered)
"ya" = (
/obj/structure/stone_tile/surrounding_tile/cracked,
/obj/structure/punji_sticks/spikes,
/turf/open/misc/asteroid/basalt/lava_land_surface,
/area/ruin/unpowered)
"ze" = (
/obj/structure/punji_sticks/spikes,
/turf/open/misc/hay/lavaland,
/area/ruin/unpowered)
"zl" = (
/obj/effect/mapping_helpers/bombable_wall,
/turf/closed/indestructible/riveted/boss/wasteland,
/area/ruin/unpowered)
"zL" = (
/obj/structure/stone_tile/slab/cracked{
	dir = 1
	},
/turf/open/lava/smooth/lava_land_surface,
/area/lavaland/surface/outdoors)
"zQ" = (
/obj/structure/railing/stone{
	layer = -6
	},
/turf/closed/mineral/volcanic/lava_land_surface,
/area/lavaland/surface/outdoors)
"Ah" = (
/turf/closed/mineral/volcanic/lava_land_surface,
/area/ruin/unpowered)
"An" = (
/obj/structure/stone_tile/slab/cracked{
	dir = 1
	},
/obj/structure/stone_tile/surrounding_tile/cracked{
	dir = 4
	},
/obj/item/cultivator/rake,
/turf/open/misc/hay/lavaland,
/area/ruin/unpowered)
"Ax" = (
/obj/structure/punji_sticks/spikes,
/turf/closed/mineral/volcanic/lava_land_surface,
/area/lavaland/surface/outdoors)
"BE" = (
/obj/structure/stone_tile/slab/cracked{
	dir = 8
	},
/obj/item/storage/belt/mining/primitive,
/turf/closed/mineral/volcanic/lava_land_surface,
/area/ruin/unpowered)
"BP" = (
/obj/item/stack/sheet/bone,
/obj/effect/decal/cleanable/dirt,
/obj/structure/punji_sticks/spikes,
/turf/open/misc/hay/lavaland,
/area/ruin/unpowered)
"CH" = (
/obj/structure/stone_tile/block{
	dir = 1
	},
/turf/closed/mineral/volcanic/lava_land_surface,
/area/lavaland/surface/outdoors)
"Dm" = (
/obj/structure/railing/stone/right{
	layer = -6
	},
/obj/structure/railing/stone/left{
	layer = -6
	},
/obj/structure/punji_sticks/spikes,
/turf/closed/mineral/random/high_chance/volcanic,
/area/lavaland/surface/outdoors)
"Ef" = (
/obj/structure/stone_tile/block/burnt,
/turf/open/lava/smooth/lava_land_surface,
/area/lavaland/surface/outdoors)
"El" = (
/obj/structure/railing/stone{
	layer = -6
	},
/obj/structure/stone_tile/slab,
/turf/open/misc/asteroid/basalt/lava_land_surface,
/area/lavaland/surface/outdoors)
"Fe" = (
/obj/structure/stone_tile/block/burnt{
	dir = 1
	},
/turf/closed/mineral/volcanic/lava_land_surface,
/area/lavaland/surface/outdoors)
"Fn" = (
/obj/structure/stone_tile/surrounding_tile/cracked{
	dir = 1
	},
/obj/structure/stone_tile/slab/cracked{
	dir = 1
	},
/obj/structure/trap/fire{
	name = "Anctient runic spikes";
	desc = "A strange carving of some symbols. What's that for?";
	alpha = 180;
	icon = 'icons/obj/service/hydroponics/equipment.dmi';
	icon_state = "woodspike";
	light_color = "#FF1111";
	color = "#FF1111";
	max_integrity = 30
	},
/turf/open/misc/hay/lavaland,
/area/ruin/unpowered)
"Gb" = (
/obj/structure/stone_tile/surrounding/cracked{
	dir = 6
	},
/turf/closed/mineral/volcanic/lava_land_surface,
/area/lavaland/surface/outdoors)
"GK" = (
/obj/structure/trap/fire{
	name = "Anctient runic spikes";
	desc = "A strange carving of some symbols. What's that for?";
	alpha = 180;
	icon = 'icons/obj/service/hydroponics/equipment.dmi';
	icon_state = "woodspike";
	light_color = "#FF1111";
	color = "#FF1111";
	max_integrity = 30
	},
/turf/closed/mineral/volcanic/lava_land_surface,
/area/lavaland/surface/outdoors)
"GP" = (
/obj/item/shovel,
/obj/structure/stone_tile/cracked{
	dir = 8
	},
/obj/structure/stone_tile/surrounding_tile/cracked,
/obj/effect/decal/cleanable/dirt,
/turf/open/misc/hay/lavaland,
/area/ruin/unpowered)
"HQ" = (
/obj/structure/railing/stone{
	layer = -6
	},
/obj/structure/stone_tile/slab,
/mob/living/basic/mining/wolf{
	desc = "A baby goliath. Do it. Stomp it.";
	faction = list("mining","boss","hell");
	name = "Biter";
	attack_sound = 'sound/effects/wounds/crackandbleed.ogg';
	attack_verb_continuous = "maniacally tears";
	attack_verb_simple = "tears";
	attack_vis_effect = "slash";
	bare_wound_bonus = 5;
	butcher_results = list(/obj/item/food/meat/slab/goliath = 1);
	can_tame = 0;
	health = 35;
	icon = 'icons/mob/simple/lavaland/lavaland_monsters.dmi';
	icon_dead = "goliath_baby_dead";
	icon_living = "goliath_baby";
	icon_state = "goliath_baby";
	maxHealth = 35;
	melee_damage_lower = 1;
	melee_attack_cooldown = 5;
	speed = 0.2;
	wound_bonus = -1;
	icon_gib = "syndicate_gib";
	melee_damage_upper = 2;
	damage_coeff = list("brute" = 1, "burn" = 1, "toxin" = 1, "stamina" = 1, "oxygen" = 1);
	crusher_loot = null
	},
/turf/closed/mineral/random/high_chance/volcanic,
/area/lavaland/surface/outdoors)
"JT" = (
/obj/structure/stone_tile/block,
/obj/structure/stone_tile/block/cracked{
	dir = 1
	},
/turf/closed/mineral/volcanic/lava_land_surface,
/area/lavaland/surface/outdoors)
"Kt" = (
/obj/structure/stone_tile/block/cracked,
/obj/structure/stone_tile/block/burnt{
	dir = 1
	},
/mob/living/basic/mining/goliath,
/turf/closed/mineral/random/high_chance/volcanic,
/area/lavaland/surface/outdoors)
"Kz" = (
/obj/effect/decal/cleanable/dirt,
/turf/open/misc/hay/lavaland,
/area/ruin/unpowered)
"Le" = (
/obj/structure/railing/stone{
	layer = -6
	},
/obj/structure/stone_tile/cracked{
	dir = 8
	},
/obj/item/xenoarch/useless_relic/magnified{
	name = "Ancient relic";
	desc = "Sort of relic that can be exported through Cargo."
	},
/turf/closed/mineral/volcanic/lava_land_surface,
/area/lavaland/surface/outdoors)
"LN" = (
/obj/structure/stone_tile/surrounding,
/obj/structure/stone_tile/center,
/turf/closed/mineral/volcanic/lava_land_surface,
/area/lavaland/surface/outdoors)
"My" = (
/obj/structure/stone_tile/surrounding_tile/cracked{
	dir = 1
	},
/obj/structure/stone_tile/slab/cracked{
	dir = 8
	},
/turf/open/lava/smooth/lava_land_surface,
/area/lavaland/surface/outdoors)
"MD" = (
/obj/structure/railing/stone/left{
	layer = -6
	},
/obj/structure/trap/damage{
	name = "Anctient runic spikes";
	desc = "A strange carving of some symbols. What's that for?";
	icon = 'icons/obj/service/hydroponics/equipment.dmi';
	icon_state = "woodspike";
	light_color = "#DDFFDD";
	color = "#77FF77";
	alpha = 180;
	max_integrity = 30
	},
/turf/closed/mineral/volcanic/lava_land_surface,
/area/lavaland/surface/outdoors)
"MY" = (
/obj/structure/stone_tile/surrounding_tile/cracked{
	dir = 1
	},
/turf/closed/mineral/volcanic/lava_land_surface,
/area/lavaland/surface/outdoors)
"NK" = (
/obj/structure/railing/stone/left{
	layer = -6
	},
/turf/closed/mineral/random/high_chance/volcanic,
/area/lavaland/surface/outdoors)
"Ob" = (
/obj/machinery/hydroponics/soil,
/obj/item/stack/sheet/animalhide/goliath_hide,
/obj/effect/decal/cleanable/dirt,
/turf/open/misc/hay/lavaland,
/area/ruin/unpowered)
"Oq" = (
/obj/item/spear/bonespear,
/obj/effect/decal/cleanable/dirt,
/turf/open/misc/hay/lavaland,
/area/ruin/unpowered)
"OO" = (
/obj/structure/stone_tile/slab,
/turf/closed/mineral/random/high_chance/volcanic,
/area/lavaland/surface/outdoors)
"OQ" = (
/obj/structure/stone_tile/block/cracked,
/obj/structure/stone_tile/block/burnt{
	dir = 1
	},
/obj/effect/decal/cleanable/dirt,
/turf/open/misc/asteroid/basalt/lava_land_surface,
/area/lavaland/surface/outdoors)
"Pk" = (
/obj/structure/stone_tile/block/cracked{
	dir = 1
	},
/turf/closed/mineral/volcanic/lava_land_surface,
/area/lavaland/surface/outdoors)
"Pp" = (
/obj/structure/railing/stone{
	layer = -6
	},
/obj/structure/stone_tile/slab,
/obj/item/xenoarch/useless_relic{
	name = "Ancient relic";
	desc = "Sort of relic that can be exported through Cargo."
	},
/turf/closed/mineral/volcanic/lava_land_surface,
/area/lavaland/surface/outdoors)
"Pq" = (
/obj/structure/stone_tile/slab/cracked{
	dir = 8
	},
/obj/effect/decal/cleanable/dirt,
/turf/open/misc/hay/lavaland,
/area/ruin/unpowered)
"Pr" = (
/obj/structure/stone_tile/block,
/obj/structure/stone_tile/surrounding_tile/cracked{
	dir = 5
	},
/obj/structure/stone_tile/surrounding_tile/cracked{
	dir = 1
	},
/turf/closed/mineral/volcanic/lava_land_surface,
/area/lavaland/surface/outdoors)
"RP" = (
/turf/closed/indestructible/riveted/boss,
/area/lavaland/surface/outdoors)
"TK" = (
/obj/machinery/hydroponics/soil,
/obj/item/stack/sheet/bone,
/obj/effect/decal/cleanable/dirt,
/turf/open/misc/hay/lavaland,
/area/ruin/unpowered)
"UA" = (
/obj/structure/stone_tile/surrounding_tile/cracked{
	dir = 8
	},
/obj/structure/stone_tile/surrounding/cracked{
	dir = 1
	},
/obj/effect/decal/cleanable/dirt,
/obj/structure/punji_sticks/spikes,
/turf/open/misc/asteroid/basalt/lava_land_surface,
/area/ruin/unpowered)
"UY" = (
/obj/structure/stone_tile/surrounding_tile/cracked{
	dir = 4
	},
/turf/closed/mineral/volcanic/lava_land_surface,
/area/lavaland/surface/outdoors)
"Vw" = (
/obj/machinery/hydroponics/soil,
/mob/living/basic/mining/wolf{
	desc = "A baby goliath. Do it. Stomp it.";
	faction = list("mining","boss","hell");
	name = "Biter";
	attack_sound = 'sound/effects/wounds/crackandbleed.ogg';
	attack_verb_continuous = "maniacally tears";
	attack_verb_simple = "tears";
	attack_vis_effect = "slash";
	bare_wound_bonus = 5;
	butcher_results = list(/obj/item/food/meat/slab/goliath = 1);
	can_tame = 0;
	health = 35;
	icon = 'icons/mob/simple/lavaland/lavaland_monsters.dmi';
	icon_dead = "goliath_baby_dead";
	icon_living = "goliath_baby";
	icon_state = "goliath_baby";
	maxHealth = 35;
	melee_damage_lower = 1;
	melee_attack_cooldown = 5;
	speed = 0.2;
	wound_bonus = -1;
	icon_gib = "syndicate_gib";
	melee_damage_upper = 2;
	damage_coeff = list("brute" = 1, "burn" = 1, "toxin" = 1, "stamina" = 1, "oxygen" = 1);
	crusher_loot = null
	},
/turf/closed/mineral/volcanic/lava_land_surface,
/area/ruin/unpowered)
"VL" = (
/obj/structure/railing/stone{
	layer = -6
	},
/obj/structure/stone_tile/slab,
/turf/closed/mineral/volcanic/lava_land_surface,
/area/lavaland/surface/outdoors)
"Xc" = (
/obj/structure/stone_tile/slab,
/mob/living/basic/mining/wolf{
	desc = "A baby goliath. Do it. Stomp it.";
	faction = list("mining","boss","hell");
	name = "Biter";
	attack_sound = 'sound/effects/wounds/crackandbleed.ogg';
	attack_verb_continuous = "maniacally tears";
	attack_verb_simple = "tears";
	attack_vis_effect = "slash";
	bare_wound_bonus = 5;
	butcher_results = list(/obj/item/food/meat/slab/goliath = 1);
	can_tame = 0;
	health = 35;
	icon = 'icons/mob/simple/lavaland/lavaland_monsters.dmi';
	icon_dead = "goliath_baby_dead";
	icon_living = "goliath_baby";
	icon_state = "goliath_baby";
	maxHealth = 35;
	melee_damage_lower = 1;
	melee_attack_cooldown = 5;
	speed = 0.2;
	wound_bonus = -1;
	icon_gib = "syndicate_gib";
	melee_damage_upper = 2;
	damage_coeff = list("brute" = 1, "burn" = 1, "toxin" = 1, "stamina" = 1, "oxygen" = 1);
	crusher_loot = null
	},
/turf/closed/mineral/volcanic/lava_land_surface,
/area/lavaland/surface/outdoors)
"Yh" = (
/obj/structure/stone_tile/slab/cracked{
	dir = 6
	},
/obj/effect/decal/cleanable/dirt,
/turf/open/misc/asteroid/basalt/lava_land_surface,
/area/lavaland/surface/outdoors)
"Yy" = (
/obj/machinery/smartfridge/drying_rack,
/obj/structure/stone_tile/surrounding/cracked{
	dir = 1
	},
/obj/structure/stone_tile/cracked{
	dir = 8
	},
/turf/open/misc/hay/lavaland,
/area/ruin/unpowered)
"ZE" = (
/obj/structure/stone_tile/slab,
/mob/living/basic/mining/goliath,
/turf/closed/mineral/random/high_chance/volcanic,
/area/lavaland/surface/outdoors)

(1,1,1) = {"
cH
cH
cH
cH
NK
UY
Xc
cH
cH
cH
MD
cH
"}
(2,1,1) = {"
cH
cH
zL
My
nx
Kt
JT
fB
nI
zl
my
qu
"}
(3,1,1) = {"
cH
Ef
ql
aF
Le
OO
OO
sn
ze
it
Dm
qu
"}
(4,1,1) = {"
cH
jD
zl
zl
fB
lS
OO
pd
Oq
pd
VL
GK
"}
(5,1,1) = {"
cH
fB
fB
lV
fB
LN
Yh
js
ze
rv
aj
cH
"}
(6,1,1) = {"
Fe
fB
Yy
Pq
Fn
tb
wU
Ob
Kz
Vw
HQ
cH
"}
(7,1,1) = {"
CH
fB
qp
An
UA
jX
xq
TK
iw
fZ
Dm
cH
"}
(8,1,1) = {"
Pk
fB
GP
qd
ya
OQ
Pr
iN
fZ
hV
VL
Ax
"}
(9,1,1) = {"
cH
vx
Ah
kn
BE
Gb
OO
xR
aO
dB
Pp
qu
"}
(10,1,1) = {"
cH
cH
oL
Ah
kr
OO
ZE
iN
BP
TK
El
qu
"}
(11,1,1) = {"
cH
cH
cH
dN
fB
wk
Pk
iN
ms
ab
vF
cH
"}
(12,1,1) = {"
cH
cH
cH
hA
RP
cH
MY
zl
iB
fB
zQ
cH
"}
