//MAP CONVERTED BY dmm2tgm.py THIS HEADER COMMENT PREVENTS RECONVERSION, DO NOT REMOVE
"a" = (
/obj/structure/stone_tile/slab,
/turf/closed/mineral/volcanic/lava_land_surface,
/area/lavaland/surface/outdoors)
"b" = (
/obj/structure/stone_tile/block,
/turf/closed/mineral/random/high_chance/volcanic,
/area/lavaland/surface/outdoors)
"e" = (
/obj/structure/stone_tile,
/mob/living/basic/mining/wolf{
	desc = "A baby goliath. Do it. Stomp it.";
	faction = list("mining","boss","hell");
	name = "Biter";
	attack_sound = 'sound/effects/wounds/crackandbleed.ogg';
	attack_verb_continuous = "maniacally tears";
	attack_verb_simple = "tears";
	attack_vis_effect = "slash";
	bare_wound_bonus = 5;
	butcher_results = list(/obj/item/food/meat/slab/goliath = 1);
	can_tame = 0;
	health = 35;
	icon = 'icons/mob/simple/lavaland/lavaland_monsters.dmi';
	icon_dead = "goliath_baby_dead";
	icon_living = "goliath_baby";
	icon_state = "goliath_baby";
	maxHealth = 35;
	melee_damage_lower = 1;
	melee_attack_cooldown = 5;
	speed = 0.2;
	wound_bonus = -1;
	icon_gib = "syndicate_gib";
	melee_damage_upper = 2;
	damage_coeff = list("brute" = 1, "burn" = 1, "toxin" = 1, "stamina" = 1, "oxygen" = 1);
	crusher_loot = null
	},
/turf/closed/mineral/volcanic/lava_land_surface,
/area/lavaland/surface/outdoors)
"h" = (
/obj/structure/stone_tile/block{
	dir = 8
	},
/turf/closed/mineral/volcanic/lava_land_surface,
/area/lavaland/surface/outdoors)
"i" = (
/obj/structure/stone_tile{
	dir = 8
	},
/turf/closed/mineral/random/high_chance/volcanic,
/area/lavaland/surface/outdoors)
"k" = (
/obj/structure/stone_tile/surrounding/cracked,
/mob/living/basic/mining/wolf{
	desc = "A baby goliath. Do it. Stomp it.";
	faction = list("mining","boss","hell");
	name = "Biter";
	attack_sound = 'sound/effects/wounds/crackandbleed.ogg';
	attack_verb_continuous = "maniacally tears";
	attack_verb_simple = "tears";
	attack_vis_effect = "slash";
	bare_wound_bonus = 5;
	butcher_results = list(/obj/item/food/meat/slab/goliath = 1);
	can_tame = 0;
	health = 35;
	icon = 'icons/mob/simple/lavaland/lavaland_monsters.dmi';
	icon_dead = "goliath_baby_dead";
	icon_living = "goliath_baby";
	icon_state = "goliath_baby";
	maxHealth = 35;
	melee_damage_lower = 1;
	melee_attack_cooldown = 5;
	speed = 0.2;
	wound_bonus = -1;
	icon_gib = "syndicate_gib";
	melee_damage_upper = 2;
	damage_coeff = list("brute" = 1, "burn" = 1, "toxin" = 1, "stamina" = 1, "oxygen" = 1);
	crusher_loot = null
	},
/mob/living/basic/mining/wolf{
	desc = "A baby goliath. Do it. Stomp it.";
	faction = list("mining","boss","hell");
	name = "Biter";
	attack_sound = 'sound/effects/wounds/crackandbleed.ogg';
	attack_verb_continuous = "maniacally tears";
	attack_verb_simple = "tears";
	attack_vis_effect = "slash";
	bare_wound_bonus = 5;
	butcher_results = list(/obj/item/food/meat/slab/goliath = 1);
	can_tame = 0;
	health = 35;
	icon = 'icons/mob/simple/lavaland/lavaland_monsters.dmi';
	icon_dead = "goliath_baby_dead";
	icon_living = "goliath_baby";
	icon_state = "goliath_baby";
	maxHealth = 35;
	melee_damage_lower = 1;
	melee_attack_cooldown = 5;
	speed = 0.2;
	wound_bonus = -1;
	icon_gib = "syndicate_gib";
	melee_damage_upper = 2;
	damage_coeff = list("brute" = 1, "burn" = 1, "toxin" = 1, "stamina" = 1, "oxygen" = 1);
	crusher_loot = null
	},
/mob/living/basic/mining/wolf{
	desc = "A baby goliath. Do it. Stomp it.";
	faction = list("mining","boss","hell");
	name = "Biter";
	attack_sound = 'sound/effects/wounds/crackandbleed.ogg';
	attack_verb_continuous = "maniacally tears";
	attack_verb_simple = "tears";
	attack_vis_effect = "slash";
	bare_wound_bonus = 5;
	butcher_results = list(/obj/item/food/meat/slab/goliath = 1);
	can_tame = 0;
	health = 35;
	icon = 'icons/mob/simple/lavaland/lavaland_monsters.dmi';
	icon_dead = "goliath_baby_dead";
	icon_living = "goliath_baby";
	icon_state = "goliath_baby";
	maxHealth = 35;
	melee_damage_lower = 1;
	melee_attack_cooldown = 5;
	speed = 0.2;
	wound_bonus = -1;
	icon_gib = "syndicate_gib";
	melee_damage_upper = 2;
	damage_coeff = list("brute" = 1, "burn" = 1, "toxin" = 1, "stamina" = 1, "oxygen" = 1);
	crusher_loot = null
	},
/turf/closed/mineral/random/high_chance/volcanic,
/area/lavaland/surface/outdoors)
"l" = (
/turf/template_noop,
/area/template_noop)
"r" = (
/obj/effect/mapping_helpers/bombable_wall,
/turf/closed/indestructible/riveted/boss/wasteland,
/area/lavaland/surface/outdoors)
"t" = (
/obj/structure/stone_tile/slab,
/mob/living/basic/mining/goliath,
/turf/closed/mineral/random/high_chance/volcanic,
/area/lavaland/surface/outdoors)
"v" = (
/obj/structure/trap/fire{
	name = "Anctient runic spikes";
	desc = "A strange carving of some symbols. What's that for?";
	alpha = 180;
	icon = 'icons/obj/service/hydroponics/equipment.dmi';
	icon_state = "woodspike";
	light_color = "#FF1111";
	color = "#FF1111"
	},
/turf/closed/mineral/volcanic/lava_land_surface,
/area/lavaland/surface/outdoors)
"y" = (
/obj/structure/stone_tile/block,
/obj/structure/trap/damage{
	name = "Anctient runic spikes";
	desc = "A strange carving of some symbols. What's that for?";
	icon = 'icons/obj/service/hydroponics/equipment.dmi';
	icon_state = "woodspike";
	light_color = "#DDFFDD";
	color = "#77FF77";
	alpha = 180
	},
/turf/closed/mineral/random/high_chance/volcanic,
/area/lavaland/surface/outdoors)
"F" = (
/obj/structure/stone_tile{
	dir = 1
	},
/obj/item/xenoarch/useless_relic{
	name = "Ancient relic";
	desc = "Sort of relic that can be exported through Cargo."
	},
/turf/closed/mineral/random/high_chance/volcanic,
/area/lavaland/surface/outdoors)
"H" = (
/obj/structure/stone_tile/slab/cracked{
	dir = 10
	},
/obj/structure/stone_tile/slab/cracked{
	dir = 8
	},
/obj/structure/punji_sticks/spikes,
/turf/closed/mineral/volcanic/lava_land_surface,
/area/lavaland/surface/outdoors)
"J" = (
/obj/structure/stone_tile/block/cracked,
/turf/closed/mineral/volcanic/lava_land_surface,
/area/lavaland/surface/outdoors)
"Q" = (
/turf/closed/indestructible/riveted/boss,
/area/lavaland/surface/outdoors)
"R" = (
/obj/structure/stone_tile/block/cracked,
/obj/structure/punji_sticks/spikes,
/turf/closed/mineral/volcanic/lava_land_surface,
/area/lavaland/surface/outdoors)
"S" = (
/obj/structure/stone_tile/slab/cracked{
	dir = 1
	},
/obj/structure/stone_tile/slab/cracked{
	dir = 4
	},
/turf/closed/mineral/volcanic/lava_land_surface,
/area/lavaland/surface/outdoors)
"U" = (
/obj/structure/stone_tile/surrounding/cracked,
/mob/living/basic/mining/goliath,
/turf/closed/mineral/random/high_chance/volcanic,
/area/lavaland/surface/outdoors)
"V" = (
/obj/structure/stone_tile/block{
	dir = 4
	},
/obj/structure/stone_tile/burnt{
	dir = 8
	},
/turf/closed/mineral/random/high_chance/volcanic,
/area/lavaland/surface/outdoors)
"W" = (
/turf/closed/mineral/volcanic/lava_land_surface,
/area/lavaland/surface/outdoors)
"X" = (
/obj/structure/stone_tile/surrounding,
/obj/structure/stone_tile/center/cracked,
/turf/closed/mineral/random/high_chance/volcanic,
/area/lavaland/surface/outdoors)

(1,1,1) = {"
Q
l
l
h
v
h
l
l
l
"}
(2,1,1) = {"
Q
R
l
Q
Q
Q
t
W
l
"}
(3,1,1) = {"
Q
b
l
V
F
r
X
Q
J
"}
(4,1,1) = {"
r
i
U
a
k
H
l
Q
y
"}
(5,1,1) = {"
Q
Q
a
Q
S
l
l
Q
e
"}
