//MAP CONVERTED BY dmm2tgm.py THIS HEADER COMMENT PREVENTS RECONVERSION, DO NOT REMOVE
"a" = (
/turf/closed/mineral/volcanic/lava_land_surface,
/area/lavaland/surface/outdoors)
"d" = (
/mob/living/basic/mining/lobstrosity/lava,
/turf/open/misc/asteroid/basalt/lava_land_surface,
/area/lavaland/surface/outdoors)
"j" = (
/obj/item/fishing_rod/bone{
	pixel_x = 11;
	pixel_y = -5
	},
/mob/living/basic/mining/lobstrosity/lava{
	name = "Big Armored Daddy Chomper";
	desc = "Damn... That's a big one.";
	current_size = 2;
	speed = -0.5;
	health = 900;
	melee_damage_lower = 30;
	melee_damage_upper = 60;
	obj_damage = 60;
	damage_coeff = list("brute" = 1, "burn" = 1, "toxin" = 1, "stamina" = 1, "oxygen" = 1);
	maxHealth = 900;
	butcher_results = null;
	guaranteed_butcher_results = list(/obj/item/food/meat/slab/rawcrab = 16, /obj/item/stack/sheet/bone = 4, /obj/item/organ/internal/monster_core/rush_gland = 1,/obj/item/crusher_trophy/lobster_claw=1);
	base_pixel_y = -32
	},
/obj/effect/spawner/random/structure/orevein_longregen,
/turf/open/misc/asteroid/basalt/lava_land_surface,
/area/lavaland/surface/outdoors)
"k" = (
/obj/effect/spawner/random/structure/orevein_longregen,
/turf/open/misc/asteroid/basalt/lava_land_surface,
/area/lavaland/surface/outdoors)
"l" = (
/turf/template_noop,
/area/template_noop)
"o" = (
/obj/structure/flora/ash/stem_shroom,
/turf/open/misc/asteroid/basalt/lava_land_surface,
/area/lavaland/surface/outdoors)
"q" = (
/mob/living/basic/mining/lobstrosity/lava,
/turf/closed/mineral/volcanic/lava_land_surface,
/area/lavaland/surface/outdoors)
"v" = (
/turf/open/misc/asteroid/basalt/lava_land_surface,
/area/lavaland/surface/outdoors)
"x" = (
/obj/structure/flora/ash/seraka,
/turf/closed/mineral/volcanic/lava_land_surface,
/area/lavaland/surface/outdoors)
"y" = (
/obj/structure/flora/rock/pile/style_random,
/mob/living/basic/mining/lobstrosity/lava,
/turf/closed/mineral/volcanic/lava_land_surface,
/area/lavaland/surface/outdoors)
"B" = (
/obj/item/chair/wood{
	pixel_x = 4;
	pixel_y = -6
	},
/turf/open/misc/asteroid/basalt/lava_land_surface,
/area/lavaland/surface/outdoors)
"C" = (
/obj/structure/flora/ash/cacti,
/turf/open/misc/asteroid/basalt/lava_land_surface,
/area/lavaland/surface/outdoors)
"G" = (
/obj/structure/flora/rock/pile/style_random,
/turf/open/misc/asteroid/basalt/lava_land_surface,
/area/lavaland/surface/outdoors)
"K" = (
/obj/item/fishing_hook/rescue{
	pixel_x = -14;
	pixel_y = -15
	},
/obj/effect/spawner/random/structure/orevein_longregen,
/turf/open/misc/asteroid/basalt/lava_land_surface,
/area/lavaland/surface/outdoors)
"L" = (
/obj/item/reagent_containers/cup/bucket/wooden{
	pixel_x = 9;
	pixel_y = 8
	},
/obj/effect/spawner/random/structure/orevein_longregen,
/turf/open/misc/asteroid/basalt/lava_land_surface,
/area/lavaland/surface/outdoors)
"N" = (
/obj/structure/ore_vein,
/obj/item/xenoarch/useless_relic/magnified{
	name = "Ancient relic";
	desc = "Sort of relic that can be exported through Cargo."
	},
/turf/open/misc/asteroid/basalt/lava_land_surface,
/area/lavaland/surface/outdoors)
"P" = (
/obj/item/fishing_line/sinew{
	pixel_x = 8;
	pixel_y = 5
	},
/obj/effect/spawner/random/structure/orevein_longregen,
/turf/open/misc/asteroid/basalt/lava_land_surface,
/area/lavaland/surface/outdoors)
"Q" = (
/obj/structure/flora/rock/pile/style_random,
/turf/closed/mineral/volcanic/lava_land_surface,
/area/lavaland/surface/outdoors)
"U" = (
/obj/effect/spawner/random/structure/orevein_longregen,
/turf/closed/mineral/volcanic/lava_land_surface,
/area/lavaland/surface/outdoors)
"X" = (
/turf/open/lava/smooth/lava_land_surface,
/area/lavaland/surface/outdoors)

(1,1,1) = {"
l
U
a
a
a
U
a
U
l
l
l
l
"}
(2,1,1) = {"
l
Q
X
a
d
a
a
U
x
l
l
l
"}
(3,1,1) = {"
U
a
X
X
X
X
G
U
a
q
l
l
"}
(4,1,1) = {"
a
C
k
X
X
X
X
X
v
a
U
l
"}
(5,1,1) = {"
U
a
G
X
X
P
X
X
X
G
U
l
"}
(6,1,1) = {"
a
U
X
X
N
j
k
X
X
k
a
a
"}
(7,1,1) = {"
U
a
d
X
X
K
L
X
X
d
C
a
"}
(8,1,1) = {"
a
a
X
X
X
X
B
N
X
X
k
U
"}
(9,1,1) = {"
l
U
a
X
X
X
X
X
X
X
X
a
"}
(10,1,1) = {"
l
a
a
y
v
X
X
X
X
X
G
U
"}
(11,1,1) = {"
l
l
a
U
a
o
k
d
X
a
U
a
"}
(12,1,1) = {"
l
l
l
l
a
a
U
a
a
U
a
l
"}
