//MAP CONVERTED BY dmm2tgm.py THIS HEADER COMMENT PREVENTS RECONVERSION, DO NOT REMOVE
"a" = (
/turf/template_noop,
/area/template_noop)
"c" = (
/obj/structure/stone_tile{
	dir = 8
	},
/obj/structure/stone_tile{
	dir = 1
	},
/obj/structure/stone_tile/cracked{
	dir = 4
	},
/turf/closed/mineral/volcanic/lava_land_surface,
/area/lavaland/surface/outdoors)
"d" = (
/obj/structure/stone_tile/block/cracked{
	dir = 8
	},
/obj/effect/spawner/random/mob/necropolis_mob,
/turf/closed/mineral/volcanic/lava_land_surface,
/area/lavaland/surface/outdoors)
"e" = (
/obj/effect/spawner/random/structure/spikes,
/turf/closed/mineral/volcanic/lava_land_surface,
/area/lavaland/surface/outdoors)
"f" = (
/obj/structure/stone_tile/slab/burnt,
/turf/closed/mineral/volcanic/lava_land_surface,
/area/lavaland/surface/outdoors)
"g" = (
/obj/structure/stone_tile/burnt,
/turf/closed/mineral/volcanic/lava_land_surface,
/area/lavaland/surface/outdoors)
"h" = (
/obj/structure/stone_tile{
	dir = 4
	},
/turf/closed/mineral/volcanic/lava_land_surface,
/area/lavaland/surface/outdoors)
"i" = (
/obj/structure/flora/rock/style_random,
/turf/closed/mineral/volcanic/lava_land_surface,
/area/lavaland/surface/outdoors)
"j" = (
/obj/structure/flora/rock/pile/style_random,
/turf/closed/mineral/volcanic/lava_land_surface,
/area/lavaland/surface/outdoors)
"k" = (
/obj/structure/stone_tile/block{
	dir = 1
	},
/turf/closed/mineral/volcanic/lava_land_surface,
/area/lavaland/surface/outdoors)
"l" = (
/obj/structure/stone_tile/block/cracked,
/obj/effect/spawner/random/mob/necropolis_mob,
/turf/closed/mineral/volcanic/lava_land_surface,
/area/lavaland/surface/outdoors)
"o" = (
/obj/structure/stone_tile/slab,
/obj/item/xenoarch/useless_relic{
	name = "Ancient relic";
	desc = "Sort of relic that can be exported through Cargo."
	},
/turf/closed/mineral/volcanic/lava_land_surface,
/area/lavaland/surface/outdoors)
"p" = (
/obj/structure/stone_tile/block/cracked{
	dir = 1
	},
/turf/closed/mineral/volcanic/lava_land_surface,
/area/lavaland/surface/outdoors)
"q" = (
/turf/closed/indestructible/riveted/boss,
/area/lavaland/surface/outdoors)
"r" = (
/obj/structure/stone_tile{
	dir = 8
	},
/turf/closed/mineral/volcanic/lava_land_surface,
/area/lavaland/surface/outdoors)
"s" = (
/obj/structure/stone_tile/slab/cracked{
	dir = 5
	},
/obj/structure/stone_tile/slab/cracked{
	dir = 10
	},
/turf/closed/mineral/volcanic/lava_land_surface,
/area/lavaland/surface/outdoors)
"u" = (
/obj/structure/stone_tile,
/obj/item/xenoarch/useless_relic/magnified{
	name = "Ancient relic";
	desc = "Sort of relic that can be exported through Cargo."
	},
/turf/closed/mineral/volcanic/lava_land_surface,
/area/lavaland/surface/outdoors)
"v" = (
/obj/structure/stone_tile/cracked{
	dir = 4
	},
/obj/effect/spawner/random/mob/necropolis_mob,
/turf/closed/mineral/volcanic/lava_land_surface,
/area/lavaland/surface/outdoors)
"w" = (
/obj/structure/stone_tile/surrounding/cracked{
	dir = 6
	},
/turf/closed/mineral/volcanic/lava_land_surface,
/area/lavaland/surface/outdoors)
"x" = (
/obj/structure/stone_tile/slab/cracked{
	dir = 6
	},
/turf/closed/mineral/volcanic/lava_land_surface,
/area/lavaland/surface/outdoors)
"y" = (
/obj/structure/stone_tile/slab,
/turf/closed/mineral/volcanic/lava_land_surface,
/area/lavaland/surface/outdoors)
"z" = (
/obj/structure/stone_tile/block/burnt,
/obj/effect/spawner/random/structure/spikes,
/turf/closed/mineral/volcanic/lava_land_surface,
/area/lavaland/surface/outdoors)
"A" = (
/obj/structure/stone_tile/slab,
/obj/effect/spawner/random/mob/necropolis_mob,
/turf/closed/mineral/volcanic/lava_land_surface,
/area/lavaland/surface/outdoors)
"B" = (
/obj/structure/stone_tile/surrounding_tile,
/obj/structure/stone_tile/surrounding_tile{
	dir = 4
	},
/turf/closed/mineral/volcanic/lava_land_surface,
/area/lavaland/surface/outdoors)
"C" = (
/turf/closed/mineral/volcanic/lava_land_surface,
/area/lavaland/surface/outdoors)
"E" = (
/obj/structure/stone_tile/surrounding/burnt,
/obj/structure/stone_tile/center/burnt,
/turf/closed/mineral/volcanic/lava_land_surface,
/area/lavaland/surface/outdoors)
"F" = (
/obj/structure/stone_tile/block/burnt,
/obj/structure/stone_tile/block/cracked{
	dir = 1
	},
/turf/closed/mineral/volcanic/lava_land_surface,
/area/lavaland/surface/outdoors)
"G" = (
/obj/structure/railing/stone/right{
	layer = -6
	},
/obj/effect/spawner/random/structure/spikes,
/turf/closed/mineral/volcanic/lava_land_surface,
/area/lavaland/surface/outdoors)
"H" = (
/obj/structure/stone_tile/surrounding_tile,
/obj/effect/spawner/random/mob/necropolis_mob,
/turf/closed/mineral/volcanic/lava_land_surface,
/area/lavaland/surface/outdoors)
"I" = (
/obj/structure/stone_tile/surrounding_tile{
	dir = 1
	},
/turf/closed/mineral/volcanic/lava_land_surface,
/area/lavaland/surface/outdoors)
"J" = (
/obj/structure/stone_tile/surrounding/cracked,
/turf/closed/mineral/volcanic/lava_land_surface,
/area/lavaland/surface/outdoors)
"K" = (
/obj/structure/stone_tile/slab/burnt,
/obj/item/reagent_containers/cup/bowl/wood_bowl,
/turf/closed/mineral/volcanic/lava_land_surface,
/area/lavaland/surface/outdoors)
"L" = (
/obj/structure/stone_tile/block,
/obj/item/xenoarch/useless_relic{
	name = "Ancient relic";
	desc = "Sort of relic that can be exported through Cargo."
	},
/obj/effect/spawner/random/mob/necropolis_mob,
/turf/closed/mineral/volcanic/lava_land_surface,
/area/lavaland/surface/outdoors)
"N" = (
/obj/structure/stone_tile{
	dir = 1
	},
/obj/structure/railing/stone/left{
	layer = -6
	},
/turf/closed/mineral/volcanic/lava_land_surface,
/area/lavaland/surface/outdoors)
"P" = (
/obj/structure/stone_tile{
	dir = 8
	},
/obj/structure/stone_tile/burnt,
/obj/structure/stone_tile/cracked{
	dir = 4
	},
/turf/closed/mineral/volcanic/lava_land_surface,
/area/lavaland/surface/outdoors)
"Q" = (
/obj/structure/railing/stone{
	layer = -6
	},
/turf/closed/mineral/volcanic/lava_land_surface,
/area/lavaland/surface/outdoors)
"R" = (
/obj/structure/stone_tile{
	dir = 8
	},
/obj/structure/stone_tile{
	dir = 1
	},
/obj/structure/stone_tile/burnt,
/turf/closed/mineral/volcanic/lava_land_surface,
/area/lavaland/surface/outdoors)
"T" = (
/obj/structure/ore_vein,
/turf/closed/mineral/volcanic/lava_land_surface,
/area/lavaland/surface/outdoors)
"U" = (
/obj/structure/stone_tile/block/cracked{
	dir = 1
	},
/obj/effect/spawner/random/mob/necropolis_mob,
/turf/closed/mineral/volcanic/lava_land_surface,
/area/lavaland/surface/outdoors)
"V" = (
/obj/structure/stone_tile/block,
/obj/effect/spawner/random/structure/spikes,
/turf/closed/mineral/volcanic/lava_land_surface,
/area/lavaland/surface/outdoors)
"W" = (
/obj/structure/stone_tile/block{
	dir = 8
	},
/obj/structure/stone_tile/block/burnt{
	dir = 4
	},
/turf/closed/mineral/volcanic/lava_land_surface,
/area/lavaland/surface/outdoors)
"X" = (
/obj/structure/railing/stone{
	layer = -6
	},
/obj/effect/spawner/random/structure/spikes,
/turf/closed/mineral/volcanic/lava_land_surface,
/area/lavaland/surface/outdoors)
"Y" = (
/obj/structure/stone_tile/surrounding_tile{
	dir = 4
	},
/obj/structure/stone_tile/surrounding_tile,
/obj/structure/stone_tile/center/burnt,
/turf/closed/mineral/volcanic/lava_land_surface,
/area/lavaland/surface/outdoors)
"Z" = (
/obj/structure/stone_tile/surrounding/cracked{
	dir = 1
	},
/turf/closed/mineral/volcanic/lava_land_surface,
/area/lavaland/surface/outdoors)

(1,1,1) = {"
a
a
v
j
a
a
a
a
B
a
a
a
"}
(2,1,1) = {"
a
q
q
p
k
y
a
z
I
Y
a
a
"}
(3,1,1) = {"
q
q
o
a
V
g
i
C
d
W
a
a
"}
(4,1,1) = {"
d
a
a
a
Z
x
e
I
K
j
H
a
"}
(5,1,1) = {"
a
a
a
a
a
q
q
j
P
r
N
a
"}
(6,1,1) = {"
a
a
a
a
a
a
q
u
T
f
Q
T
"}
(7,1,1) = {"
a
a
a
a
a
a
q
q
J
E
X
h
"}
(8,1,1) = {"
q
l
a
a
a
a
U
w
C
x
X
a
"}
(9,1,1) = {"
q
q
a
a
a
a
a
a
p
F
Q
a
"}
(10,1,1) = {"
p
q
L
a
a
a
a
a
a
A
Q
a
"}
(11,1,1) = {"
a
q
q
a
a
a
a
a
c
R
Q
a
"}
(12,1,1) = {"
a
a
a
a
a
a
a
a
s
a
G
a
"}
