//MAP CONVERTED BY dmm2tgm.py THIS HEADER COMMENT PREVENTS RECONVERSION, DO NOT REMOVE
"a" = (
/obj/effect/spawner/random/structure/spikes,
/turf/closed/mineral/volcanic/lava_land_surface,
/area/lavaland/surface/outdoors)
"f" = (
/obj/structure/stone_tile/block/cracked,
/obj/effect/spawner/random/mob/brimdemon,
/turf/closed/mineral/random/high_chance/volcanic,
/area/lavaland/surface/outdoors)
"g" = (
/turf/template_noop,
/area/template_noop)
"l" = (
/obj/structure/stone_tile/block,
/obj/effect/spawner/random/structure/spikes,
/turf/closed/mineral/volcanic/lava_land_surface,
/area/lavaland/surface/outdoors)
"m" = (
/obj/structure/stone_tile/block/cracked,
/obj/effect/spawner/random/structure/spikes,
/turf/closed/mineral/volcanic/lava_land_surface,
/area/lavaland/surface/outdoors)
"p" = (
/obj/structure/stone_tile/block/cracked{
	dir = 1
	},
/turf/closed/mineral/volcanic/lava_land_surface,
/area/lavaland/surface/outdoors)
"q" = (
/turf/closed/indestructible/riveted/boss,
/area/lavaland/surface/outdoors)
"x" = (
/obj/effect/mapping_helpers/bombable_wall,
/turf/closed/indestructible/riveted/boss/wasteland,
/area/lavaland/surface/outdoors)
"y" = (
/obj/structure/stone_tile/block,
/obj/effect/spawner/random/mob/brimdemon,
/turf/closed/mineral/volcanic/lava_land_surface,
/area/lavaland/surface/outdoors)
"z" = (
/obj/structure/stone_tile/block,
/obj/effect/spawner/random/structure/spikes,
/turf/closed/mineral/random/high_chance/volcanic,
/area/lavaland/surface/outdoors)
"C" = (
/obj/structure/flora/rock/pile/style_random,
/obj/effect/spawner/random/structure/spikes,
/turf/closed/mineral/volcanic/lava_land_surface,
/area/lavaland/surface/outdoors)
"F" = (
/obj/structure/stone_tile/block,
/obj/structure/stone_tile/block,
/obj/structure/stone_tile/block,
/obj/effect/spawner/random/mob/brimdemon,
/turf/closed/mineral/random/high_chance/volcanic,
/area/lavaland/surface/outdoors)
"I" = (
/obj/structure/stone_tile/block{
	dir = 1
	},
/turf/closed/mineral/volcanic/lava_land_surface,
/area/lavaland/surface/outdoors)
"L" = (
/obj/structure/stone_tile/block{
	dir = 1
	},
/obj/effect/spawner/random/mob/brimdemon,
/turf/closed/mineral/random/high_chance/volcanic,
/area/lavaland/surface/outdoors)
"U" = (
/obj/effect/spawner/random/structure/spikes,
/turf/closed/mineral/random/high_chance/volcanic,
/area/lavaland/surface/outdoors)
"V" = (
/obj/structure/stone_tile/block/cracked{
	dir = 1
	},
/obj/effect/spawner/random/mob/brimdemon,
/turf/closed/mineral/volcanic/lava_land_surface,
/area/lavaland/surface/outdoors)
"X" = (
/obj/structure/stone_tile/block/cracked{
	dir = 1
	},
/obj/effect/spawner/random/mob/brimdemon,
/turf/closed/mineral/random/high_chance/volcanic,
/area/lavaland/surface/outdoors)
"Y" = (
/obj/structure/stone_tile/block/cracked{
	dir = 1
	},
/obj/item/xenoarch/useless_relic/magnified{
	name = "Ancient relic";
	desc = "Sort of relic that can be exported through Cargo."
	},
/obj/effect/spawner/random/structure/spikes,
/turf/closed/mineral/volcanic/lava_land_surface,
/area/lavaland/surface/outdoors)

(1,1,1) = {"
g
q
C
"}
(2,1,1) = {"
g
q
q
"}
(3,1,1) = {"
q
q
q
"}
(4,1,1) = {"
q
q
q
"}
(5,1,1) = {"
I
q
l
"}
(6,1,1) = {"
V
q
z
"}
(7,1,1) = {"
g
q
f
"}
(8,1,1) = {"
q
x
g
"}
(9,1,1) = {"
x
g
g
"}
(10,1,1) = {"
q
q
q
"}
(11,1,1) = {"
g
q
C
"}
(12,1,1) = {"
L
x
m
"}
(13,1,1) = {"
Y
q
F
"}
(14,1,1) = {"
q
q
q
"}
(15,1,1) = {"
g
q
q
"}
(16,1,1) = {"
g
q
q
"}
(17,1,1) = {"
p
q
U
"}
(18,1,1) = {"
X
U
g
"}
(19,1,1) = {"
a
q
g
"}
(20,1,1) = {"
q
q
q
"}
(21,1,1) = {"
q
q
g
"}
(22,1,1) = {"
q
q
g
"}
(23,1,1) = {"
U
q
y
"}
(24,1,1) = {"
C
q
g
"}
