//MAP CONVERTED BY dmm2tgm.py THIS HEADER COMMENT PREVENTS RECONVERSION, DO NOT REMOVE
"c" = (
/obj/structure/table_frame/wood,
/obj/structure/stone_tile/block/cracked,
/obj/item/xenoarch/useless_relic/magnified{
	name = "Ancient relic";
	desc = "Sort of relic that can be exported through Cargo."
	},
/turf/open/misc/asteroid/basalt/lava_land_surface,
/area/ruin/unpowered)
"d" = (
/obj/structure/flora/rock/pile/style_random,
/turf/closed/mineral/volcanic/lava_land_surface,
/area/lavaland/surface/outdoors)
"e" = (
/obj/structure/stone_tile/slab/cracked,
/obj/structure/trap/cult,
/obj/item/reagent_containers/cup/bucket/wooden{
	pixel_x = 9;
	pixel_y = -7
	},
/turf/open/misc/asteroid/basalt/lava_land_surface,
/area/ruin/unpowered)
"f" = (
/obj/effect/spawner/random/engineering/tool_advanced,
/obj/effect/decal/cleanable/ash{
	pixel_x = -15;
	pixel_y = -3
	},
/obj/item/toy/plush/narplush,
/obj/effect/decal/cleanable/dirt,
/turf/open/floor/engine/cult{
	initial_gas_mix = "LAVALAND_ATMOS"
	},
/area/ruin/unpowered)
"g" = (
/obj/structure/stone_tile/cracked{
	dir = 4
	},
/turf/closed/mineral/volcanic/lava_land_surface,
/area/lavaland/surface/outdoors)
"h" = (
/obj/structure/flora/rock/pile/style_random,
/turf/closed/mineral/volcanic/lava_land_surface,
/area/ruin/unpowered)
"i" = (
/obj/structure/stone_tile/surrounding,
/obj/structure/stone_tile/center,
/obj/structure/trap/cult,
/turf/open/misc/asteroid/basalt/lava_land_surface,
/area/ruin/unpowered)
"l" = (
/obj/structure/flora/rock/pile/style_random,
/obj/item/xenoarch/useless_relic{
	name = "Ancient relic";
	desc = "Sort of relic that can be exported through Cargo."
	},
/turf/closed/mineral/random/high_chance/volcanic,
/area/lavaland/surface/outdoors)
"n" = (
/obj/structure/stone_tile/block/cracked{
	dir = 4
	},
/turf/closed/mineral/random/high_chance/volcanic,
/area/ruin/unpowered)
"o" = (
/obj/effect/mapping_helpers/bombable_wall,
/turf/closed/indestructible/riveted/boss/wasteland,
/area/lavaland/surface/outdoors)
"p" = (
/turf/template_noop,
/area/template_noop)
"r" = (
/turf/closed/indestructible/cult,
/area/ruin/unpowered)
"s" = (
/obj/structure/stone_tile/block/cracked{
	dir = 1
	},
/turf/closed/mineral/random/high_chance/volcanic,
/area/lavaland/surface/outdoors)
"u" = (
/obj/item/clothing/suit/chaplainsuit/whiterobe{
	pixel_x = 13;
	pixel_y = 9
	},
/obj/structure/stone_tile{
	dir = 8
	},
/obj/structure/stone_tile{
	dir = 4
	},
/obj/structure/stone_tile{
	dir = 1
	},
/turf/open/misc/asteroid/basalt/lava_land_surface,
/area/ruin/unpowered)
"v" = (
/obj/structure/stone_tile/cracked{
	dir = 8
	},
/obj/item/xenoarch/useless_relic{
	name = "Ancient relic";
	desc = "Sort of relic that can be exported through Cargo."
	},
/turf/closed/mineral/volcanic/lava_land_surface,
/area/lavaland/surface/outdoors)
"w" = (
/mob/living/basic/construct/proteon/hostile,
/obj/effect/decal/cleanable/dirt,
/turf/open/floor/engine/cult{
	initial_gas_mix = "LAVALAND_ATMOS"
	},
/area/ruin/unpowered)
"y" = (
/obj/structure/flora/rock/pile/style_random,
/obj/effect/spawner/random/structure/spikes,
/turf/closed/mineral/volcanic/lava_land_surface,
/area/lavaland/surface/outdoors)
"A" = (
/obj/structure/destructible/cult/pylon,
/turf/open/floor/engine/cult{
	initial_gas_mix = "LAVALAND_ATMOS"
	},
/area/ruin/unpowered)
"B" = (
/obj/effect/decal/cleanable/dirt,
/turf/open/floor/engine/cult{
	initial_gas_mix = "LAVALAND_ATMOS"
	},
/area/ruin/unpowered)
"C" = (
/obj/effect/decal/cleanable/ash{
	pixel_y = -7;
	pixel_x = 4
	},
/mob/living/basic/construct/proteon/hostile,
/obj/effect/decal/cleanable/dirt,
/turf/open/floor/engine/cult{
	initial_gas_mix = "LAVALAND_ATMOS"
	},
/area/ruin/unpowered)
"E" = (
/obj/structure/stone_tile{
	dir = 1
	},
/obj/structure/stone_tile{
	dir = 4
	},
/obj/structure/stone_tile{
	dir = 8
	},
/turf/open/floor/engine/cult{
	initial_gas_mix = "LAVALAND_ATMOS"
	},
/area/ruin/unpowered)
"F" = (
/obj/structure/stone_tile/cracked{
	dir = 8
	},
/obj/effect/spawner/random/structure/spikes,
/turf/closed/mineral/volcanic/lava_land_surface,
/area/lavaland/surface/outdoors)
"G" = (
/obj/effect/spawner/random/structure/spikes,
/turf/closed/mineral/volcanic/lava_land_surface,
/area/lavaland/surface/outdoors)
"I" = (
/obj/structure/stone_tile/surrounding/burnt,
/obj/structure/stone_tile/center/burnt,
/turf/open/misc/asteroid/basalt/lava_land_surface,
/area/ruin/unpowered)
"J" = (
/obj/effect/spawner/random/structure/spikes,
/turf/closed/mineral/random/high_chance/volcanic,
/area/lavaland/surface/outdoors)
"K" = (
/obj/item/flashlight/flare/torch{
	pixel_x = -8
	},
/obj/effect/decal/cleanable/ash,
/turf/open/floor/engine/cult{
	initial_gas_mix = "LAVALAND_ATMOS"
	},
/area/ruin/unpowered)
"L" = (
/obj/structure/stone_tile/surrounding/cracked,
/obj/structure/stone_tile/center/cracked,
/obj/item/chair/wood,
/turf/closed/mineral/volcanic/lava_land_surface,
/area/ruin/unpowered)
"M" = (
/obj/structure/stone_tile{
	dir = 4
	},
/obj/structure/stone_tile/slab/cracked{
	dir = 1
	},
/turf/closed/mineral/random/high_chance/volcanic,
/area/ruin/unpowered)
"N" = (
/obj/structure/stone_tile/cracked{
	dir = 8
	},
/obj/structure/stone_tile,
/obj/structure/stone_tile{
	dir = 1
	},
/turf/closed/mineral/random/high_chance/volcanic,
/area/ruin/unpowered)
"O" = (
/obj/structure/stone_tile/block/cracked{
	dir = 1
	},
/turf/open/misc/asteroid/basalt/lava_land_surface,
/area/ruin/unpowered)
"P" = (
/obj/structure/stone_tile/cracked{
	dir = 4
	},
/obj/structure/stone_tile/surrounding_tile,
/turf/open/misc/asteroid/basalt/lava_land_surface,
/area/ruin/unpowered)
"Q" = (
/obj/effect/decal/cleanable/grand_remains,
/obj/effect/decal/cleanable/blood/old,
/obj/effect/mob_spawn/corpse/human/miner,
/obj/effect/gibspawner/human/bodypartless,
/obj/effect/spawner/random/engineering/material_rare,
/obj/item/organ/internal/liver,
/mob/living/basic/faithless{
	faction = list("cult")
	},
/obj/item/raw_anomaly_core/bluespace,
/obj/effect/decal/cleanable/dirt,
/turf/open/floor/engine/cult{
	initial_gas_mix = "LAVALAND_ATMOS"
	},
/area/ruin/unpowered)
"V" = (
/obj/structure/stone_tile/cracked{
	dir = 8
	},
/obj/structure/stone_tile/surrounding_tile,
/turf/open/misc/asteroid/basalt/lava_land_surface,
/area/ruin/unpowered)
"W" = (
/obj/item/coin/gold{
	pixel_x = -10;
	pixel_y = 8
	},
/obj/structure/stone_tile{
	dir = 1
	},
/turf/closed/mineral/volcanic/lava_land_surface,
/area/ruin/unpowered)
"X" = (
/obj/structure/stone_tile/block/cracked{
	dir = 8
	},
/turf/closed/mineral/random/high_chance/volcanic,
/area/lavaland/surface/outdoors)
"Z" = (
/turf/closed/indestructible/riveted/boss,
/area/lavaland/surface/outdoors)

(1,1,1) = {"
p
p
p
X
J
d
p
p
"}
(2,1,1) = {"
p
p
p
Z
l
Z
F
p
"}
(3,1,1) = {"
G
g
Z
Z
o
Z
Z
p
"}
(4,1,1) = {"
y
Z
Z
Z
N
n
h
p
"}
(5,1,1) = {"
p
G
Z
W
e
M
I
G
"}
(6,1,1) = {"
p
G
L
i
P
Z
Z
o
"}
(7,1,1) = {"
y
o
Z
V
O
Z
Z
p
"}
(8,1,1) = {"
G
s
o
c
E
K
r
Z
"}
(9,1,1) = {"
p
v
Z
u
C
B
A
Z
"}
(10,1,1) = {"
p
Z
Z
f
B
Q
w
Z
"}
(11,1,1) = {"
p
p
Z
r
A
w
r
Z
"}
(12,1,1) = {"
p
p
p
Z
Z
o
Z
p
"}
