//MAP CONVERTED BY dmm2tgm.py THIS HEADER COMMENT PREVENTS RECONVERSION, DO NOT REMOVE
"a" = (
/turf/template_noop,
/area/template_noop)
"b" = (
/obj/structure/stone_tile/block/cracked{
	dir = 8
	},
/obj/effect/spawner/random/mob/necropolis_mob,
/turf/closed/mineral/volcanic/lava_land_surface,
/area/lavaland/surface/outdoors)
"c" = (
/obj/structure/stone_tile/block{
	dir = 1
	},
/obj/effect/spawner/random/mob/necropolis_mob,
/turf/closed/mineral/volcanic/lava_land_surface,
/area/lavaland/surface/outdoors)
"e" = (
/obj/structure/stone_tile/burnt,
/turf/closed/indestructible/riveted/boss,
/area/lavaland/surface/outdoors)
"f" = (
/obj/structure/stone_tile/surrounding/cracked{
	dir = 1
	},
/obj/effect/spawner/random/structure/spikes,
/turf/closed/mineral/random/high_chance/volcanic,
/area/lavaland/surface/outdoors)
"g" = (
/obj/structure/stone_tile/surrounding_tile/cracked,
/obj/structure/stone_tile/surrounding_tile/cracked{
	dir = 1
	},
/obj/structure/stone_tile/center/cracked,
/turf/closed/mineral/volcanic/lava_land_surface,
/area/lavaland/surface/outdoors)
"i" = (
/obj/structure/stone_tile/burnt,
/obj/structure/stone_tile/cracked{
	dir = 8
	},
/obj/effect/spawner/random/structure/spikes,
/turf/closed/mineral/volcanic/lava_land_surface,
/area/lavaland/surface/outdoors)
"j" = (
/obj/structure/stone_tile/block/cracked{
	pixel_y = -16
	},
/obj/structure/stone_tile,
/obj/structure/stone_tile/cracked{
	dir = 8
	},
/turf/closed/mineral/random/high_chance/volcanic,
/area/lavaland/surface/outdoors)
"m" = (
/obj/structure/stone_tile/slab/cracked,
/obj/effect/spawner/random/mob/necropolis_mob,
/turf/closed/mineral/volcanic/lava_land_surface,
/area/lavaland/surface/outdoors)
"o" = (
/obj/structure/stone_tile/burnt,
/obj/item/xenoarch/useless_relic{
	name = "Ancient relic";
	desc = "Sort of relic that can be exported through Cargo."
	},
/turf/closed/mineral/volcanic/lava_land_surface,
/area/lavaland/surface/outdoors)
"q" = (
/obj/structure/stone_tile/slab/cracked,
/turf/closed/mineral/volcanic/lava_land_surface,
/area/lavaland/surface/outdoors)
"s" = (
/obj/structure/stone_tile/surrounding/cracked{
	dir = 8
	},
/obj/effect/spawner/random/structure/spikes,
/turf/closed/mineral/random/high_chance/volcanic,
/area/lavaland/surface/outdoors)
"t" = (
/obj/structure/stone_tile/slab/cracked,
/obj/effect/spawner/random/entertainment/coin{
	pixel_x = 7;
	pixel_y = -4
	},
/turf/closed/mineral/random/high_chance/volcanic,
/area/lavaland/surface/outdoors)
"u" = (
/obj/structure/stone_tile/slab/cracked{
	dir = 1
	},
/obj/effect/spawner/random/structure/spikes,
/turf/closed/mineral/volcanic/lava_land_surface,
/area/lavaland/surface/outdoors)
"z" = (
/obj/effect/mapping_helpers/bombable_wall,
/turf/closed/indestructible/riveted/boss/wasteland,
/area/lavaland/surface/outdoors)
"A" = (
/turf/closed/indestructible/riveted/boss,
/area/lavaland/surface/outdoors)
"D" = (
/obj/structure/stone_tile/slab/cracked{
	dir = 4
	},
/obj/structure/stone_tile/slab/cracked{
	dir = 1
	},
/turf/closed/mineral/volcanic/lava_land_surface,
/area/lavaland/surface/outdoors)
"E" = (
/obj/structure/stone_tile/slab,
/obj/effect/spawner/random/entertainment/coin{
	pixel_x = -4;
	pixel_y = 8
	},
/turf/closed/mineral/volcanic/lava_land_surface,
/area/lavaland/surface/outdoors)
"F" = (
/obj/structure/stone_tile/cracked,
/turf/closed/mineral/volcanic/lava_land_surface,
/area/lavaland/surface/outdoors)
"G" = (
/obj/structure/stone_tile/surrounding/cracked,
/obj/structure/stone_tile/center/burnt,
/turf/closed/mineral/random/high_chance/volcanic,
/area/lavaland/surface/outdoors)
"H" = (
/obj/structure/stone_tile/block/cracked{
	dir = 1
	},
/obj/structure/stone_tile/block/burnt,
/obj/item/retractor/ashwalker{
	pixel_x = 5;
	pixel_y = -9
	},
/turf/closed/mineral/random/high_chance/volcanic,
/area/lavaland/surface/outdoors)
"K" = (
/obj/structure/stone_tile/surrounding/cracked{
	dir = 1
	},
/obj/structure/stone_tile/surrounding/cracked,
/turf/closed/mineral/volcanic/lava_land_surface,
/area/lavaland/surface/outdoors)
"M" = (
/obj/structure/stone_tile{
	dir = 4
	},
/turf/closed/mineral/volcanic/lava_land_surface,
/area/lavaland/surface/outdoors)
"O" = (
/obj/structure/stone_tile/cracked{
	dir = 1
	},
/obj/effect/spawner/random/mob/necropolis_mob,
/turf/closed/mineral/volcanic/lava_land_surface,
/area/lavaland/surface/outdoors)
"S" = (
/obj/structure/stone_tile,
/obj/effect/spawner/random/structure/spikes,
/turf/closed/mineral/volcanic/lava_land_surface,
/area/lavaland/surface/outdoors)
"U" = (
/obj/structure/stone_tile/slab,
/turf/closed/mineral/volcanic/lava_land_surface,
/area/lavaland/surface/outdoors)
"V" = (
/obj/structure/stone_tile/surrounding/cracked,
/obj/structure/stone_tile/center/cracked,
/turf/closed/mineral/volcanic/lava_land_surface,
/area/lavaland/surface/outdoors)
"W" = (
/obj/structure/stone_tile/slab/cracked,
/turf/closed/indestructible/riveted/boss,
/area/lavaland/surface/outdoors)
"Y" = (
/obj/structure/stone_tile/surrounding_tile/cracked{
	dir = 1
	},
/obj/structure/stone_tile/surrounding_tile,
/obj/structure/stone_tile/surrounding_tile{
	dir = 4
	},
/obj/structure/stone_tile/surrounding_tile{
	dir = 8
	},
/obj/structure/stone_tile/center/cracked,
/turf/closed/mineral/volcanic/lava_land_surface,
/area/lavaland/surface/outdoors)
"Z" = (
/obj/effect/spawner/random/structure/spikes,
/turf/closed/mineral/volcanic/lava_land_surface,
/area/lavaland/surface/outdoors)

(1,1,1) = {"
a
a
a
a
a
"}
(2,1,1) = {"
A
m
a
a
a
"}
(3,1,1) = {"
A
U
z
A
A
"}
(4,1,1) = {"
M
D
g
a
a
"}
(5,1,1) = {"
q
s
Z
a
o
"}
(6,1,1) = {"
c
f
G
U
i
"}
(7,1,1) = {"
a
V
t
H
q
"}
(8,1,1) = {"
a
K
j
u
b
"}
(9,1,1) = {"
O
E
Y
a
a
"}
(10,1,1) = {"
z
W
a
a
a
"}
(11,1,1) = {"
a
e
a
A
F
"}
(12,1,1) = {"
a
a
O
S
a
"}
