//MAP CONVERTED BY dmm2tgm.py THIS HEADER COMMENT PREVENTS RECONVERSION, DO NOT REMOVE
"a" = (
/turf/closed/indestructible/riveted/boss,
/area/ruin/unpowered)
"c" = (
/obj/structure/fluff/divine/powerpylon{
	color = "#7777FF"
	},
/obj/structure/marker_beacon/teal,
/obj/item/stock_parts/cell/crystal_cell{
	color = "#77FFFF";
	name = "Ethereal crystal";
	alpha = 150;
	desc = "A cold crystal that can serve as sort of power source. Probably."
	},
/turf/open/misc/snow,
/area/ruin/unpowered)
"d" = (
/obj/structure/fluff/divine/nexus{
	color = "#7777FF"
	},
/obj/structure/marker_beacon/teal,
/obj/item/stock_parts/cell/crystal_cell{
	color = "#77FFFF";
	name = "Ethereal crystal";
	alpha = 150;
	desc = "A cold crystal that can serve as sort of power source. Probably."
	},
/turf/open/misc/snow,
/area/ruin/unpowered)
"e" = (
/obj/effect/turf_decal/weather/snow/corner{
	dir = 9
	},
/mob/living/basic/mining/ice_demon{
	health = 300;
	name = "Rime";
	speed = 0;
	current_size = 1.25;
	base_pixel_y = -7.5;
	melee_damage_lower = 10;
	melee_damage_upper = 20;
	melee_damage_type = "burn";
	damage_coeff = list("brute" = 1, "burn" = 0, "toxin" = 0, "stamina" = 0, "oxygen" = 0);
	melee_attack_cooldown = 10;
	color = "#ccccFF";
	light_color = "#ccccFF"
	},
/turf/open/misc/ice,
/area/ruin/unpowered)
"h" = (
/obj/effect/turf_decal/weather/snow/corner{
	dir = 9
	},
/mob/living/basic/mining/ice_demon{
	health = 300;
	name = "Rime";
	speed = 0;
	current_size = 1.25;
	base_pixel_y = -7.5;
	melee_damage_lower = 10;
	melee_damage_upper = 20;
	melee_damage_type = "burn";
	damage_coeff = list("brute" = 1, "burn" = 0, "toxin" = 0, "stamina" = 0, "oxygen" = 0);
	melee_attack_cooldown = 10;
	color = "#ccccFF";
	light_color = "#ccccFF"
	},
/obj/item/melee/frozen_moonlight,
/turf/open/misc/ice,
/area/ruin/unpowered)
"i" = (
/turf/template_noop,
/area/template_noop)
"k" = (
/turf/closed/indestructible/riveted/boss,
/area/lavaland/surface/outdoors)
"p" = (
/obj/item/grenade/gas_crystal/nitrous_oxide_crystal,
/turf/open/misc/ice,
/area/ruin/unpowered)
"q" = (
/obj/effect/turf_decal/weather/snow/corner{
	dir = 6
	},
/turf/open/misc/ice,
/area/ruin/unpowered)
"r" = (
/obj/effect/turf_decal/weather/snow/corner{
	dir = 1
	},
/turf/open/misc/ice,
/area/ruin/unpowered)
"y" = (
/obj/effect/mapping_helpers/bombable_wall,
/turf/closed/indestructible/riveted/boss/wasteland,
/area/lavaland/surface/outdoors)
"z" = (
/obj/effect/turf_decal/weather/snow/corner,
/turf/open/misc/ice,
/area/ruin/unpowered)
"B" = (
/obj/effect/turf_decal/weather/snow/corner{
	dir = 10
	},
/turf/open/misc/ice,
/area/ruin/unpowered)
"C" = (
/obj/effect/turf_decal/weather/snow/corner{
	dir = 6
	},
/mob/living/basic/mining/ice_demon{
	health = 300;
	name = "Rime";
	speed = 0;
	current_size = 1.25;
	base_pixel_y = -7.5;
	melee_damage_lower = 10;
	melee_damage_upper = 20;
	melee_damage_type = "burn";
	damage_coeff = list("brute" = 1, "burn" = 0, "toxin" = 0, "stamina" = 0, "oxygen" = 0);
	melee_attack_cooldown = 10;
	color = "#ccccFF";
	light_color = "#ccccFF"
	},
/turf/open/misc/ice,
/area/ruin/unpowered)
"D" = (
/obj/structure/flora/ash/chilly,
/mob/living/basic/mining/ice_demon{
	health = 300;
	name = "Rime";
	speed = 0;
	current_size = 1.25;
	base_pixel_y = -7.5;
	melee_damage_lower = 10;
	melee_damage_upper = 20;
	melee_damage_type = "burn";
	damage_coeff = list("brute" = 1, "burn" = 0, "toxin" = 0, "stamina" = 0, "oxygen" = 0);
	melee_attack_cooldown = 10;
	color = "#ccccFF";
	light_color = "#ccccFF"
	},
/turf/open/misc/snow,
/area/ruin/unpowered)
"G" = (
/obj/structure/fluff/divine/conduit{
	color = "#7777FF"
	},
/obj/item/stock_parts/cell/crystal_cell{
	color = "#77FFFF";
	name = "Ethereal crystal";
	alpha = 150;
	desc = "A cold crystal that can serve as sort of power source. Probably."
	},
/turf/open/misc/snow,
/area/ruin/unpowered)
"I" = (
/mob/living/basic/mining/ice_demon{
	health = 300;
	name = "Rime";
	speed = 0;
	current_size = 1.25;
	base_pixel_y = -7.5;
	melee_damage_lower = 10;
	melee_damage_upper = 20;
	melee_damage_type = "burn";
	damage_coeff = list("brute" = 1, "burn" = 0, "toxin" = 0, "stamina" = 0, "oxygen" = 0);
	melee_attack_cooldown = 10;
	color = "#ccccFF";
	light_color = "#ccccFF"
	},
/turf/open/misc/ice,
/area/ruin/unpowered)
"K" = (
/obj/effect/mapping_helpers/bombable_wall,
/turf/closed/indestructible/riveted/boss/wasteland,
/area/ruin/unpowered)
"L" = (
/obj/effect/turf_decal/weather/snow/corner{
	dir = 5
	},
/obj/effect/turf_decal/weather/snow/corner{
	dir = 8
	},
/turf/open/misc/ice,
/area/ruin/unpowered)
"M" = (
/obj/effect/spawner/random/structure/spikes,
/turf/closed/mineral/volcanic/lava_land_surface,
/area/lavaland/surface/outdoors)
"N" = (
/obj/structure/flora/rock/pile/icy/style_random,
/turf/open/misc/snow,
/area/ruin/unpowered)
"P" = (
/turf/open/misc/ice,
/area/ruin/unpowered)
"R" = (
/turf/open/misc/snow,
/area/ruin/unpowered)
"U" = (
/obj/structure/flora/grass/both/style_random,
/turf/open/misc/snow,
/area/ruin/unpowered)
"W" = (
/obj/effect/turf_decal/weather/snow/corner{
	dir = 5
	},
/turf/open/misc/ice,
/area/ruin/unpowered)
"Y" = (
/obj/structure/fluff/divine/shrine{
	color = "#7777FF"
	},
/obj/effect/turf_decal/weather/snow/corner{
	dir = 6
	},
/obj/effect/turf_decal/weather/snow/corner{
	dir = 8
	},
/turf/open/misc/ice,
/area/ruin/unpowered)
"Z" = (
/obj/structure/fluff/divine/shrine{
	color = "#7777FF"
	},
/turf/open/misc/snow,
/area/ruin/unpowered)

(1,1,1) = {"
i
i
k
y
M
k
k
M
i
"}
(2,1,1) = {"
i
k
a
a
a
a
a
k
M
"}
(3,1,1) = {"
y
a
a
U
e
B
a
a
k
"}
(4,1,1) = {"
y
a
G
D
r
p
Y
a
a
"}
(5,1,1) = {"
M
a
d
h
P
q
N
R
K
"}
(6,1,1) = {"
y
a
L
I
z
U
Z
a
a
"}
(7,1,1) = {"
y
a
a
W
C
c
a
a
k
"}
(8,1,1) = {"
M
k
a
a
a
a
a
y
i
"}
(9,1,1) = {"
i
M
k
y
M
y
y
i
i
"}
