//MAP CONVERTED BY dmm2tgm.py THIS HEADER COMMENT PREVENTS RECONVERSION, DO NOT REMOVE
"a" = (
/turf/closed/indestructible/riveted/boss,
/area/lavaland/surface/outdoors)
"d" = (
/obj/structure/stone_tile/block,
/turf/open/lava/smooth/lava_land_surface{
	slowdown = 0
	},
/area/lavaland/surface/outdoors)
"e" = (
/obj/structure/stone_tile/burnt{
	dir = 1
	},
/turf/closed/mineral/random/high_chance/volcanic,
/area/lavaland/surface/outdoors)
"f" = (
/obj/structure/stone_tile,
/obj/structure/stone_tile{
	dir = 1
	},
/obj/structure/stone_tile/cracked{
	dir = 8
	},
/turf/open/lava/smooth/lava_land_surface{
	slowdown = 0
	},
/area/lavaland/surface/outdoors)
"i" = (
/obj/structure/stone_tile/slab,
/turf/open/misc/asteroid/basalt/lava_land_surface,
/area/lavaland/surface/outdoors)
"n" = (
/obj/structure/stone_tile/block{
	dir = 4
	},
/turf/closed/mineral/volcanic/lava_land_surface,
/area/lavaland/surface/outdoors)
"q" = (
/obj/structure/stone_tile/block,
/turf/closed/mineral/volcanic/lava_land_surface,
/area/lavaland/surface/outdoors)
"r" = (
/obj/structure/stone_tile/slab/cracked{
	dir = 4
	},
/obj/structure/stone_tile/slab/cracked{
	dir = 8
	},
/turf/open/misc/asteroid/basalt/lava_land_surface,
/area/lavaland/surface/outdoors)
"u" = (
/obj/structure/stone_tile,
/obj/structure/stone_tile{
	dir = 8
	},
/obj/structure/stone_tile{
	dir = 1
	},
/obj/effect/mapping_helpers/bombable_wall,
/turf/closed/indestructible/riveted/boss/wasteland,
/area/lavaland/surface/outdoors)
"v" = (
/obj/structure/stone_tile/block{
	dir = 8
	},
/turf/open/misc/asteroid/basalt/lava_land_surface,
/area/lavaland/surface/outdoors)
"B" = (
/obj/structure/stone_tile/slab/cracked,
/turf/closed/mineral/volcanic/lava_land_surface,
/area/lavaland/surface/outdoors)
"D" = (
/obj/structure/stone_tile/block{
	dir = 8
	},
/turf/closed/mineral/volcanic/lava_land_surface,
/area/lavaland/surface/outdoors)
"E" = (
/turf/template_noop,
/area/template_noop)
"F" = (
/turf/open/lava/smooth/lava_land_surface{
	slowdown = 0
	},
/area/lavaland/surface/outdoors)
"G" = (
/turf/closed/mineral/volcanic/lava_land_surface,
/area/lavaland/surface/outdoors)
"J" = (
/obj/structure/stone_tile/block/cracked{
	dir = 1
	},
/turf/open/misc/asteroid/basalt/lava_land_surface,
/area/lavaland/surface/outdoors)
"L" = (
/obj/structure/stone_tile/block{
	dir = 4
	},
/turf/closed/mineral/random/high_chance/volcanic,
/area/lavaland/surface/outdoors)
"M" = (
/obj/structure/stone_tile/block{
	dir = 1
	},
/turf/closed/mineral/random/high_chance/volcanic,
/area/lavaland/surface/outdoors)
"N" = (
/obj/structure/stone_tile,
/obj/structure/stone_tile{
	dir = 8
	},
/obj/structure/stone_tile{
	dir = 1
	},
/turf/closed/mineral/random/high_chance/volcanic,
/area/lavaland/surface/outdoors)
"O" = (
/obj/structure/stone_tile/block/cracked,
/turf/closed/indestructible/riveted/boss,
/area/lavaland/surface/outdoors)
"R" = (
/turf/closed/mineral/random/high_chance/volcanic,
/area/template_noop)
"T" = (
/obj/structure/stone_tile/block/cracked{
	dir = 4
	},
/turf/closed/mineral/volcanic/lava_land_surface,
/area/lavaland/surface/outdoors)
"U" = (
/obj/structure/stone_tile/block{
	dir = 1
	},
/turf/closed/mineral/volcanic/lava_land_surface,
/area/lavaland/surface/outdoors)
"V" = (
/obj/structure/stone_tile{
	dir = 4
	},
/obj/structure/stone_tile{
	dir = 1
	},
/obj/structure/stone_tile/burnt{
	dir = 8
	},
/turf/open/lava/smooth/lava_land_surface{
	slowdown = 0
	},
/area/lavaland/surface/outdoors)
"Z" = (
/obj/structure/stone_tile,
/obj/structure/stone_tile{
	dir = 4
	},
/obj/structure/stone_tile/cracked{
	dir = 8
	},
/turf/closed/mineral/random/high_chance/volcanic,
/area/lavaland/surface/outdoors)

(1,1,1) = {"
E
E
a
a
a
E
E
E
E
a
a
a
"}
(2,1,1) = {"
D
a
a
N
n
E
a
a
E
E
T
a
"}
(3,1,1) = {"
a
a
d
F
E
E
a
E
E
E
G
a
"}
(4,1,1) = {"
E
E
f
E
E
B
a
E
E
a
E
a
"}
(5,1,1) = {"
a
q
E
E
E
i
u
E
E
a
U
E
"}
(6,1,1) = {"
a
E
E
E
E
M
O
E
E
a
J
E
"}
(7,1,1) = {"
a
E
E
E
E
a
a
E
a
a
E
E
"}
(8,1,1) = {"
a
E
E
E
E
r
E
E
E
n
e
a
"}
(9,1,1) = {"
E
E
E
E
E
E
E
E
E
E
R
a
"}
(10,1,1) = {"
E
a
a
E
E
E
q
E
E
E
v
a
"}
(11,1,1) = {"
E
L
E
E
a
a
Z
E
E
V
a
a
"}
(12,1,1) = {"
E
E
E
E
a
a
E
E
a
a
a
a
"}
