//MAP CONVERTED BY dmm2tgm.py THIS HEADER COMMENT PREVENTS RECONVERSION, DO NOT REMOVE
"aM" = (
/obj/structure/stone_tile,
/obj/structure/trap/damage{
	name = "Anctient runic spikes";
	desc = "A strange carving of some symbols. What's that for?";
	icon = 'icons/obj/service/hydroponics/equipment.dmi';
	icon_state = "woodspike";
	light_color = "#DDFFDD";
	color = "#77FF77";
	alpha = 180;
	max_integrity = 30
	},
/turf/closed/mineral/random/high_chance/volcanic,
/area/lavaland/surface/outdoors)
"bd" = (
/obj/structure/stone_tile/center/cracked,
/obj/structure/stone_tile/surrounding/cracked{
	dir = 6
	},
/turf/closed/mineral/random/high_chance/volcanic,
/area/lavaland/surface/outdoors)
"bR" = (
/obj/structure/flora/ash/cacti,
/turf/closed/mineral/volcanic/lava_land_surface,
/area/lavaland/surface/outdoors)
"cv" = (
/obj/structure/stone_tile/surrounding,
/obj/structure/stone_tile/center,
/obj/effect/decal/cleanable/blood/gibs/limb{
	pixel_y = 10
	},
/obj/effect/decal/cleanable/blood/old{
	pixel_x = -5;
	pixel_y = 15
	},
/obj/effect/decal/cleanable/blood/old{
	icon_state = "floor4-old";
	pixel_y = 10;
	pixel_x = 5
	},
/obj/effect/decal/cleanable/blood/tracks{
	desc = "Your instincts say you shouldn't be following these.";
	icon_state = "ltrails_1";
	dir = 10;
	pixel_y = 15
	},
/turf/open/misc/asteroid/basalt/lava_land_surface,
/area/lavaland/surface/outdoors)
"dk" = (
/obj/structure/stone_tile/block/cracked{
	dir = 4
	},
/obj/structure/stone_tile/cracked{
	dir = 4
	},
/obj/structure/stone_tile{
	dir = 8
	},
/obj/item/organ/internal/tongue/cat/tajaran,
/turf/open/indestructible/necropolis,
/area/ruin/unpowered)
"eD" = (
/obj/structure/stone_tile/slab/burnt,
/obj/effect/gibspawner,
/turf/open/indestructible/boss,
/area/ruin/unpowered)
"eR" = (
/obj/structure/stone_tile/slab/cracked,
/obj/effect/gibspawner,
/turf/open/indestructible/necropolis,
/area/ruin/unpowered)
"fc" = (
/obj/structure/stone_tile/block/cracked,
/obj/effect/decal/cleanable/blood/tracks{
	desc = "Your instincts say you shouldn't be following these.";
	icon_state = "ltrails_1";
	dir = 6
	},
/obj/item/soulstone,
/turf/open/indestructible/necropolis,
/area/ruin/unpowered)
"fx" = (
/obj/structure/stone_tile{
	dir = 8
	},
/obj/structure/trap/cult{
	name = "Anctient runic spikes";
	desc = "A strange carving of some symbols. What's that for?";
	alpha = 180;
	icon = 'icons/obj/service/hydroponics/equipment.dmi';
	icon_state = "woodspike";
	light_color = "#FF9911";
	color = "#FF9911";
	max_integrity = 30
	},
/turf/closed/mineral/volcanic/lava_land_surface,
/area/lavaland/surface/outdoors)
"gs" = (
/obj/structure/stone_tile/block{
	dir = 1
	},
/turf/closed/mineral/random/high_chance/volcanic,
/area/lavaland/surface/outdoors)
"id" = (
/obj/structure/stone_tile/surrounding_tile/cracked,
/obj/structure/stone_tile/center,
/obj/structure/stone_tile/surrounding_tile{
	dir = 1
	},
/obj/structure/stone_tile/surrounding_tile{
	dir = 8
	},
/obj/item/trash/candle{
	pixel_y = 12
	},
/turf/open/indestructible/necropolis,
/area/ruin/unpowered)
"ig" = (
/obj/structure/stone_tile,
/obj/structure/stone_tile{
	dir = 4
	},
/obj/structure/stone_tile{
	dir = 1
	},
/turf/open/misc/asteroid/basalt/lava_land_surface,
/area/lavaland/surface/outdoors)
"ir" = (
/obj/structure/stone_tile/surrounding_tile/cracked,
/obj/structure/stone_tile/surrounding_tile/cracked{
	dir = 4
	},
/obj/structure/stone_tile/center,
/obj/structure/stone_tile/surrounding_tile{
	dir = 8
	},
/obj/item/organ/internal/tongue/dwarven,
/obj/effect/glowing_rune,
/turf/open/indestructible/necropolis,
/area/ruin/unpowered)
"jP" = (
/obj/structure/flora/ash/cap_shroom,
/turf/closed/mineral/volcanic/lava_land_surface,
/area/lavaland/surface/outdoors)
"kt" = (
/turf/closed/mineral/volcanic/lava_land_surface,
/area/lavaland/surface/outdoors)
"kw" = (
/obj/structure/flora/rock/pile/style_random,
/turf/closed/mineral/volcanic/lava_land_surface,
/area/lavaland/surface/outdoors)
"kI" = (
/obj/structure/stone_tile/slab/burnt,
/obj/item/stack/sheet/mineral/runite{
	amount = 5
	},
/turf/open/indestructible/boss,
/area/ruin/unpowered)
"lb" = (
/obj/structure/stone_tile/block,
/obj/structure/stone_tile{
	dir = 1
	},
/obj/structure/stone_tile{
	dir = 4
	},
/obj/item/stack/sheet/mineral/runite{
	amount = 5
	},
/obj/item/organ/internal/tongue/alien,
/turf/open/indestructible/necropolis,
/area/ruin/unpowered)
"lq" = (
/obj/effect/mapping_helpers/bombable_wall,
/turf/closed/indestructible/riveted/boss/wasteland,
/area/lavaland/surface/outdoors)
"lx" = (
/obj/item/xenoarch/useless_relic{
	name = "Ancient relic";
	desc = "Sort of relic that can be exported through Cargo."
	},
/turf/closed/mineral/volcanic/lava_land_surface,
/area/lavaland/surface/outdoors)
"lC" = (
/obj/structure/stone_tile/slab/burnt,
/obj/effect/decal/cleanable/blood/gibs/up,
/obj/effect/glowing_rune,
/turf/open/indestructible/boss,
/area/ruin/unpowered)
"md" = (
/obj/structure/stone_tile/block,
/obj/structure/trap/damage{
	name = "Anctient runic spikes";
	desc = "A strange carving of some symbols. What's that for?";
	icon = 'icons/obj/service/hydroponics/equipment.dmi';
	icon_state = "woodspike";
	light_color = "#DDFFDD";
	color = "#77FF77";
	alpha = 180;
	max_integrity = 30
	},
/turf/closed/mineral/random/high_chance/volcanic,
/area/lavaland/surface/outdoors)
"my" = (
/obj/structure/stone_tile/slab/burnt,
/obj/effect/decal/cleanable/blood/old{
	icon_state = "gibbl1"
	},
/obj/item/organ/internal/tongue/jelly,
/turf/open/indestructible/boss,
/area/ruin/unpowered)
"nS" = (
/turf/closed/indestructible/riveted/boss,
/area/ruin/unpowered)
"om" = (
/obj/structure/stone_tile,
/turf/closed/mineral/random/high_chance/volcanic,
/area/lavaland/surface/outdoors)
"oA" = (
/obj/structure/stone_tile/block/cracked,
/obj/structure/trap/damage{
	name = "Anctient runic spikes";
	desc = "A strange carving of some symbols. What's that for?";
	icon = 'icons/obj/service/hydroponics/equipment.dmi';
	icon_state = "woodspike";
	light_color = "#DDFFDD";
	color = "#77FF77";
	alpha = 180;
	max_integrity = 30
	},
/turf/closed/mineral/volcanic/lava_land_surface,
/area/lavaland/surface/outdoors)
"qr" = (
/turf/closed/indestructible/riveted/boss,
/area/lavaland/surface/outdoors)
"su" = (
/obj/structure/stone_tile/slab/burnt,
/obj/item/organ/internal/tongue/insect,
/turf/open/indestructible/necropolis,
/area/ruin/unpowered)
"tn" = (
/obj/structure/stone_tile/block/cracked{
	dir = 8
	},
/turf/closed/mineral/volcanic/lava_land_surface,
/area/lavaland/surface/outdoors)
"tF" = (
/obj/structure/stone_tile,
/turf/closed/mineral/volcanic/lava_land_surface,
/area/lavaland/surface/outdoors)
"ug" = (
/obj/structure/stone_tile/block{
	dir = 4
	},
/obj/structure/stone_tile{
	dir = 8
	},
/obj/structure/stone_tile{
	dir = 4
	},
/obj/effect/decal/cleanable/blood/old{
	icon_state = "floor4-old"
	},
/obj/item/organ/internal/tongue/snail,
/turf/open/indestructible/necropolis,
/area/ruin/unpowered)
"un" = (
/obj/structure/punji_sticks/spikes,
/turf/closed/mineral/random/high_chance/volcanic,
/area/lavaland/surface/outdoors)
"uz" = (
/obj/effect/mapping_helpers/bombable_wall,
/obj/structure/necropolis_arch,
/turf/closed/indestructible/riveted/boss/wasteland,
/area/ruin/unpowered)
"uA" = (
/obj/structure/stone_tile/cracked{
	dir = 4
	},
/turf/closed/mineral/volcanic/lava_land_surface,
/area/lavaland/surface/outdoors)
"vM" = (
/obj/structure/trap/damage{
	name = "Anctient runic spikes";
	desc = "A strange carving of some symbols. What's that for?";
	icon = 'icons/obj/service/hydroponics/equipment.dmi';
	icon_state = "woodspike";
	light_color = "#DDFFDD";
	color = "#77FF77";
	alpha = 180;
	max_integrity = 30
	},
/turf/closed/mineral/volcanic/lava_land_surface,
/area/lavaland/surface/outdoors)
"vP" = (
/obj/structure/stone_tile/block{
	dir = 8
	},
/obj/item/trash/candle{
	pixel_x = 9;
	pixel_y = -1
	},
/obj/item/soulstone,
/turf/open/indestructible/necropolis,
/area/ruin/unpowered)
"wl" = (
/obj/structure/stone_tile/block{
	dir = 4
	},
/turf/closed/mineral/volcanic/lava_land_surface,
/area/lavaland/surface/outdoors)
"ws" = (
/obj/structure/stone_tile/block{
	dir = 8
	},
/obj/structure/stone_tile,
/obj/structure/stone_tile{
	dir = 1
	},
/obj/item/organ/internal/tongue/golem,
/turf/open/indestructible/necropolis,
/area/ruin/unpowered)
"xc" = (
/obj/structure/stone_tile,
/obj/structure/trap/cult{
	name = "Anctient runic spikes";
	desc = "A strange carving of some symbols. What's that for?";
	alpha = 180;
	icon = 'icons/obj/service/hydroponics/equipment.dmi';
	icon_state = "woodspike";
	light_color = "#FF9911";
	color = "#FF9911";
	max_integrity = 30
	},
/turf/closed/mineral/volcanic/lava_land_surface,
/area/lavaland/surface/outdoors)
"yh" = (
/obj/effect/mapping_helpers/bombable_wall,
/turf/closed/indestructible/riveted/boss/wasteland,
/area/ruin/unpowered)
"ys" = (
/obj/structure/stone_tile/block{
	dir = 4
	},
/obj/structure/stone_tile/block/cracked{
	dir = 8
	},
/mob/living/basic/mining/wolf{
	desc = "A demonic creature that moves relatively fast, but doesn't do a lot of damage.";
	faction = list("mining","boss","hell");
	name = "Ancient Demon";
	attack_sound = 'sound/effects/wounds/crackandbleed.ogg';
	attack_verb_continuous = "maniacally tears";
	attack_verb_simple = "tears";
	attack_vis_effect = "slash";
	bare_wound_bonus = 5;
	butcher_results = list(/obj/item/food/grown/mushroom/glowshroom/shadowshroom = 1,/obj/item/food/meat/slab/human/mutant/shadow = 1,/obj/item/organ/external/tail/lizard = 1);
	can_tame = 0;
	damage_coeff = list("brute" = 1, "burn" = 1, "toxin" = 1, "stamina" = 0.42, "oxygen" = 1);
	health = 240;
	icon = 'modular_nova/master_files/icons/mob/newmobs32x64.dmi';
	icon_dead = "demondead";
	icon_living = "engorgedemon";
	icon_state = "engorgedemon";
	maxHealth = 240;
	melee_damage_lower = 3;
	melee_attack_cooldown = 5;
	speed = -0.1;
	wound_bonus = -1;
	guaranteed_butcher_results = list(/obj/structure/trap/fire=1);
	crusher_loot = /obj/item/organ/internal/eyes/shadow
	},
/turf/open/indestructible/boss,
/area/ruin/unpowered)
"yt" = (
/obj/structure/stone_tile{
	dir = 8
	},
/obj/item/xenoarch/useless_relic{
	name = "Ancient relic";
	desc = "Sort of relic that can be exported through Cargo."
	},
/turf/closed/mineral/random/high_chance/volcanic,
/area/lavaland/surface/outdoors)
"yI" = (
/obj/structure/stone_tile/cracked,
/obj/structure/punji_sticks/spikes,
/turf/closed/mineral/random/high_chance/volcanic,
/area/lavaland/surface/outdoors)
"Al" = (
/obj/structure/stone_tile/block/cracked{
	dir = 1
	},
/obj/structure/stone_tile{
	dir = 8
	},
/obj/structure/stone_tile,
/obj/effect/decal/cleanable/blood/old,
/obj/item/organ/internal/tongue/human,
/turf/open/indestructible/necropolis,
/area/ruin/unpowered)
"Bw" = (
/obj/structure/stone_tile/block/cracked,
/obj/structure/punji_sticks/spikes,
/turf/closed/mineral/random/high_chance/volcanic,
/area/lavaland/surface/outdoors)
"BI" = (
/obj/structure/stone_tile/block{
	dir = 1
	},
/obj/structure/stone_tile/cracked,
/obj/structure/stone_tile{
	dir = 8
	},
/obj/effect/decal/cleanable/blood/gibs/down,
/turf/open/indestructible/necropolis,
/area/ruin/unpowered)
"CN" = (
/obj/structure/stone_tile,
/obj/structure/stone_tile{
	dir = 8
	},
/obj/structure/stone_tile/cracked{
	dir = 4
	},
/obj/structure/stone_tile/cracked{
	dir = 1
	},
/obj/structure/mirror/broken/directional/north,
/obj/structure/fluff/divine/nexus{
	light_color = "#FF0000";
	icon = 'icons/obj/antags/cult/structures.dmi';
	icon_state = "altar"
	},
/turf/open/indestructible/boss,
/area/ruin/unpowered)
"DQ" = (
/obj/structure/stone_tile/surrounding_tile/cracked,
/obj/structure/punji_sticks/spikes,
/turf/closed/mineral/random/high_chance/volcanic,
/area/lavaland/surface/outdoors)
"Eu" = (
/obj/structure/stone_tile/surrounding_tile/cracked{
	dir = 4
	},
/obj/structure/stone_tile/center/cracked,
/obj/structure/stone_tile/surrounding_tile,
/obj/structure/stone_tile/surrounding_tile{
	dir = 1
	},
/obj/item/trash/candle{
	pixel_x = 9;
	pixel_y = -1
	},
/obj/item/organ/internal/tongue/ethereal,
/obj/effect/glowing_rune,
/turf/open/indestructible/necropolis,
/area/ruin/unpowered)
"EL" = (
/obj/structure/stone_tile/block/cracked{
	dir = 4
	},
/obj/item/soulstone,
/turf/open/indestructible/necropolis,
/area/ruin/unpowered)
"FQ" = (
/obj/structure/flora/ash/seraka,
/turf/closed/mineral/random/high_chance/volcanic,
/area/lavaland/surface/outdoors)
"He" = (
/obj/structure/punji_sticks/spikes,
/turf/closed/mineral/volcanic/lava_land_surface,
/area/lavaland/surface/outdoors)
"Io" = (
/obj/structure/punji_sticks/spikes,
/turf/closed/mineral/strange_rock/volcanic,
/area/lavaland/surface/outdoors)
"Iq" = (
/obj/structure/stone_tile,
/obj/structure/stone_tile{
	dir = 8
	},
/obj/structure/stone_tile/cracked{
	dir = 4
	},
/obj/structure/stone_tile/cracked{
	dir = 1
	},
/obj/structure/destructible/cult/pylon,
/obj/item/clothing/head/hooded/cult_hoodie/hardened,
/turf/open/indestructible/boss,
/area/ruin/unpowered)
"Ix" = (
/obj/structure/fluff/big_chain{
	pixel_y = 12
	},
/turf/closed/indestructible/riveted/boss,
/area/ruin/unpowered)
"IU" = (
/obj/structure/stone_tile,
/obj/structure/stone_tile{
	dir = 1
	},
/obj/structure/stone_tile/cracked{
	dir = 4
	},
/obj/structure/stone_tile/cracked{
	dir = 8
	},
/obj/structure/destructible/cult/pylon,
/obj/item/clothing/head/hooded/cult_hoodie/hardened,
/turf/open/indestructible/boss,
/area/ruin/unpowered)
"Kk" = (
/obj/structure/stone_tile/cracked{
	dir = 1
	},
/turf/closed/mineral/random/high_chance/volcanic,
/area/lavaland/surface/outdoors)
"Ky" = (
/obj/structure/stone_tile{
	dir = 8
	},
/obj/structure/punji_sticks/spikes,
/turf/closed/mineral/volcanic/lava_land_surface,
/area/lavaland/surface/outdoors)
"Kz" = (
/obj/structure/stone_tile/slab/burnt,
/obj/effect/decal/cleanable/blood/old{
	icon_state = "gib2"
	},
/obj/effect/decal/cleanable/blood/old{
	icon_state = "gibbl4"
	},
/turf/open/indestructible/boss,
/area/ruin/unpowered)
"KS" = (
/obj/structure/stone_tile/block/cracked{
	dir = 8
	},
/obj/structure/stone_tile/cracked{
	dir = 1
	},
/obj/structure/stone_tile,
/obj/item/stack/sheet/mineral/runite{
	amount = 5
	},
/turf/open/indestructible/necropolis,
/area/ruin/unpowered)
"Lx" = (
/obj/structure/trap/fire{
	name = "Anctient runic spikes";
	desc = "A strange carving of some symbols. What's that for?";
	alpha = 180;
	icon = 'icons/obj/service/hydroponics/equipment.dmi';
	icon_state = "woodspike";
	light_color = "#FF1111";
	color = "#FF1111";
	max_integrity = 30
	},
/turf/closed/mineral/volcanic/lava_land_surface,
/area/lavaland/surface/outdoors)
"LA" = (
/obj/structure/stone_tile/surrounding_tile{
	dir = 8
	},
/obj/structure/punji_sticks/spikes,
/turf/closed/mineral/strange_rock/volcanic,
/area/lavaland/surface/outdoors)
"LX" = (
/obj/structure/stone_tile/surrounding_tile{
	dir = 1
	},
/turf/closed/mineral/volcanic/lava_land_surface,
/area/lavaland/surface/outdoors)
"Mo" = (
/obj/structure/stone_tile/cracked{
	dir = 1
	},
/turf/closed/mineral/volcanic/lava_land_surface,
/area/lavaland/surface/outdoors)
"MN" = (
/obj/structure/stone_tile/slab/burnt,
/obj/effect/gibspawner,
/turf/open/indestructible/necropolis,
/area/ruin/unpowered)
"NR" = (
/obj/effect/mapping_helpers/bombable_wall,
/obj/structure/fluff/big_chain{
	pixel_y = 12
	},
/turf/closed/indestructible/riveted/boss/wasteland,
/area/ruin/unpowered)
"Ov" = (
/obj/structure/stone_tile,
/obj/structure/stone_tile{
	dir = 8
	},
/obj/structure/stone_tile{
	dir = 1
	},
/obj/structure/stone_tile/cracked{
	dir = 4
	},
/obj/effect/decal/cleanable/blood/tracks{
	desc = "Your instincts say you shouldn't be following these.";
	dir = 8;
	icon_state = "ltrails_2"
	},
/obj/item/organ/internal/tongue/hemophage,
/turf/open/indestructible/boss,
/area/ruin/unpowered)
"Ps" = (
/obj/structure/stone_tile{
	dir = 4
	},
/obj/structure/stone_tile{
	dir = 8
	},
/obj/structure/stone_tile{
	dir = 1
	},
/obj/item/stack/sheet/animalhide/goliath_hide,
/turf/open/misc/asteroid/basalt/lava_land_surface,
/area/lavaland/surface/outdoors)
"PV" = (
/obj/structure/stone_tile,
/obj/structure/stone_tile{
	dir = 8
	},
/obj/structure/stone_tile{
	dir = 1
	},
/obj/structure/stone_tile{
	dir = 4
	},
/obj/effect/decal/cleanable/blood/gibs,
/obj/effect/glowing_rune,
/obj/item/sharpener/cult,
/turf/open/indestructible/boss,
/area/ruin/unpowered)
"QG" = (
/obj/structure/stone_tile/slab/burnt,
/obj/effect/gibspawner/human,
/turf/open/indestructible/necropolis,
/area/ruin/unpowered)
"QI" = (
/obj/effect/gibspawner/human/bodypartless,
/turf/open/misc/asteroid/basalt/lava_land_surface,
/area/lavaland/surface/outdoors)
"Sr" = (
/turf/template_noop,
/area/template_noop)
"Ss" = (
/obj/effect/decal/cleanable/blood/tracks{
	desc = "Your instincts say you shouldn't be following these.";
	dir = 8;
	icon_state = "ltrails_2"
	},
/obj/effect/decal/cleanable/grand_remains,
/obj/effect/rune/narsie{
	color = "#440000";
	used = 1;
	light_color = "#440000"
	},
/mob/living/basic/mega_arachnid{
	health = 2000;
	maxHealth = 2000;
	speed = -1.4;
	melee_attack_cooldown = 5;
	health_doll_icon = "bubblegum";
	icon = 'modular_nova/master_files/icons/mob/newmobs32x64.dmi';
	icon_dead = "demondead";
	icon_living = "devourdemon";
	icon_state = "devourdemon";
	pixel_x = 0;
	base_pixel_x = 0;
	attack_verb_continuous = "devours";
	attack_verb_simple = "reaps";
	attack_sound = 'sound/effects/wounds/crackandbleed.ogg';
	name = "Eldritch Horror";
	faction = list("mining","boss","hell");
	light_color = "#D00000";
	desc = "This creature is terror itself, a manifestation of the raw hunger and avarice of mortals.";
	unsuitable_atmos_damage = 0;
	unsuitable_cold_damage = 0;
	unsuitable_heat_damage = 0;
	melee_damage_lower = 5;
	damage_coeff = list("brute" = 1, "burn" = 1, "toxin" = 1, "stamina" = 1, "oxygen" = 1);
	maximum_survivable_temperature = 24000;
	minimum_survivable_temperature = 0;
	butcher_results = list(/obj/item/food/grown/mushroom/glowshroom/shadowshroom = 1,/obj/item/food/meat/slab/human/mutant/shadow = 1,/obj/item/organ/internal/eyes/shadow = 1);
	guaranteed_butcher_results = list(/obj/item/book/granter/action/spell/true_random = 1,/obj/item/melee/cultblade=4,/obj/item/clothing/suit/hooded/cultrobes=4);
	armour_penetration = 15;
	combat_mode = 1;
	light_power = 12;
	light_range = 3;
	lighting_cutoff_blue = 35;
	lighting_cutoff_green = 15;
	lighting_cutoff_red = 25
	},
/turf/open/indestructible/necropolis,
/area/ruin/unpowered)
"Sv" = (
/obj/structure/stone_tile/block,
/obj/structure/stone_tile/cracked{
	dir = 1
	},
/obj/structure/stone_tile{
	dir = 4
	},
/obj/item/disk/design_disk/knight_gear,
/turf/open/indestructible/necropolis,
/area/ruin/unpowered)
"SB" = (
/obj/structure/stone_tile/block{
	dir = 1
	},
/turf/closed/mineral/volcanic/lava_land_surface,
/area/lavaland/surface/outdoors)
"Tp" = (
/obj/structure/stone_tile/block{
	dir = 8
	},
/obj/structure/stone_tile/cracked{
	dir = 1
	},
/obj/structure/stone_tile,
/obj/effect/decal/cleanable/blood/gibs/old,
/turf/open/indestructible/necropolis,
/area/ruin/unpowered)
"TF" = (
/obj/structure/stone_tile{
	dir = 4
	},
/turf/closed/mineral/volcanic/lava_land_surface,
/area/lavaland/surface/outdoors)
"TY" = (
/obj/structure/stone_tile/block{
	dir = 1
	},
/obj/item/soulstone,
/turf/open/indestructible/necropolis,
/area/ruin/unpowered)
"Ue" = (
/obj/structure/stone_tile/surrounding_tile/cracked{
	dir = 8
	},
/obj/structure/stone_tile/center,
/obj/structure/stone_tile/surrounding_tile{
	dir = 1
	},
/obj/structure/stone_tile/surrounding_tile{
	dir = 4
	},
/obj/effect/decal/cleanable/blood/tracks{
	desc = "Your instincts say you shouldn't be following these.";
	icon_state = "ltrails_1";
	dir = 10
	},
/obj/item/organ/internal/tongue/lizard/silver,
/turf/open/indestructible/necropolis,
/area/ruin/unpowered)
"Uk" = (
/obj/structure/stone_tile/cracked{
	dir = 4
	},
/turf/closed/mineral/random/high_chance/volcanic,
/area/lavaland/surface/outdoors)
"Ur" = (
/obj/structure/stone_tile/slab/burnt,
/obj/effect/decal/cleanable/blood/gibs/torso,
/obj/effect/decal/cleanable/blood/old{
	icon_state = "gibbl4"
	},
/turf/open/indestructible/boss,
/area/ruin/unpowered)
"VK" = (
/obj/structure/flora/rock/pile/style_random,
/turf/closed/mineral/random/high_chance/volcanic,
/area/lavaland/surface/outdoors)
"WI" = (
/obj/structure/stone_tile/block,
/obj/structure/stone_tile{
	dir = 1
	},
/obj/structure/stone_tile{
	dir = 4
	},
/obj/effect/decal/cleanable/blood,
/obj/effect/mob_spawn/corpse/human/wizard,
/turf/open/indestructible/necropolis,
/area/ruin/unpowered)
"Xc" = (
/obj/structure/flora/ash/stem_shroom,
/turf/closed/mineral/random/high_chance/volcanic,
/area/lavaland/surface/outdoors)
"Xh" = (
/obj/structure/stone_tile{
	dir = 8
	},
/obj/structure/trap/damage{
	name = "Anctient runic spikes";
	desc = "A strange carving of some symbols. What's that for?";
	icon = 'icons/obj/service/hydroponics/equipment.dmi';
	icon_state = "woodspike";
	light_color = "#DDFFDD";
	color = "#77FF77";
	alpha = 180;
	max_integrity = 30
	},
/turf/closed/mineral/volcanic/lava_land_surface,
/area/lavaland/surface/outdoors)
"Xo" = (
/turf/closed/mineral/random/high_chance/volcanic,
/area/lavaland/surface/outdoors)
"Xp" = (
/obj/structure/stone_tile/block{
	dir = 4
	},
/obj/structure/stone_tile{
	dir = 8
	},
/obj/structure/stone_tile{
	dir = 4
	},
/obj/effect/decal/cleanable/blood/old{
	icon_state = "gibbl1"
	},
/obj/item/stack/sheet/mineral/runite{
	amount = 5
	},
/turf/open/indestructible/necropolis,
/area/ruin/unpowered)
"XB" = (
/obj/structure/stone_tile,
/obj/structure/trap/fire{
	name = "Anctient runic spikes";
	desc = "A strange carving of some symbols. What's that for?";
	alpha = 180;
	icon = 'icons/obj/service/hydroponics/equipment.dmi';
	icon_state = "woodspike";
	light_color = "#FF1111";
	color = "#FF1111";
	max_integrity = 30
	},
/turf/closed/mineral/random/high_chance/volcanic,
/area/lavaland/surface/outdoors)
"Yt" = (
/obj/structure/stone_tile{
	dir = 1
	},
/turf/closed/mineral/random/high_chance/volcanic,
/area/lavaland/surface/outdoors)
"Yw" = (
/obj/structure/stone_tile{
	dir = 8
	},
/turf/closed/mineral/volcanic/lava_land_surface,
/area/lavaland/surface/outdoors)

(1,1,1) = {"
Sr
Sr
Sr
Sr
Sr
Sr
Sr
Sr
Sr
Sr
TF
Xh
Sr
Sr
Sr
"}
(2,1,1) = {"
Sr
Sr
lx
He
tn
qr
qr
qr
Xh
Sr
qr
qr
Yw
Sr
Sr
"}
(3,1,1) = {"
Sr
He
uA
nS
nS
nS
nS
nS
qr
Sr
qr
lq
yI
Sr
Sr
"}
(4,1,1) = {"
kt
Uk
nS
nS
MN
su
eD
nS
qr
Ky
Kk
XB
Sr
Sr
Sr
"}
(5,1,1) = {"
Xc
lq
nS
nS
QG
lC
Ur
nS
qr
qr
LA
kw
Sr
Sr
Sr
"}
(6,1,1) = {"
kt
gs
nS
Iq
dk
ug
Xp
PV
nS
nS
qr
Lx
jP
Sr
Sr
"}
(7,1,1) = {"
kt
nS
Ix
lb
id
EL
Eu
BI
nS
nS
NR
md
Bw
fx
ig
"}
(8,1,1) = {"
Lx
nS
CN
WI
fc
Ss
TY
eR
ys
yh
uz
cv
bd
He
QI
"}
(9,1,1) = {"
kt
nS
Ix
Sv
ir
vP
Ue
Al
nS
nS
NR
Bw
oA
xc
Ps
"}
(10,1,1) = {"
kt
SB
nS
IU
KS
ws
Tp
Ov
nS
nS
qr
He
Sr
Sr
Sr
"}
(11,1,1) = {"
kt
qr
nS
nS
QG
Kz
kI
nS
nS
qr
DQ
bR
He
Sr
Sr
"}
(12,1,1) = {"
kt
Yt
nS
nS
MN
my
QG
nS
qr
aM
Uk
Ky
kw
Io
Sr
"}
(13,1,1) = {"
vM
FQ
LX
nS
nS
nS
nS
nS
qr
He
qr
qr
yt
Lx
Sr
"}
(14,1,1) = {"
Sr
kt
Xo
kt
wl
qr
qr
lq
om
kw
qr
qr
tF
kw
Sr
"}
(15,1,1) = {"
Sr
Sr
Sr
Sr
Sr
Sr
Lx
VK
un
Sr
Mo
tF
Sr
Sr
Sr
"}
