//MAP CONVERTED BY dmm2tgm.py THIS HEADER COMMENT PREVENTS RECONVERSION, DO NOT REMOVE
"a" = (
/turf/template_noop,
/area/template_noop)
"h" = (
/obj/structure/flora/rock/pile/style_random,
/turf/closed/mineral/random/high_chance/volcanic,
/area/lavaland/surface/outdoors)
"k" = (
/turf/open/chasm/lavaland,
/area/lavaland/surface/outdoors)
"n" = (
/turf/closed/mineral/random/high_chance/volcanic,
/area/lavaland/surface/outdoors)
"p" = (
/obj/structure/healingfountain,
/obj/structure/stone_tile/slab,
/turf/closed/mineral/random/high_chance/volcanic,
/area/lavaland/surface/outdoors)
"u" = (
/obj/structure/punji_sticks/spikes,
/turf/closed/mineral/random/high_chance/volcanic,
/area/lavaland/surface/outdoors)
"G" = (
/turf/closed/mineral/volcanic/lava_land_surface,
/area/lavaland/surface/outdoors)
"H" = (
/obj/structure/punji_sticks/spikes,
/turf/closed/mineral/volcanic/lava_land_surface,
/area/lavaland/surface/outdoors)
"M" = (
/obj/structure/flora/rock/style_random,
/turf/closed/mineral/random/high_chance/volcanic,
/area/lavaland/surface/outdoors)
"W" = (
/obj/structure/stone_tile/block/cracked{
	dir = 1
	},
/turf/closed/mineral/random/high_chance/volcanic,
/area/lavaland/surface/outdoors)

(1,1,1) = {"
a
a
a
H
a
"}
(2,1,1) = {"
a
a
G
n
a
"}
(3,1,1) = {"
a
G
k
h
a
"}
(4,1,1) = {"
n
M
k
n
n
"}
(5,1,1) = {"
u
k
k
k
u
"}
(6,1,1) = {"
n
W
p
k
n
"}
(7,1,1) = {"
n
n
k
k
n
"}
(8,1,1) = {"
h
k
k
n
h
"}
(9,1,1) = {"
u
k
k
n
H
"}
(10,1,1) = {"
n
k
h
n
a
"}
(11,1,1) = {"
G
u
n
G
a
"}
(12,1,1) = {"
a
a
H
a
a
"}
