//MAP CONVERTED BY dmm2tgm.py THIS HEADER COMMENT PREVENTS RECONVERSION, DO NOT REMOVE
"ai" = (
/obj/structure/stone_tile/slab,
/mob/living/basic/mining/watcher/magmawing,
/turf/open/misc/asteroid/basalt/lava_land_surface,
/area/ruin/unpowered)
"bY" = (
/obj/structure/stone_tile/block,
/turf/open/misc/asteroid/basalt/lava_land_surface,
/area/lavaland/surface/outdoors)
"cE" = (
/obj/structure/stone_tile,
/obj/structure/stone_tile{
	dir = 1
	},
/obj/structure/stone_tile/burnt{
	dir = 4
	},
/turf/open/lava/smooth/lava_land_surface,
/area/ruin/unpowered)
"dj" = (
/obj/structure/stone_tile/block/cracked,
/obj/structure/stone_tile/block{
	dir = 1
	},
/turf/open/lava/smooth/lava_land_surface,
/area/ruin/unpowered)
"ea" = (
/obj/item/claymore,
/turf/closed/mineral/random/high_chance/volcanic,
/area/ruin/unpowered)
"ew" = (
/obj/structure/stone_tile/slab,
/obj/item/spear/bonespear,
/turf/closed/mineral/random/high_chance/volcanic,
/area/lavaland/surface/outdoors)
"eV" = (
/obj/structure/stone_tile/burnt{
	dir = 4
	},
/obj/structure/stone_tile/burnt{
	dir = 1
	},
/obj/structure/stone_tile,
/obj/structure/stone_tile{
	dir = 8
	},
/turf/open/lava/smooth/lava_land_surface,
/area/ruin/unpowered)
"fx" = (
/obj/structure/stone_tile/block{
	dir = 1
	},
/turf/closed/mineral/volcanic/lava_land_surface,
/area/lavaland/surface/outdoors)
"fy" = (
/obj/structure/stone_tile/slab,
/obj/structure/millstone,
/turf/closed/mineral/random/high_chance/volcanic,
/area/lavaland/surface/outdoors)
"fS" = (
/obj/structure/flora/rock/pile/style_random,
/obj/effect/spawner/random/structure/spikes,
/turf/closed/mineral/random/high_chance/volcanic,
/area/lavaland/surface/outdoors)
"fY" = (
/obj/effect/spawner/random/mob/necropolis_mob,
/turf/closed/mineral/random/high_chance/volcanic,
/area/lavaland/surface/outdoors)
"hj" = (
/obj/structure/stone_tile/burnt,
/turf/open/lava/smooth/lava_land_surface,
/area/lavaland/surface/outdoors)
"hW" = (
/obj/structure/stone_tile,
/obj/structure/stone_tile{
	dir = 4
	},
/obj/structure/stone_tile{
	dir = 8
	},
/obj/structure/stone_tile{
	dir = 1
	},
/turf/closed/mineral/volcanic/lava_land_surface,
/area/lavaland/surface/outdoors)
"jh" = (
/obj/structure/stone_tile/slab,
/obj/effect/spawner/random/mob/necropolis_mob,
/turf/closed/mineral/volcanic/lava_land_surface,
/area/lavaland/surface/outdoors)
"jt" = (
/obj/structure/stone_tile/burnt,
/turf/open/lava/smooth/lava_land_surface,
/area/ruin/unpowered)
"jX" = (
/obj/structure/large_mortar,
/turf/closed/mineral/volcanic/lava_land_surface,
/area/lavaland/surface/outdoors)
"ki" = (
/obj/item/xenoarch/useless_relic{
	name = "Ancient relic";
	desc = "Sort of relic that can be exported through Cargo."
	},
/turf/closed/mineral/volcanic/lava_land_surface,
/area/lavaland/surface/outdoors)
"kj" = (
/obj/structure/stone_tile/block{
	dir = 1
	},
/obj/item/xenoarch/useless_relic{
	name = "Ancient relic";
	desc = "Sort of relic that can be exported through Cargo."
	},
/turf/closed/mineral/random/high_chance/volcanic,
/area/lavaland/surface/outdoors)
"ku" = (
/obj/structure/stone_tile,
/obj/structure/stone_tile{
	dir = 4
	},
/obj/structure/stone_tile{
	dir = 8
	},
/obj/structure/stone_tile{
	dir = 1
	},
/turf/open/misc/asteroid/basalt/lava_land_surface,
/area/ruin/unpowered)
"ld" = (
/obj/structure/stone_tile/block,
/turf/closed/mineral/volcanic/lava_land_surface,
/area/lavaland/surface/outdoors)
"ls" = (
/turf/open/lava/smooth/lava_land_surface,
/area/lavaland/surface/outdoors)
"lH" = (
/obj/effect/spawner/random/structure/spikes,
/turf/closed/mineral/volcanic/lava_land_surface,
/area/ruin/unpowered)
"lK" = (
/obj/structure/stone_tile{
	dir = 1
	},
/turf/open/lava/smooth/lava_land_surface,
/area/ruin/unpowered)
"mJ" = (
/obj/structure/flora/ash/cacti,
/turf/open/misc/asteroid/basalt/lava_land_surface,
/area/lavaland/surface/outdoors)
"mS" = (
/obj/structure/stone_tile/slab,
/obj/item/xenoarch/useless_relic{
	name = "Ancient relic";
	desc = "Sort of relic that can be exported through Cargo."
	},
/turf/closed/mineral/volcanic/lava_land_surface,
/area/lavaland/surface/outdoors)
"nl" = (
/obj/structure/stone_tile/slab,
/obj/structure/necropolis_gate/locked,
/turf/open/misc/asteroid/basalt/lava_land_surface,
/area/ruin/unpowered)
"nV" = (
/obj/effect/spawner/random/structure/spikes,
/turf/closed/mineral/volcanic/lava_land_surface,
/area/lavaland/surface/outdoors)
"oj" = (
/obj/structure/stone_tile/slab,
/turf/closed/mineral/random/high_chance/volcanic,
/area/lavaland/surface/outdoors)
"oK" = (
/obj/structure/stone_tile/slab/cracked{
	dir = 5
	},
/obj/structure/stone_tile/slab/cracked{
	dir = 10
	},
/turf/open/lava/smooth/lava_land_surface,
/area/ruin/unpowered)
"oT" = (
/obj/structure/flora/ash/cap_shroom,
/turf/open/misc/asteroid/basalt/lava_land_surface,
/area/lavaland/surface/outdoors)
"oZ" = (
/obj/effect/mapping_helpers/bombable_wall,
/turf/closed/indestructible/riveted/boss/wasteland,
/area/lavaland/surface/outdoors)
"pg" = (
/obj/effect/spawner/random/mob/necropolis_mob,
/turf/closed/mineral/volcanic/lava_land_surface,
/area/lavaland/surface/outdoors)
"qO" = (
/obj/structure/stone_tile/block/cracked,
/obj/structure/stone_tile{
	dir = 1
	},
/turf/open/lava/smooth/lava_land_surface,
/area/ruin/unpowered)
"qP" = (
/obj/structure/stone_tile/slab,
/obj/item/fireaxe/boneaxe,
/obj/effect/spawner/random/mob/necropolis_mob,
/turf/closed/mineral/random/high_chance/volcanic,
/area/lavaland/surface/outdoors)
"rh" = (
/obj/item/reagent_containers/cup/glass/drinkingglass/filled/nuka_cola{
	name = "Mountain Dew"
	},
/turf/closed/mineral/volcanic/lava_land_surface,
/area/ruin/unpowered)
"rt" = (
/obj/structure/flora/rock/pile/style_random,
/turf/closed/mineral/random/high_chance/volcanic,
/area/lavaland/surface/outdoors)
"sp" = (
/obj/structure/flora/rock/pile/style_random,
/obj/item/xenoarch/useless_relic/magnified{
	name = "Ancient relic";
	desc = "Sort of relic that can be exported through Cargo."
	},
/turf/open/misc/asteroid/basalt/lava_land_surface,
/area/lavaland/surface/outdoors)
"sS" = (
/obj/structure/stone_tile/slab,
/turf/closed/mineral/volcanic/lava_land_surface,
/area/lavaland/surface/outdoors)
"sW" = (
/obj/structure/stone_tile/block/cracked,
/turf/open/lava/smooth/lava_land_surface,
/area/ruin/unpowered)
"tw" = (
/obj/structure/stone_tile/block,
/obj/structure/stone_tile/block/burnt{
	dir = 1
	},
/turf/open/lava/smooth/lava_land_surface,
/area/ruin/unpowered)
"tC" = (
/obj/structure/stone_tile/block/cracked{
	dir = 1
	},
/obj/structure/stone_tile/burnt,
/turf/open/lava/smooth/lava_land_surface,
/area/ruin/unpowered)
"ub" = (
/obj/structure/stone_tile/slab,
/turf/open/misc/asteroid/basalt/lava_land_surface,
/area/lavaland/surface/outdoors)
"uq" = (
/turf/open/misc/asteroid/basalt/lava_land_surface,
/area/lavaland/surface/outdoors)
"uP" = (
/turf/open/lava/smooth/lava_land_surface,
/area/ruin/unpowered)
"uV" = (
/obj/structure/flora/ash/cacti,
/turf/closed/mineral/volcanic/lava_land_surface,
/area/lavaland/surface/outdoors)
"ve" = (
/obj/structure/flora/rock/pile/style_random,
/obj/effect/spawner/random/mob/necropolis_mob,
/turf/closed/mineral/random/high_chance/volcanic,
/area/lavaland/surface/outdoors)
"vf" = (
/obj/item/ammo_casing/arrow/bone,
/obj/effect/spawner/random/structure/spikes,
/turf/closed/mineral/volcanic/lava_land_surface,
/area/lavaland/surface/outdoors)
"vT" = (
/obj/structure/stone_tile/slab,
/turf/closed/mineral/volcanic/lava_land_surface,
/area/ruin/unpowered)
"wT" = (
/obj/item/organ/external/spines,
/turf/closed/mineral/random/high_chance/volcanic,
/area/lavaland/surface/outdoors)
"ye" = (
/obj/structure/stone_tile/slab,
/obj/structure/closet/crate/wooden/storage_barrel,
/turf/closed/mineral/volcanic/lava_land_surface,
/area/lavaland/surface/outdoors)
"yf" = (
/obj/effect/spawner/random/mob/necropolis_mob,
/turf/open/misc/asteroid/basalt/lava_land_surface,
/area/lavaland/surface/outdoors)
"yp" = (
/obj/structure/stone_tile/slab/cracked,
/turf/open/lava/smooth/lava_land_surface,
/area/ruin/unpowered)
"yJ" = (
/obj/structure/flora/ash/leaf_shroom,
/turf/closed/mineral/volcanic/lava_land_surface,
/area/ruin/unpowered)
"yN" = (
/obj/effect/spawner/random/structure/spikes,
/turf/closed/mineral/random/high_chance/volcanic,
/area/lavaland/surface/outdoors)
"Aa" = (
/obj/structure/stone_tile/block/cracked{
	dir = 1
	},
/obj/structure/stone_tile/burnt{
	dir = 8
	},
/turf/open/lava/smooth/lava_land_surface,
/area/ruin/unpowered)
"AA" = (
/obj/effect/spawner/random/structure/orevein_longregen,
/turf/closed/mineral/random/high_chance/volcanic,
/area/lavaland/surface/outdoors)
"AG" = (
/obj/structure/stone_tile/slab,
/obj/item/xenoarch/useless_relic{
	name = "Ancient relic";
	desc = "Sort of relic that can be exported through Cargo."
	},
/turf/closed/mineral/random/high_chance/volcanic,
/area/lavaland/surface/outdoors)
"AY" = (
/obj/structure/stone_tile/slab,
/mob/living/basic/mining/watcher/magmawing{
	name = "Spirit of fire";
	desc = "Presented with extreme temperatures, adaptive watchers absorb heat through their circulatory wings and repurpose it as a weapon. This one definitely primed. ";
	current_size = 1.25;
	base_pixel_y = -7.5;
	speed = -1;
	health = 320;
	maxHealth = 320;
	guaranteed_butcher_results = list(/obj/item/stack/sheet/sinew = 2,/obj/structure/flora/ash/fireblossom=4,/obj/item/book/granter/action/spell/sacredflame=1,/obj/item/crusher_trophy/blaster_tubes/magma_wing=1);
	light_power = 7
	},
/turf/open/lava/smooth/lava_land_surface,
/area/ruin/unpowered)
"DM" = (
/turf/closed/indestructible/riveted/boss,
/area/lavaland/surface/outdoors)
"EL" = (
/obj/structure/flora/rock/style_random,
/turf/open/misc/asteroid/basalt/lava_land_surface,
/area/lavaland/surface/outdoors)
"Gi" = (
/obj/structure/stone_tile/slab,
/turf/closed/mineral/random/high_chance/volcanic,
/area/ruin/unpowered)
"GR" = (
/obj/structure/stone_tile/burnt{
	dir = 8
	},
/turf/open/lava/smooth/lava_land_surface,
/area/ruin/unpowered)
"Hd" = (
/obj/item/stack/sheet/bone,
/turf/closed/mineral/random/high_chance/volcanic,
/area/lavaland/surface/outdoors)
"HB" = (
/obj/structure/flora/rock/pile/style_random,
/obj/effect/spawner/random/structure/spikes,
/turf/closed/mineral/volcanic/lava_land_surface,
/area/lavaland/surface/outdoors)
"HX" = (
/obj/structure/stone_tile/block{
	dir = 1
	},
/turf/closed/mineral/random/high_chance/volcanic,
/area/lavaland/surface/outdoors)
"Il" = (
/obj/structure/stone_tile/burnt{
	dir = 1
	},
/turf/closed/mineral/volcanic/lava_land_surface,
/area/lavaland/surface/outdoors)
"JK" = (
/obj/structure/stone_tile{
	dir = 4
	},
/turf/closed/mineral/volcanic/lava_land_surface,
/area/lavaland/surface/outdoors)
"KX" = (
/turf/template_noop,
/area/template_noop)
"Lt" = (
/turf/closed/indestructible/riveted/boss,
/area/ruin/unpowered)
"LA" = (
/obj/structure/stone_tile/slab/cracked{
	dir = 4
	},
/obj/structure/stone_tile/slab/cracked{
	dir = 8
	},
/turf/open/lava/smooth/lava_land_surface,
/area/ruin/unpowered)
"LB" = (
/obj/structure/flora/rock/pile/style_random,
/mob/living/basic/mining/ancient_demon/demoraptor,
/turf/open/misc/asteroid/basalt/lava_land_surface,
/area/lavaland/surface/outdoors)
"MJ" = (
/obj/structure/flora/rock/pile/style_random,
/turf/closed/mineral/volcanic/lava_land_surface,
/area/lavaland/surface/outdoors)
"MR" = (
/obj/structure/flora/ash/tall_shroom,
/obj/item/food/grown/mushroom/amanita,
/turf/closed/mineral/volcanic/lava_land_surface,
/area/lavaland/surface/outdoors)
"Ou" = (
/obj/structure/stone_tile/slab,
/obj/item/stack/sheet/bone,
/turf/closed/mineral/random/high_chance/volcanic,
/area/lavaland/surface/outdoors)
"Pl" = (
/obj/structure/flora/ash/stem_shroom,
/obj/effect/spawner/random/structure/spikes,
/turf/closed/mineral/volcanic/lava_land_surface,
/area/lavaland/surface/outdoors)
"Qs" = (
/obj/effect/spawner/random/structure/orevein_longregen,
/turf/open/misc/asteroid/basalt/lava_land_surface,
/area/lavaland/surface/outdoors)
"Rh" = (
/obj/structure/stone_tile/slab/cracked{
	dir = 4
	},
/obj/structure/stone_tile/slab/cracked{
	dir = 8
	},
/obj/structure/stone_tile/slab/cracked{
	dir = 1
	},
/turf/open/lava/smooth/lava_land_surface,
/area/ruin/unpowered)
"Tv" = (
/obj/structure/stone_tile/slab,
/turf/open/misc/asteroid/basalt/lava_land_surface,
/area/ruin/unpowered)
"TE" = (
/obj/structure/flora/rock/pile/style_random,
/obj/effect/spawner/random/structure/spikes,
/turf/closed/mineral/volcanic/lava_land_surface,
/area/ruin/unpowered)
"Ue" = (
/obj/effect/spawner/random/structure/orevein_longregen,
/turf/closed/mineral/volcanic/lava_land_surface,
/area/lavaland/surface/outdoors)
"Uh" = (
/obj/structure/stone_tile/block/burnt{
	dir = 8
	},
/turf/open/lava/smooth/lava_land_surface,
/area/ruin/unpowered)
"Uo" = (
/obj/structure/stone_tile/block,
/obj/effect/spawner/random/mob/necropolis_mob,
/turf/closed/mineral/volcanic/lava_land_surface,
/area/lavaland/surface/outdoors)
"UP" = (
/obj/structure/stone_tile/slab/cracked{
	dir = 5
	},
/turf/open/lava/smooth/lava_land_surface,
/area/ruin/unpowered)
"Vv" = (
/obj/structure/stone_tile/block,
/turf/closed/mineral/random/high_chance/volcanic,
/area/lavaland/surface/outdoors)
"WP" = (
/obj/structure/stone_tile/slab,
/mob/living/basic/mining/watcher/magmawing,
/turf/open/lava/smooth/lava_land_surface,
/area/ruin/unpowered)
"XW" = (
/obj/structure/stone_tile/block/cracked{
	dir = 1
	},
/obj/structure/stone_tile/block,
/turf/open/lava/smooth/lava_land_surface,
/area/ruin/unpowered)
"Yj" = (
/obj/structure/stone_tile/block/cracked{
	dir = 1
	},
/turf/open/lava/smooth/lava_land_surface,
/area/ruin/unpowered)
"ZE" = (
/obj/structure/stone_tile/slab/cracked{
	dir = 1
	},
/turf/open/lava/smooth/lava_land_surface,
/area/ruin/unpowered)
"ZX" = (
/obj/structure/stone_tile/slab,
/turf/open/lava/smooth/lava_land_surface,
/area/ruin/unpowered)

(1,1,1) = {"
KX
KX
KX
nV
oZ
HB
KX
KX
nV
nV
Ue
oZ
nV
KX
KX
KX
"}
(2,1,1) = {"
KX
KX
KX
JK
oZ
oZ
DM
Lt
Lt
yp
nV
DM
DM
nV
KX
KX
"}
(3,1,1) = {"
KX
KX
KX
eV
sS
oZ
ew
ki
Lt
dj
KX
DM
ye
vf
KX
KX
"}
(4,1,1) = {"
KX
KX
KX
WP
Pl
oZ
oj
jh
hW
KX
KX
hW
oj
AA
nV
KX
"}
(5,1,1) = {"
KX
KX
KX
ZX
rh
DM
uV
Ou
Lt
ZX
KX
Lt
mS
oj
DM
nV
"}
(6,1,1) = {"
KX
nV
KX
Yj
Lt
DM
DM
DM
Lt
lK
ZX
Lt
DM
ve
DM
DM
"}
(7,1,1) = {"
oZ
fx
KX
ZX
ZX
oZ
oj
Ue
Lt
uP
cE
Lt
wT
oj
DM
ld
"}
(8,1,1) = {"
DM
fx
KX
yp
ZX
DM
qP
rt
sW
ZE
uP
ku
Ou
sS
DM
bY
"}
(9,1,1) = {"
KX
fx
DM
uP
nV
DM
AG
MR
Lt
jt
oK
Lt
fy
nV
DM
LB
"}
(10,1,1) = {"
KX
fx
DM
Aa
DM
Lt
Lt
Lt
Lt
ai
Gi
Lt
DM
nV
DM
bY
"}
(11,1,1) = {"
oZ
fx
KX
KX
fS
AA
uP
Rh
ZX
Tv
Gi
oj
ub
ub
oZ
Uo
"}
(12,1,1) = {"
HB
Ue
KX
KX
ZX
yN
yN
TE
jt
uP
tC
ub
KX
KX
DM
Ue
"}
(13,1,1) = {"
oZ
nV
DM
WP
ZX
Lt
Lt
uP
DM
DM
DM
DM
KX
DM
DM
Vv
"}
(14,1,1) = {"
oZ
HX
DM
ZX
yp
Lt
qO
uP
EL
DM
DM
hj
KX
sp
DM
Vv
"}
(15,1,1) = {"
DM
HX
oZ
KX
yJ
Lt
sW
uP
LA
Qs
ls
ls
ls
mJ
DM
nV
"}
(16,1,1) = {"
DM
kj
DM
lH
Lt
Lt
Lt
GR
ZX
ZX
yp
ZX
XW
Lt
Lt
yf
"}
(17,1,1) = {"
nV
HX
DM
KX
KX
vT
vT
ZX
ZX
ZX
AY
ZX
ZX
Tv
nl
uq
"}
(18,1,1) = {"
nV
nV
DM
KX
Lt
Lt
Lt
Il
ZX
Tv
ZX
ZX
tw
Lt
Lt
uq
"}
(19,1,1) = {"
Ue
nV
Ue
KX
KX
Lt
ea
Hd
MJ
oT
uP
uP
uP
UP
DM
nV
"}
(20,1,1) = {"
nV
pg
yN
KX
Yj
Lt
ls
rt
AA
DM
Lt
sW
uP
uP
nV
nV
"}
(21,1,1) = {"
nV
yN
yN
ZX
ZX
Lt
DM
DM
DM
DM
mJ
KX
Uh
Lt
nV
KX
"}
(22,1,1) = {"
nV
Ue
oZ
sW
oK
ZX
jX
DM
oj
sS
sS
KX
KX
KX
nV
KX
"}
(23,1,1) = {"
KX
nV
oZ
uP
uP
yp
nV
fY
yN
DM
DM
DM
DM
KX
KX
KX
"}
(24,1,1) = {"
KX
KX
oZ
KX
KX
KX
KX
oZ
KX
DM
pg
KX
KX
KX
KX
KX
"}
