//MAP CONVERTED BY dmm2tgm.py THIS HEADER COMMENT PREVENTS RECONVERSION, DO NOT REMOVE
"aM" = (
/obj/structure/stone_tile,
/obj/effect/spawner/random/structure/spikes,
/turf/closed/mineral/random/high_chance/volcanic,
/area/lavaland/surface/outdoors)
"bd" = (
/obj/structure/stone_tile/center/cracked,
/obj/structure/stone_tile/surrounding/cracked{
	dir = 6
	},
/turf/closed/mineral/random/high_chance/volcanic,
/area/lavaland/surface/outdoors)
"bR" = (
/obj/structure/flora/ash/cacti,
/turf/closed/mineral/volcanic/lava_land_surface,
/area/lavaland/surface/outdoors)
"cv" = (
/obj/structure/stone_tile/surrounding,
/obj/structure/stone_tile/center,
/obj/effect/decal/cleanable/blood/gibs/limb{
	pixel_y = 10
	},
/obj/effect/decal/cleanable/blood/old{
	pixel_x = -5;
	pixel_y = 15
	},
/obj/effect/decal/cleanable/blood/old{
	icon_state = "floor4-old";
	pixel_y = 10;
	pixel_x = 5
	},
/obj/effect/decal/cleanable/blood/tracks{
	desc = "Your instincts say you shouldn't be following these.";
	icon_state = "ltrails_1";
	dir = 10;
	pixel_y = 15
	},
/turf/open/misc/asteroid/basalt/lava_land_surface,
/area/lavaland/surface/outdoors)
"dk" = (
/obj/structure/stone_tile/block/cracked{
	dir = 4
	},
/obj/structure/stone_tile/cracked{
	dir = 4
	},
/obj/structure/stone_tile{
	dir = 8
	},
/obj/item/organ/internal/tongue/cat/tajaran,
/turf/open/indestructible/necropolis,
/area/ruin/unpowered)
"eD" = (
/obj/structure/stone_tile/slab/burnt,
/obj/effect/gibspawner,
/turf/open/indestructible/boss,
/area/ruin/unpowered)
"eR" = (
/obj/structure/stone_tile/slab/cracked,
/obj/effect/gibspawner,
/turf/open/indestructible/necropolis,
/area/ruin/unpowered)
"fc" = (
/obj/structure/stone_tile/block/cracked,
/obj/effect/decal/cleanable/blood/tracks{
	desc = "Your instincts say you shouldn't be following these.";
	icon_state = "ltrails_1";
	dir = 6
	},
/obj/item/soulstone,
/turf/open/indestructible/necropolis,
/area/ruin/unpowered)
"fx" = (
/obj/structure/stone_tile{
	dir = 8
	},
/obj/effect/spawner/random/structure/spikes,
/turf/open/misc/asteroid/basalt/lava_land_surface,
/area/lavaland/surface/outdoors)
"gs" = (
/obj/structure/stone_tile/block{
	dir = 1
	},
/turf/closed/mineral/random/high_chance/volcanic,
/area/lavaland/surface/outdoors)
"id" = (
/obj/structure/stone_tile/surrounding_tile/cracked,
/obj/structure/stone_tile/center,
/obj/structure/stone_tile/surrounding_tile{
	dir = 1
	},
/obj/structure/stone_tile/surrounding_tile{
	dir = 8
	},
/obj/item/trash/candle{
	pixel_y = 12
	},
/turf/open/indestructible/necropolis,
/area/ruin/unpowered)
"ig" = (
/obj/structure/stone_tile,
/obj/structure/stone_tile{
	dir = 4
	},
/obj/structure/stone_tile{
	dir = 1
	},
/mob/living/basic/mining/ancient_demon/ancient_demon_lesser,
/turf/open/misc/asteroid/basalt/lava_land_surface,
/area/lavaland/surface/outdoors)
"ir" = (
/obj/structure/stone_tile/surrounding_tile/cracked,
/obj/structure/stone_tile/surrounding_tile/cracked{
	dir = 4
	},
/obj/structure/stone_tile/center,
/obj/structure/stone_tile/surrounding_tile{
	dir = 8
	},
/obj/item/organ/internal/tongue/dwarven,
/obj/effect/glowing_rune,
/turf/open/indestructible/necropolis,
/area/ruin/unpowered)
"jP" = (
/obj/structure/flora/ash/cap_shroom,
/obj/effect/spawner/random/structure/spikes,
/turf/closed/mineral/volcanic/lava_land_surface,
/area/lavaland/surface/outdoors)
"kt" = (
/obj/effect/spawner/random/structure/spikes,
/turf/closed/mineral/volcanic/lava_land_surface,
/area/lavaland/surface/outdoors)
"kw" = (
/obj/structure/flora/rock/pile/style_random,
/turf/closed/mineral/volcanic/lava_land_surface,
/area/lavaland/surface/outdoors)
"kI" = (
/obj/structure/stone_tile/slab/burnt,
/obj/item/stack/sheet/mineral/runite{
	amount = 5
	},
/turf/open/indestructible/boss,
/area/ruin/unpowered)
"lb" = (
/obj/structure/stone_tile/block,
/obj/structure/stone_tile{
	dir = 1
	},
/obj/structure/stone_tile{
	dir = 4
	},
/obj/item/stack/sheet/mineral/runite{
	amount = 5
	},
/obj/item/organ/internal/tongue/alien,
/turf/open/indestructible/necropolis,
/area/ruin/unpowered)
"lq" = (
/obj/effect/mapping_helpers/bombable_wall,
/turf/closed/indestructible/riveted/boss/wasteland,
/area/lavaland/surface/outdoors)
"lx" = (
/obj/item/xenoarch/useless_relic{
	name = "Ancient relic";
	desc = "Sort of relic that can be exported through Cargo."
	},
/turf/closed/mineral/volcanic/lava_land_surface,
/area/lavaland/surface/outdoors)
"lC" = (
/obj/structure/stone_tile/slab/burnt,
/obj/effect/decal/cleanable/blood/gibs/up,
/obj/effect/glowing_rune,
/turf/open/indestructible/boss,
/area/ruin/unpowered)
"md" = (
/obj/structure/stone_tile/block,
/obj/effect/spawner/random/structure/spikes,
/turf/closed/mineral/random/high_chance/volcanic,
/area/lavaland/surface/outdoors)
"my" = (
/obj/structure/stone_tile/slab/burnt,
/obj/effect/decal/cleanable/blood/old{
	icon_state = "gibbl1"
	},
/obj/item/organ/internal/tongue/jelly,
/obj/item/xenoarch/useless_relic/magnified,
/turf/open/indestructible/boss,
/area/ruin/unpowered)
"nS" = (
/turf/closed/indestructible/riveted/boss,
/area/ruin/unpowered)
"oA" = (
/obj/structure/stone_tile/block/cracked,
/obj/effect/spawner/random/structure/spikes,
/turf/closed/mineral/volcanic/lava_land_surface,
/area/lavaland/surface/outdoors)
"qr" = (
/turf/closed/indestructible/riveted/boss,
/area/lavaland/surface/outdoors)
"su" = (
/obj/structure/stone_tile/slab/burnt,
/obj/item/organ/internal/tongue/insect,
/obj/item/xenoarch/useless_relic/magnified,
/turf/open/indestructible/necropolis,
/area/ruin/unpowered)
"tn" = (
/obj/structure/stone_tile/block/cracked{
	dir = 8
	},
/mob/living/basic/mining/ancient_demon/ancient_demon_lesser,
/turf/closed/mineral/volcanic/lava_land_surface,
/area/lavaland/surface/outdoors)
"tF" = (
/obj/structure/stone_tile,
/obj/effect/spawner/random/structure/spikes,
/turf/closed/mineral/volcanic/lava_land_surface,
/area/lavaland/surface/outdoors)
"ug" = (
/obj/structure/stone_tile/block{
	dir = 4
	},
/obj/structure/stone_tile{
	dir = 8
	},
/obj/structure/stone_tile{
	dir = 4
	},
/obj/effect/decal/cleanable/blood/old{
	icon_state = "floor4-old"
	},
/obj/item/organ/internal/tongue/snail,
/turf/open/indestructible/necropolis,
/area/ruin/unpowered)
"un" = (
/obj/effect/spawner/random/structure/spikes,
/turf/closed/mineral/random/high_chance/volcanic,
/area/lavaland/surface/outdoors)
"uz" = (
/obj/effect/mapping_helpers/bombable_wall,
/obj/structure/necropolis_arch,
/turf/closed/indestructible/riveted/boss/wasteland,
/area/ruin/unpowered)
"uA" = (
/obj/structure/stone_tile/cracked{
	dir = 4
	},
/turf/closed/mineral/volcanic/lava_land_surface,
/area/lavaland/surface/outdoors)
"vP" = (
/obj/structure/stone_tile/block{
	dir = 8
	},
/obj/item/trash/candle{
	pixel_x = 9;
	pixel_y = -1
	},
/obj/item/soulstone,
/turf/open/indestructible/necropolis,
/area/ruin/unpowered)
"wl" = (
/obj/structure/stone_tile/block{
	dir = 4
	},
/mob/living/basic/mining/ancient_demon/ancient_demon_lesser,
/turf/closed/mineral/volcanic/lava_land_surface,
/area/lavaland/surface/outdoors)
"ws" = (
/obj/structure/stone_tile/block{
	dir = 8
	},
/obj/structure/stone_tile,
/obj/structure/stone_tile{
	dir = 1
	},
/obj/item/organ/internal/tongue/golem,
/turf/open/indestructible/necropolis,
/area/ruin/unpowered)
"xc" = (
/obj/structure/stone_tile,
/obj/effect/spawner/random/structure/spikes,
/turf/open/misc/asteroid/basalt/lava_land_surface,
/area/lavaland/surface/outdoors)
"yh" = (
/obj/effect/mapping_helpers/bombable_wall,
/turf/closed/indestructible/riveted/boss/wasteland,
/area/ruin/unpowered)
"ys" = (
/obj/structure/stone_tile/block{
	dir = 4
	},
/obj/structure/stone_tile/block/cracked{
	dir = 8
	},
/turf/open/indestructible/boss,
/area/ruin/unpowered)
"yt" = (
/obj/structure/stone_tile{
	dir = 8
	},
/obj/item/xenoarch/useless_relic{
	name = "Ancient relic";
	desc = "Sort of relic that can be exported through Cargo."
	},
/turf/closed/mineral/random/high_chance/volcanic,
/area/lavaland/surface/outdoors)
"yI" = (
/obj/structure/stone_tile/cracked,
/obj/effect/spawner/random/structure/spikes,
/turf/closed/mineral/random/high_chance/volcanic,
/area/lavaland/surface/outdoors)
"Al" = (
/obj/structure/stone_tile/block/cracked{
	dir = 1
	},
/obj/structure/stone_tile{
	dir = 8
	},
/obj/structure/stone_tile,
/obj/effect/decal/cleanable/blood/old,
/obj/item/organ/internal/tongue/human,
/turf/open/indestructible/necropolis,
/area/ruin/unpowered)
"Bw" = (
/obj/structure/stone_tile/block/cracked,
/obj/effect/spawner/random/structure/spikes,
/turf/closed/mineral/random/high_chance/volcanic,
/area/lavaland/surface/outdoors)
"BI" = (
/obj/structure/stone_tile/block{
	dir = 1
	},
/obj/structure/stone_tile/cracked,
/obj/structure/stone_tile{
	dir = 8
	},
/obj/effect/decal/cleanable/blood/gibs/down,
/turf/open/indestructible/necropolis,
/area/ruin/unpowered)
"CN" = (
/obj/structure/stone_tile,
/obj/structure/stone_tile{
	dir = 8
	},
/obj/structure/stone_tile/cracked{
	dir = 4
	},
/obj/structure/stone_tile/cracked{
	dir = 1
	},
/obj/structure/mirror/broken/directional/north,
/obj/structure/fluff/divine/nexus{
	light_color = "#FF0000";
	icon = 'icons/obj/antags/cult/structures.dmi';
	icon_state = "altar"
	},
/obj/item/dice/d20/fate,
/turf/open/indestructible/boss,
/area/ruin/unpowered)
"DQ" = (
/obj/structure/stone_tile/surrounding_tile/cracked,
/obj/effect/spawner/random/structure/spikes,
/turf/closed/mineral/random/high_chance/volcanic,
/area/lavaland/surface/outdoors)
"Eu" = (
/obj/structure/stone_tile/surrounding_tile/cracked{
	dir = 4
	},
/obj/structure/stone_tile/center/cracked,
/obj/structure/stone_tile/surrounding_tile,
/obj/structure/stone_tile/surrounding_tile{
	dir = 1
	},
/obj/item/trash/candle{
	pixel_x = 9;
	pixel_y = -1
	},
/obj/item/organ/internal/tongue/ethereal,
/obj/effect/glowing_rune,
/turf/open/indestructible/necropolis,
/area/ruin/unpowered)
"EL" = (
/obj/structure/stone_tile/block/cracked{
	dir = 4
	},
/obj/item/soulstone,
/turf/open/indestructible/necropolis,
/area/ruin/unpowered)
"FQ" = (
/obj/structure/flora/ash/seraka,
/obj/effect/spawner/random/structure/spikes,
/turf/closed/mineral/random/high_chance/volcanic,
/area/lavaland/surface/outdoors)
"He" = (
/obj/effect/spawner/random/structure/spikes,
/turf/open/misc/asteroid/basalt/lava_land_surface,
/area/lavaland/surface/outdoors)
"Io" = (
/obj/effect/spawner/random/structure/spikes,
/turf/closed/mineral/strange_rock/volcanic,
/area/lavaland/surface/outdoors)
"Iq" = (
/obj/structure/stone_tile,
/obj/structure/stone_tile{
	dir = 8
	},
/obj/structure/stone_tile/cracked{
	dir = 4
	},
/obj/structure/stone_tile/cracked{
	dir = 1
	},
/obj/structure/destructible/cult/pylon,
/obj/item/clothing/head/hooded/cult_hoodie/hardened,
/turf/open/indestructible/boss,
/area/ruin/unpowered)
"Ix" = (
/obj/structure/fluff/big_chain{
	pixel_y = 12
	},
/turf/closed/indestructible/riveted/boss,
/area/ruin/unpowered)
"IU" = (
/obj/structure/stone_tile,
/obj/structure/stone_tile{
	dir = 1
	},
/obj/structure/stone_tile/cracked{
	dir = 4
	},
/obj/structure/stone_tile/cracked{
	dir = 8
	},
/obj/structure/destructible/cult/pylon,
/obj/item/clothing/head/hooded/cult_hoodie/hardened,
/turf/open/indestructible/boss,
/area/ruin/unpowered)
"Kk" = (
/obj/structure/stone_tile/cracked{
	dir = 1
	},
/obj/effect/spawner/random/structure/spikes,
/turf/closed/mineral/random/high_chance/volcanic,
/area/lavaland/surface/outdoors)
"Ky" = (
/obj/structure/flora/rock/pile/style_random,
/obj/effect/spawner/random/structure/spikes,
/turf/closed/mineral/volcanic/lava_land_surface,
/area/lavaland/surface/outdoors)
"Kz" = (
/obj/structure/stone_tile/slab/burnt,
/obj/effect/decal/cleanable/blood/old{
	icon_state = "gib2"
	},
/obj/effect/decal/cleanable/blood/old{
	icon_state = "gibbl4"
	},
/turf/open/indestructible/boss,
/area/ruin/unpowered)
"KS" = (
/obj/structure/stone_tile/block/cracked{
	dir = 8
	},
/obj/structure/stone_tile/cracked{
	dir = 1
	},
/obj/structure/stone_tile,
/obj/item/stack/sheet/mineral/runite{
	amount = 5
	},
/turf/open/indestructible/necropolis,
/area/ruin/unpowered)
"LA" = (
/obj/structure/stone_tile/surrounding_tile{
	dir = 8
	},
/obj/effect/spawner/random/structure/spikes,
/turf/closed/mineral/strange_rock/volcanic,
/area/lavaland/surface/outdoors)
"LX" = (
/obj/structure/stone_tile/surrounding_tile{
	dir = 1
	},
/turf/closed/mineral/volcanic/lava_land_surface,
/area/lavaland/surface/outdoors)
"Mo" = (
/obj/structure/stone_tile/cracked{
	dir = 1
	},
/mob/living/basic/mining/ancient_demon/ancient_demon_lesser,
/turf/closed/mineral/volcanic/lava_land_surface,
/area/lavaland/surface/outdoors)
"MN" = (
/obj/structure/stone_tile/slab/burnt,
/obj/effect/gibspawner,
/turf/open/indestructible/necropolis,
/area/ruin/unpowered)
"NR" = (
/obj/effect/mapping_helpers/bombable_wall,
/obj/structure/fluff/big_chain{
	pixel_y = 12
	},
/turf/closed/indestructible/riveted/boss/wasteland,
/area/ruin/unpowered)
"Ov" = (
/obj/structure/stone_tile,
/obj/structure/stone_tile{
	dir = 8
	},
/obj/structure/stone_tile{
	dir = 1
	},
/obj/structure/stone_tile/cracked{
	dir = 4
	},
/obj/effect/decal/cleanable/blood/tracks{
	desc = "Your instincts say you shouldn't be following these.";
	dir = 8;
	icon_state = "ltrails_2"
	},
/obj/item/organ/internal/tongue/hemophage,
/turf/open/indestructible/boss,
/area/ruin/unpowered)
"Ps" = (
/obj/structure/stone_tile{
	dir = 4
	},
/obj/structure/stone_tile{
	dir = 8
	},
/obj/structure/stone_tile{
	dir = 1
	},
/obj/item/stack/sheet/animalhide/goliath_hide,
/mob/living/basic/mining/ancient_demon/ancient_demon_lesser,
/turf/open/misc/asteroid/basalt/lava_land_surface,
/area/lavaland/surface/outdoors)
"PV" = (
/obj/structure/stone_tile,
/obj/structure/stone_tile{
	dir = 8
	},
/obj/structure/stone_tile{
	dir = 1
	},
/obj/structure/stone_tile{
	dir = 4
	},
/obj/effect/decal/cleanable/blood/gibs,
/obj/effect/glowing_rune,
/obj/item/sharpener/cult,
/turf/open/indestructible/boss,
/area/ruin/unpowered)
"QG" = (
/obj/structure/stone_tile/slab/burnt,
/obj/effect/gibspawner/human,
/turf/open/indestructible/necropolis,
/area/ruin/unpowered)
"QI" = (
/obj/effect/gibspawner/human/bodypartless,
/obj/effect/spawner/random/structure/spikes,
/turf/open/misc/asteroid/basalt/lava_land_surface,
/area/lavaland/surface/outdoors)
"Sr" = (
/turf/template_noop,
/area/template_noop)
"Ss" = (
/obj/effect/decal/cleanable/blood/tracks{
	desc = "Your instincts say you shouldn't be following these.";
	dir = 8;
	icon_state = "ltrails_2"
	},
/obj/effect/decal/cleanable/grand_remains,
/obj/effect/rune/narsie{
	color = "#440000";
	used = 1;
	light_color = "#440000"
	},
/mob/living/basic/mining/ancient_demon/eldritch_horror,
/turf/open/indestructible/necropolis,
/area/ruin/unpowered)
"Sv" = (
/obj/structure/stone_tile/block,
/obj/structure/stone_tile/cracked{
	dir = 1
	},
/obj/structure/stone_tile{
	dir = 4
	},
/obj/item/disk/design_disk/knight_gear,
/turf/open/indestructible/necropolis,
/area/ruin/unpowered)
"SB" = (
/obj/structure/stone_tile/block{
	dir = 1
	},
/turf/closed/mineral/volcanic/lava_land_surface,
/area/lavaland/surface/outdoors)
"Tp" = (
/obj/structure/stone_tile/block{
	dir = 8
	},
/obj/structure/stone_tile/cracked{
	dir = 1
	},
/obj/structure/stone_tile,
/obj/effect/decal/cleanable/blood/gibs/old,
/obj/item/xenoarch/useless_relic/magnified,
/turf/open/indestructible/necropolis,
/area/ruin/unpowered)
"TF" = (
/obj/structure/stone_tile{
	dir = 4
	},
/mob/living/basic/mining/ancient_demon/ancient_demon_lesser,
/turf/closed/mineral/volcanic/lava_land_surface,
/area/lavaland/surface/outdoors)
"TY" = (
/obj/structure/stone_tile/block{
	dir = 1
	},
/obj/item/soulstone,
/turf/open/indestructible/necropolis,
/area/ruin/unpowered)
"Ue" = (
/obj/structure/stone_tile/surrounding_tile/cracked{
	dir = 8
	},
/obj/structure/stone_tile/center,
/obj/structure/stone_tile/surrounding_tile{
	dir = 1
	},
/obj/structure/stone_tile/surrounding_tile{
	dir = 4
	},
/obj/effect/decal/cleanable/blood/tracks{
	desc = "Your instincts say you shouldn't be following these.";
	icon_state = "ltrails_1";
	dir = 10
	},
/obj/item/organ/internal/tongue/lizard/silver,
/turf/open/indestructible/necropolis,
/area/ruin/unpowered)
"Uk" = (
/obj/structure/stone_tile/cracked{
	dir = 4
	},
/turf/closed/mineral/random/high_chance/volcanic,
/area/lavaland/surface/outdoors)
"Ur" = (
/obj/structure/stone_tile/slab/burnt,
/obj/effect/decal/cleanable/blood/gibs/torso,
/obj/effect/decal/cleanable/blood/old{
	icon_state = "gibbl4"
	},
/turf/open/indestructible/boss,
/area/ruin/unpowered)
"VK" = (
/obj/structure/flora/rock/pile/style_random,
/obj/effect/spawner/random/structure/spikes,
/turf/closed/mineral/random/high_chance/volcanic,
/area/lavaland/surface/outdoors)
"WI" = (
/obj/structure/stone_tile/block,
/obj/structure/stone_tile{
	dir = 1
	},
/obj/structure/stone_tile{
	dir = 4
	},
/obj/effect/decal/cleanable/blood,
/obj/effect/mob_spawn/corpse/human/wizard,
/turf/open/indestructible/necropolis,
/area/ruin/unpowered)
"Xc" = (
/obj/structure/flora/ash/stem_shroom,
/obj/effect/spawner/random/structure/spikes,
/turf/closed/mineral/random/high_chance/volcanic,
/area/lavaland/surface/outdoors)
"Xh" = (
/obj/structure/stone_tile{
	dir = 8
	},
/obj/effect/spawner/random/structure/spikes,
/turf/closed/mineral/volcanic/lava_land_surface,
/area/lavaland/surface/outdoors)
"Xo" = (
/obj/effect/spawner/random/mob/necropolis_mob,
/turf/closed/mineral/volcanic/lava_land_surface,
/area/lavaland/surface/outdoors)
"Xp" = (
/obj/structure/stone_tile/block{
	dir = 4
	},
/obj/structure/stone_tile{
	dir = 8
	},
/obj/structure/stone_tile{
	dir = 4
	},
/obj/effect/decal/cleanable/blood/old{
	icon_state = "gibbl1"
	},
/obj/item/stack/sheet/mineral/runite{
	amount = 5
	},
/turf/open/indestructible/necropolis,
/area/ruin/unpowered)
"Yt" = (
/obj/structure/stone_tile{
	dir = 1
	},
/turf/closed/mineral/random/high_chance/volcanic,
/area/lavaland/surface/outdoors)

(1,1,1) = {"
Sr
Sr
Sr
Sr
Sr
Sr
Sr
Sr
Sr
Sr
TF
Xh
Sr
Sr
Sr
"}
(2,1,1) = {"
Sr
Sr
lx
kt
tn
qr
qr
qr
Xh
Sr
qr
qr
Xh
Sr
Sr
"}
(3,1,1) = {"
Sr
kt
uA
nS
nS
nS
nS
nS
qr
Sr
qr
lq
yI
Sr
Sr
"}
(4,1,1) = {"
kt
Uk
nS
nS
MN
su
eD
nS
nS
Xh
Kk
aM
Sr
Sr
Sr
"}
(5,1,1) = {"
Xc
lq
nS
nS
QG
lC
Ur
nS
nS
nS
LA
Ky
Sr
Sr
Sr
"}
(6,1,1) = {"
kt
gs
nS
Iq
dk
ug
Xp
PV
nS
nS
nS
kt
jP
Sr
Sr
"}
(7,1,1) = {"
Xo
nS
Ix
lb
id
EL
Eu
BI
nS
nS
NR
md
Bw
fx
ig
"}
(8,1,1) = {"
kt
nS
CN
WI
fc
Ss
TY
eR
ys
yh
uz
cv
bd
He
QI
"}
(9,1,1) = {"
kt
nS
Ix
Sv
ir
vP
Ue
Al
nS
nS
NR
Bw
oA
xc
Ps
"}
(10,1,1) = {"
kt
SB
nS
IU
KS
ws
Tp
Ov
nS
nS
nS
kt
Sr
Sr
Sr
"}
(11,1,1) = {"
kt
qr
nS
nS
QG
Kz
kI
nS
nS
nS
DQ
bR
kt
Sr
Sr
"}
(12,1,1) = {"
kt
Yt
nS
nS
MN
my
QG
nS
nS
aM
Uk
Xh
Ky
Io
Sr
"}
(13,1,1) = {"
kt
FQ
LX
nS
nS
nS
nS
nS
qr
kt
qr
qr
yt
kt
Sr
"}
(14,1,1) = {"
Sr
kt
un
kt
wl
qr
qr
lq
aM
Ky
qr
qr
tF
kw
Sr
"}
(15,1,1) = {"
Sr
Sr
Sr
Sr
Sr
Sr
kt
VK
un
Sr
Mo
tF
Sr
Sr
Sr
"}
