//MAP CONVERTED BY dmm2tgm.py THIS HEADER COMMENT PREVENTS RECONVERSION, DO NOT REMOVE
"ae" = (
/obj/structure/flora/rock/pile/style_random,
/turf/closed/mineral/volcanic/lava_land_surface,
/area/lavaland/surface/outdoors)
"al" = (
/obj/structure/stone_tile/slab,
/turf/closed/mineral/strange_rock,
/area/lavaland/surface/outdoors)
"aW" = (
/obj/structure/stone_tile/slab/burnt,
/turf/closed/mineral/volcanic/lava_land_surface,
/area/lavaland/surface/outdoors)
"cf" = (
/obj/structure/stone_tile,
/obj/structure/stone_tile{
	dir = 1
	},
/obj/structure/stone_tile{
	dir = 8
	},
/obj/structure/stone_tile{
	dir = 4
	},
/obj/item/ammo_casing/arrow/bone,
/obj/item/ammo_casing/arrow/bone,
/obj/item/ammo_casing/arrow/bone,
/turf/closed/mineral/volcanic/lava_land_surface,
/area/lavaland/surface/outdoors)
"cu" = (
/obj/structure/stone_tile/block/cracked,
/turf/closed/mineral/volcanic/lava_land_surface,
/area/lavaland/surface/outdoors)
"cU" = (
/obj/structure/stone_tile/slab,
/obj/structure/flora/rock/pile/style_random,
/turf/closed/mineral/volcanic/lava_land_surface,
/area/lavaland/surface/outdoors)
"en" = (
/obj/structure/stone_tile/slab,
/turf/closed/mineral/random/high_chance/volcanic,
/area/ruin/unpowered)
"ez" = (
/obj/structure/stone_tile/slab,
/obj/effect/decal/cleanable/dirt/dust,
/turf/open/indestructible/necropolis,
/area/ruin/unpowered)
"eF" = (
/obj/structure/stone_tile/slab,
/obj/effect/spawner/random/exotic/languagebook,
/turf/closed/mineral/random/high_chance/volcanic,
/area/ruin/unpowered)
"eO" = (
/obj/structure/flora/rock/pile/style_random,
/turf/closed/mineral/strange_rock,
/area/lavaland/surface/outdoors)
"ic" = (
/obj/structure/stone_tile/slab,
/mob/living/basic/mining/goliath/ancient,
/obj/effect/decal/cleanable/dirt/dust,
/turf/open/indestructible/necropolis,
/area/ruin/unpowered)
"it" = (
/obj/item/stack/sheet/bone,
/turf/closed/mineral/volcanic/lava_land_surface,
/area/lavaland/surface/outdoors)
"iP" = (
/obj/structure/stone_tile/slab,
/turf/closed/mineral/random/high_chance/volcanic,
/area/lavaland/surface/outdoors)
"jo" = (
/obj/item/ammo_casing/arrow/bone,
/turf/closed/mineral/volcanic/lava_land_surface,
/area/lavaland/surface/outdoors)
"jp" = (
/obj/structure/stone_tile/slab,
/obj/item/claymore/bone,
/turf/open/misc/asteroid/basalt/lava_land_surface,
/area/ruin/unpowered)
"jY" = (
/obj/structure/stone_tile/slab,
/obj/effect/decal/remains/human,
/turf/open/indestructible/necropolis,
/area/ruin/unpowered)
"kZ" = (
/obj/structure/stone_tile/slab,
/turf/closed/indestructible/riveted/boss,
/area/ruin/unpowered)
"lc" = (
/obj/structure/stone_tile/cracked,
/turf/closed/mineral/volcanic/lava_land_surface,
/area/lavaland/surface/outdoors)
"lp" = (
/obj/item/stack/sheet/bone,
/turf/closed/mineral/random/high_chance/volcanic,
/area/lavaland/surface/outdoors)
"lP" = (
/obj/structure/stone_tile/block{
	dir = 8
	},
/obj/structure/stone_tile/block{
	dir = 4
	},
/turf/closed/mineral/volcanic/lava_land_surface,
/area/ruin/unpowered)
"nc" = (
/obj/structure/stone_tile/slab,
/obj/structure/statue/bone/rib,
/turf/closed/mineral/volcanic/lava_land_surface,
/area/ruin/unpowered)
"nh" = (
/obj/structure/stone_tile/slab,
/turf/closed/mineral/volcanic/lava_land_surface,
/area/lavaland/surface/outdoors)
"oZ" = (
/mob/living/basic/mining/goliath,
/obj/structure/flora/rock/pile/style_random,
/obj/structure/stone_tile/block/cracked,
/turf/closed/mineral/random/high_chance/volcanic,
/area/lavaland/surface/outdoors)
"pR" = (
/obj/structure/stone_tile/slab,
/obj/effect/decal/cleanable/blood/old,
/obj/effect/decal/cleanable/dirt/dust,
/turf/open/misc/asteroid/basalt/lava_land_surface,
/area/ruin/unpowered)
"pT" = (
/turf/closed/indestructible/riveted/boss,
/area/lavaland/surface/outdoors)
"qt" = (
/obj/structure/stone_tile{
	dir = 1
	},
/obj/structure/stone_tile{
	dir = 8
	},
/obj/structure/stone_tile{
	dir = 4
	},
/obj/structure/stone_tile/cracked,
/turf/open/lava/smooth/lava_land_surface{
	slowdown = 0
	},
/area/lavaland/surface/outdoors)
"qB" = (
/obj/structure/flora/rock/style_random,
/turf/closed/mineral/volcanic/lava_land_surface,
/area/lavaland/surface/outdoors)
"qH" = (
/obj/structure/flora/rock/pile/style_random,
/obj/structure/stone_tile/block/cracked,
/turf/closed/mineral/volcanic/lava_land_surface,
/area/lavaland/surface/outdoors)
"qN" = (
/obj/structure/stone_tile/slab/cracked,
/turf/closed/mineral/random/high_chance/volcanic,
/area/lavaland/surface/outdoors)
"tB" = (
/obj/structure/stone_tile/slab,
/turf/closed/mineral/volcanic/lava_land_surface,
/area/ruin/unpowered)
"tJ" = (
/obj/structure/stone_tile/surrounding,
/obj/structure/stone_tile/center,
/turf/closed/mineral/volcanic/lava_land_surface,
/area/ruin/unpowered)
"tL" = (
/obj/structure/stone_tile/slab/cracked{
	dir = 4
	},
/obj/structure/stone_tile/slab/cracked{
	dir = 1
	},
/obj/effect/decal/cleanable/dirt,
/turf/open/indestructible/necropolis,
/area/ruin/unpowered)
"um" = (
/obj/structure/stone_tile/slab/cracked{
	dir = 5
	},
/obj/structure/stone_tile/slab/cracked{
	dir = 8
	},
/turf/closed/mineral/volcanic/lava_land_surface,
/area/ruin/unpowered)
"va" = (
/obj/structure/stone_tile/center,
/obj/structure/stone_tile/surrounding_tile/cracked{
	dir = 1
	},
/obj/structure/stone_tile/surrounding_tile/cracked{
	dir = 4
	},
/obj/structure/stone_tile/surrounding_tile/cracked{
	dir = 8
	},
/obj/structure/stone_tile/surrounding_tile/cracked,
/turf/open/lava/smooth/lava_land_surface{
	slowdown = 0
	},
/area/lavaland/surface/outdoors)
"vT" = (
/obj/effect/mapping_helpers/bombable_wall,
/turf/closed/indestructible/riveted/boss/wasteland,
/area/lavaland/surface/outdoors)
"xz" = (
/turf/closed/mineral/random/high_chance/volcanic,
/area/lavaland/surface/outdoors)
"yY" = (
/obj/structure/stone_tile/slab,
/obj/effect/decal/cleanable/dirt/dust,
/obj/structure/bookcase,
/turf/open/misc/asteroid/basalt/lava_land_surface,
/area/ruin/unpowered)
"zh" = (
/turf/closed/mineral/volcanic/lava_land_surface,
/area/lavaland/surface/outdoors)
"zC" = (
/obj/structure/flora/rock/style_random,
/turf/closed/mineral/random/high_chance/volcanic,
/area/lavaland/surface/outdoors)
"zL" = (
/obj/structure/stone_tile/slab,
/turf/open/lava/smooth/lava_land_surface{
	slowdown = 0
	},
/area/ruin/unpowered)
"Aq" = (
/obj/structure/stone_tile/slab,
/mob/living/basic/mining/goliath,
/turf/closed/mineral/random/high_chance/volcanic,
/area/ruin/unpowered)
"AW" = (
/turf/closed/indestructible/riveted/boss,
/area/ruin/unpowered)
"Bp" = (
/obj/structure/stone_tile/slab/cracked,
/turf/open/indestructible/necropolis,
/area/ruin/unpowered)
"BT" = (
/obj/structure/stone_tile/slab,
/obj/item/reagent_containers/cup/bowl/wood_bowl,
/turf/closed/mineral/random/high_chance/volcanic,
/area/ruin/unpowered)
"Ct" = (
/mob/living/basic/mining/goliath,
/obj/structure/stone_tile/block/cracked,
/turf/closed/mineral/random/high_chance/volcanic,
/area/lavaland/surface/outdoors)
"DB" = (
/obj/structure/stone_tile/slab,
/obj/effect/decal/cleanable/dirt/dust,
/obj/item/shrapnel/bone_fragment,
/turf/open/indestructible/necropolis,
/area/ruin/unpowered)
"Eo" = (
/obj/structure/stone_tile/slab,
/obj/item/shield/goliath,
/turf/closed/mineral/volcanic/lava_land_surface,
/area/lavaland/surface/outdoors)
"Ep" = (
/obj/structure/stone_tile/block{
	dir = 8
	},
/obj/structure/stone_tile/block{
	dir = 4
	},
/mob/living/basic/mining/goliath,
/turf/closed/mineral/volcanic/lava_land_surface,
/area/ruin/unpowered)
"Fl" = (
/obj/structure/stone_tile/slab,
/obj/effect/decal/cleanable/dirt,
/turf/open/indestructible/necropolis,
/area/ruin/unpowered)
"Ge" = (
/turf/template_noop,
/area/template_noop)
"HM" = (
/obj/structure/necropolis_arch,
/obj/structure/stone_tile/slab,
/obj/effect/decal/cleanable/blood/old,
/turf/open/misc/asteroid/basalt/lava_land_surface,
/area/ruin/unpowered)
"It" = (
/obj/structure/stone_tile/slab,
/turf/closed/mineral/strange_rock,
/area/ruin/unpowered)
"Jz" = (
/obj/structure/stone_tile/block{
	dir = 8
	},
/obj/structure/stone_tile/block{
	dir = 4
	},
/obj/structure/marker_beacon/burgundy,
/turf/closed/indestructible/riveted/boss,
/area/ruin/unpowered)
"JO" = (
/obj/structure/stone_tile/slab,
/obj/item/kitchen/spoon,
/turf/closed/mineral/random/high_chance/volcanic,
/area/ruin/unpowered)
"JR" = (
/mob/living/basic/mining/goliath,
/turf/closed/mineral/random/high_chance/volcanic,
/area/lavaland/surface/outdoors)
"Ld" = (
/obj/structure/stone_tile/surrounding_tile/cracked{
	dir = 4
	},
/obj/structure/stone_tile/surrounding_tile/cracked,
/obj/structure/stone_tile/surrounding_tile/cracked{
	dir = 8
	},
/obj/structure/stone_tile/surrounding_tile/cracked{
	dir = 1
	},
/obj/structure/stone_tile/center,
/obj/effect/decal/cleanable/blood/old,
/turf/open/misc/asteroid/basalt/lava_land_surface,
/area/ruin/unpowered)
"LB" = (
/obj/structure/stone_tile/surrounding,
/obj/structure/stone_tile/center,
/turf/open/indestructible/necropolis,
/area/ruin/unpowered)
"LI" = (
/obj/structure/stone_tile/slab,
/mob/living/basic/mining/goliath/ancient,
/obj/effect/decal/cleanable/blood/old,
/obj/effect/decal/cleanable/dirt,
/turf/open/indestructible/necropolis,
/area/ruin/unpowered)
"NW" = (
/obj/structure/stone_tile/block{
	dir = 8
	},
/obj/structure/stone_tile/block{
	dir = 4
	},
/turf/closed/mineral/random/high_chance/volcanic,
/area/ruin/unpowered)
"Ok" = (
/obj/structure/stone_tile/surrounding,
/obj/structure/stone_tile/center,
/turf/closed/mineral/random/high_chance/volcanic,
/area/ruin/unpowered)
"Ot" = (
/obj/structure/stone_tile/surrounding,
/obj/structure/stone_tile/center,
/turf/open/lava/smooth/lava_land_surface{
	slowdown = 0
	},
/area/ruin/unpowered)
"OG" = (
/turf/closed/mineral/strange_rock,
/area/lavaland/surface/outdoors)
"PG" = (
/obj/structure/stone_tile/burnt{
	dir = 1
	},
/turf/closed/mineral/volcanic/lava_land_surface,
/area/lavaland/surface/outdoors)
"QQ" = (
/obj/structure/stone_tile/slab,
/obj/structure/closet/crate/necropolis/tendril,
/turf/closed/mineral/random/high_chance/volcanic,
/area/ruin/unpowered)
"QR" = (
/obj/structure/punji_sticks/spikes,
/turf/closed/mineral/volcanic/lava_land_surface,
/area/lavaland/surface/outdoors)
"Rc" = (
/obj/structure/stone_tile/slab/cracked{
	dir = 5
	},
/obj/structure/stone_tile/slab/cracked{
	dir = 10
	},
/turf/open/lava/smooth/lava_land_surface{
	slowdown = 0
	},
/area/lavaland/surface/outdoors)
"RY" = (
/obj/structure/stone_tile/surrounding_tile/cracked{
	dir = 4
	},
/obj/structure/stone_tile/surrounding_tile/cracked{
	dir = 8
	},
/obj/structure/stone_tile/surrounding_tile/cracked,
/obj/structure/stone_tile/surrounding_tile/cracked{
	dir = 1
	},
/obj/structure/stone_tile/center,
/obj/structure/marker_beacon/burgundy,
/obj/item/crusher_trophy/goliath_tentacle,
/obj/structure/closet/crate/necropolis/tendril,
/obj/effect/decal/cleanable/dirt/dust,
/turf/open/indestructible/necropolis,
/area/ruin/unpowered)
"Sd" = (
/obj/structure/stone_tile/slab,
/obj/item/knife/hunting,
/turf/closed/mineral/random/high_chance/volcanic,
/area/ruin/unpowered)
"SN" = (
/obj/structure/stone_tile/slab/cracked,
/turf/open/lava/smooth/lava_land_surface{
	slowdown = 0
	},
/area/ruin/unpowered)
"Wq" = (
/obj/structure/stone_tile/burnt{
	dir = 1
	},
/obj/structure/stone_tile,
/obj/structure/stone_tile{
	dir = 4
	},
/turf/open/lava/smooth/lava_land_surface{
	slowdown = 0
	},
/area/lavaland/surface/outdoors)
"XT" = (
/obj/structure/stone_tile/slab,
/obj/structure/statue/bone/rib{
	dir = 1
	},
/turf/closed/mineral/volcanic/lava_land_surface,
/area/ruin/unpowered)
"XU" = (
/turf/open/lava/smooth/lava_land_surface{
	slowdown = 0
	},
/area/lavaland/surface/outdoors)
"Yb" = (
/obj/structure/stone_tile/slab/cracked,
/turf/closed/mineral/volcanic/lava_land_surface,
/area/lavaland/surface/outdoors)
"Yh" = (
/obj/structure/stone_tile/slab/burnt,
/turf/open/lava/smooth/lava_land_surface{
	slowdown = 0
	},
/area/lavaland/surface/outdoors)
"YG" = (
/obj/structure/stone_tile/slab/cracked{
	dir = 4
	},
/obj/structure/stone_tile/slab/cracked{
	dir = 1
	},
/obj/effect/decal/necropolis_gate_decal,
/obj/effect/decal/cleanable/dirt,
/turf/open/misc/asteroid/basalt/lava_land_surface,
/area/lavaland/surface/outdoors)
"Za" = (
/obj/structure/flora/rock/pile/style_random,
/obj/structure/stone_tile/cracked,
/turf/closed/mineral/volcanic/lava_land_surface,
/area/lavaland/surface/outdoors)

(1,1,1) = {"
Ge
Ge
Ge
Ge
zh
jo
zh
ae
zh
zh
zh
zh
zh
zh
Ge
Ge
"}
(2,1,1) = {"
Ge
Ge
Ge
zh
cu
pT
lp
pT
lc
pT
cu
it
qB
OG
zh
Ge
"}
(3,1,1) = {"
Ge
Ge
QR
zh
eO
zh
zh
PG
zh
xz
xz
xz
zh
zh
zh
QR
"}
(4,1,1) = {"
Ge
zh
pT
pT
vT
pT
pT
XU
qB
pT
pT
pT
cu
JR
zh
zh
"}
(5,1,1) = {"
OG
pT
pT
en
Sd
tB
Yb
aW
iP
iP
pT
pT
pT
cu
zh
zh
"}
(6,1,1) = {"
jo
pT
XT
It
Fl
en
AW
Ep
AW
lP
AW
Jz
al
nh
pT
zh
"}
(7,1,1) = {"
ae
pT
yY
DB
LI
tL
Ok
BT
Ok
tB
Ot
SN
Yh
cf
cU
zh
"}
(8,1,1) = {"
zh
pT
eF
ez
RY
kZ
en
Ld
Bp
jY
zL
HM
va
qt
YG
zh
"}
(9,1,1) = {"
zh
pT
QQ
Bp
ic
pR
Ok
en
LB
um
tJ
jp
Rc
Wq
Yh
zh
"}
(10,1,1) = {"
it
pT
nc
en
BT
It
AW
NW
AW
lP
AW
Jz
Eo
nh
pT
zh
"}
(11,1,1) = {"
zh
pT
pT
It
Aq
en
en
JO
qN
al
pT
pT
pT
cu
zh
zh
"}
(12,1,1) = {"
zh
zh
pT
pT
pT
pT
pT
pT
vT
zC
xz
pT
oZ
zh
xz
it
"}
(13,1,1) = {"
Ge
zh
zh
eO
zh
zh
ae
zh
xz
xz
zh
zh
zh
xz
zh
zh
"}
(14,1,1) = {"
Ge
Ge
zh
pT
Ct
pT
zh
OG
pT
pT
qH
zh
zh
QR
zh
Ge
"}
(15,1,1) = {"
Ge
Ge
zh
lc
zh
pT
Za
pT
it
zh
zh
zh
zh
Ge
Ge
Ge
"}
(16,1,1) = {"
Ge
Ge
Ge
zh
zh
zh
QR
PG
zh
Ge
Ge
Ge
Ge
Ge
Ge
Ge
"}
