//MAP CONVERTED BY dmm2tgm.py THIS HEADER COMMENT PREVENTS RECONVERSION, DO NOT REMOVE
"aa" = (
/obj/structure/stone_tile{
	dir = 8
	},
/obj/structure/stone_tile/cracked{
	dir = 4
	},
/turf/open/lava/smooth/lava_land_surface,
/area/lavaland/surface/outdoors)
"au" = (
/obj/structure/stone_tile/slab/cracked{
	dir = 6
	},
/obj/effect/spawner/random/entertainment/coin{
	pixel_x = -8;
	pixel_y = -8
	},
/turf/closed/mineral/random/high_chance/volcanic,
/area/ruin/unpowered)
"aQ" = (
/obj/structure/stone_tile/slab/cracked{
	dir = 6
	},
/obj/effect/spawner/random/entertainment/coin{
	pixel_x = -13;
	pixel_y = 7
	},
/turf/closed/mineral/random/high_chance/volcanic,
/area/lavaland/surface/outdoors)
"bO" = (
/obj/structure/flora/rock/pile/style_random,
/mob/living/basic/mining/ancient_demon/goliath_pup,
/mob/living/basic/mining/ancient_demon/goliath_pup,
/mob/living/basic/mining/ancient_demon/goliath_pup,
/turf/closed/mineral/volcanic/lava_land_surface,
/area/lavaland/surface/outdoors)
"cH" = (
/obj/effect/spawner/random/structure/spikes,
/turf/closed/mineral/volcanic/lava_land_surface,
/area/lavaland/surface/outdoors)
"cK" = (
/obj/structure/stone_tile,
/obj/structure/stone_tile{
	dir = 1
	},
/obj/structure/stone_tile{
	dir = 4
	},
/turf/closed/mineral/strange_rock/volcanic,
/area/lavaland/surface/outdoors)
"dl" = (
/obj/structure/stone_tile/slab,
/obj/effect/spawner/random/entertainment/coin{
	pixel_x = 6;
	pixel_y = 4
	},
/turf/open/misc/asteroid/basalt/lava_land_surface,
/area/lavaland/surface/outdoors)
"dm" = (
/obj/structure/stone_tile/surrounding/cracked{
	pixel_x = 1;
	pixel_y = -1
	},
/obj/structure/stone_tile/center/burnt,
/turf/open/lava/smooth/lava_land_surface,
/area/lavaland/surface/outdoors)
"dH" = (
/obj/structure/stone_tile{
	dir = 8
	},
/obj/structure/stone_tile{
	dir = 4
	},
/obj/structure/stone_tile/burnt,
/turf/closed/mineral/volcanic/lava_land_surface,
/area/lavaland/surface/outdoors)
"ef" = (
/obj/structure/stone_tile/slab,
/obj/item/xenoarch/useless_relic/magnified{
	name = "Ancient relic";
	desc = "Sort of relic that can be exported through Cargo."
	},
/turf/closed/mineral/random/high_chance/volcanic,
/area/ruin/unpowered)
"eE" = (
/obj/item/clothing/head/ash_headdress/winged,
/obj/effect/spawner/random/mob/necropolis_mob,
/turf/closed/mineral/random/high_chance/volcanic,
/area/lavaland/surface/outdoors)
"fB" = (
/obj/structure/stone_tile/slab/cracked{
	dir = 4
	},
/obj/structure/stone_tile/slab/cracked{
	dir = 8
	},
/mob/living/basic/mining/ancient_demon,
/turf/closed/mineral/random/high_chance/volcanic,
/area/lavaland/surface/outdoors)
"fG" = (
/mob/living/basic/mining/ancient_demon/ancient_demon_lesser,
/turf/open/misc/asteroid/basalt/lava_land_surface,
/area/lavaland/surface/outdoors)
"fW" = (
/obj/structure/stone_tile{
	dir = 8
	},
/obj/structure/stone_tile{
	dir = 4
	},
/turf/closed/mineral/volcanic/lava_land_surface,
/area/lavaland/surface/outdoors)
"hd" = (
/obj/structure/stone_tile/slab/cracked{
	dir = 6
	},
/turf/closed/mineral/random/high_chance/volcanic,
/area/ruin/unpowered)
"ib" = (
/obj/structure/flora/rock/pile/style_random,
/mob/living/basic/mining/ancient_demon/goliath_pup,
/mob/living/basic/mining/ancient_demon/goliath_pup,
/turf/closed/mineral/random/high_chance/volcanic,
/area/lavaland/surface/outdoors)
"ic" = (
/obj/structure/flora/rock/pile/style_random,
/obj/effect/spawner/random/structure/spikes,
/turf/closed/mineral/random/high_chance/volcanic,
/area/lavaland/surface/outdoors)
"id" = (
/obj/structure/stone_tile/slab/cracked{
	dir = 4
	},
/obj/structure/stone_tile/slab/cracked{
	dir = 8
	},
/turf/open/lava/smooth/lava_land_surface,
/area/lavaland/surface/outdoors)
"ij" = (
/obj/structure/stone_tile/slab/cracked{
	dir = 4
	},
/obj/structure/stone_tile/slab/cracked{
	dir = 8
	},
/mob/living/basic/mining/ancient_demon/ancient_demon_lesser,
/turf/open/misc/asteroid/basalt/lava_land_surface,
/area/ruin/unpowered)
"iN" = (
/obj/structure/stone_tile,
/obj/structure/stone_tile{
	dir = 8
	},
/obj/structure/stone_tile{
	dir = 1
	},
/obj/structure/stone_tile{
	dir = 4
	},
/turf/open/misc/asteroid/basalt/lava_land_surface,
/area/lavaland/surface/outdoors)
"je" = (
/turf/template_noop,
/area/template_noop)
"jw" = (
/obj/structure/stone_tile/slab,
/obj/item/xenoarch/useless_relic{
	name = "Ancient relic";
	desc = "Sort of relic that can be exported through Cargo."
	},
/turf/closed/mineral/random/high_chance/volcanic,
/area/ruin/unpowered)
"me" = (
/obj/item/stack/sheet/mineral/metal_hydrogen,
/obj/structure/stone_tile/slab,
/turf/closed/mineral/random/high_chance/volcanic,
/area/ruin/unpowered)
"mz" = (
/mob/living/basic/mining/ancient_demon,
/turf/closed/mineral/random/high_chance/volcanic,
/area/ruin/unpowered)
"ng" = (
/turf/open/lava/smooth/lava_land_surface,
/area/lavaland/surface/outdoors)
"nG" = (
/obj/structure/stone_tile/slab,
/turf/closed/mineral/random/high_chance/volcanic,
/area/lavaland/surface/outdoors)
"nL" = (
/obj/structure/stone_tile/slab/cracked{
	dir = 4
	},
/obj/structure/stone_tile/slab/cracked{
	dir = 1
	},
/turf/closed/mineral/random/high_chance/volcanic,
/area/lavaland/surface/outdoors)
"pg" = (
/obj/structure/stone_tile/slab/cracked{
	dir = 5
	},
/obj/structure/stone_tile/slab/cracked{
	dir = 8
	},
/turf/open/lava/smooth/lava_land_surface,
/area/lavaland/surface/outdoors)
"pU" = (
/obj/structure/stone_tile/slab,
/obj/item/xenoarch/useless_relic{
	name = "Ancient relic";
	desc = "Sort of relic that can be exported through Cargo."
	},
/turf/closed/mineral/random/high_chance/volcanic,
/area/lavaland/surface/outdoors)
"qy" = (
/obj/structure/stone_tile/surrounding_tile{
	dir = 1
	},
/obj/structure/stone_tile/surrounding_tile{
	dir = 8
	},
/turf/open/lava/smooth/lava_land_surface,
/area/lavaland/surface/outdoors)
"qA" = (
/obj/structure/stone_tile/slab,
/obj/effect/spawner/random/mob/necropolis_mob,
/turf/closed/mineral/random/high_chance/volcanic,
/area/ruin/unpowered)
"rs" = (
/obj/structure/stone_tile/slab/cracked{
	dir = 6
	},
/turf/open/lava/smooth/lava_land_surface,
/area/lavaland/surface/outdoors)
"rK" = (
/obj/structure/stone_tile,
/obj/structure/stone_tile{
	dir = 8
	},
/obj/structure/stone_tile{
	dir = 1
	},
/obj/structure/stone_tile{
	dir = 4
	},
/turf/closed/mineral/volcanic/lava_land_surface,
/area/lavaland/surface/outdoors)
"rZ" = (
/obj/structure/stone_tile/slab,
/obj/effect/spawner/random/entertainment/coin{
	pixel_x = -10;
	pixel_y = -9
	},
/turf/closed/mineral/random/high_chance/volcanic,
/area/ruin/unpowered)
"sf" = (
/obj/effect/spawner/random/structure/orevein_longregen,
/turf/open/misc/asteroid/basalt/lava_land_surface,
/area/lavaland/surface/outdoors)
"sq" = (
/obj/effect/spawner/random/structure/spikes,
/turf/closed/mineral/strange_rock/volcanic,
/area/lavaland/surface/outdoors)
"sv" = (
/obj/structure/stone_tile,
/obj/structure/stone_tile{
	dir = 1
	},
/turf/closed/mineral/random/high_chance/volcanic,
/area/lavaland/surface/outdoors)
"sQ" = (
/obj/structure/stone_tile/slab,
/obj/effect/spawner/random/mob/necropolis_mob,
/turf/open/misc/asteroid/basalt/lava_land_surface,
/area/ruin/unpowered)
"sR" = (
/obj/effect/spawner/random/structure/orevein_longregen,
/turf/closed/mineral/random/high_chance/volcanic,
/area/lavaland/surface/outdoors)
"sV" = (
/obj/structure/stone_tile/slab/cracked{
	dir = 4
	},
/obj/structure/stone_tile/slab/cracked{
	dir = 1
	},
/turf/open/misc/asteroid/basalt/lava_land_surface,
/area/lavaland/surface/outdoors)
"tX" = (
/obj/structure/stone_tile,
/obj/structure/stone_tile{
	dir = 8
	},
/obj/structure/stone_tile{
	dir = 4
	},
/turf/closed/mineral/random/high_chance/volcanic,
/area/lavaland/surface/outdoors)
"ua" = (
/obj/structure/stone_tile{
	dir = 8
	},
/obj/structure/stone_tile{
	dir = 1
	},
/obj/structure/stone_tile/burnt,
/turf/open/misc/asteroid/basalt/lava_land_surface,
/area/lavaland/surface/outdoors)
"ue" = (
/obj/structure/stone_tile/block,
/obj/structure/stone_tile/block/cracked{
	dir = 1
	},
/mob/living/basic/mining/ancient_demon/demoraptor,
/turf/open/misc/asteroid/basalt/lava_land_surface,
/area/lavaland/surface/outdoors)
"uo" = (
/obj/structure/stone_tile/slab/cracked{
	dir = 4
	},
/obj/structure/stone_tile/slab/cracked{
	dir = 1
	},
/turf/closed/mineral/volcanic/lava_land_surface,
/area/lavaland/surface/outdoors)
"uV" = (
/obj/structure/stone_tile/block/burnt,
/obj/structure/stone_tile/block/cracked{
	dir = 1
	},
/turf/open/lava/smooth/lava_land_surface,
/area/lavaland/surface/outdoors)
"vd" = (
/obj/structure/stone_tile/slab,
/turf/closed/mineral/volcanic/lava_land_surface,
/area/lavaland/surface/outdoors)
"vs" = (
/obj/structure/stone_tile/slab/cracked{
	dir = 4
	},
/turf/open/lava/smooth/lava_land_surface,
/area/lavaland/surface/outdoors)
"vy" = (
/obj/structure/stone_tile/slab,
/turf/closed/mineral/random/high_chance/volcanic,
/area/ruin/unpowered)
"wb" = (
/obj/structure/stone_tile{
	dir = 1
	},
/obj/structure/stone_tile/burnt,
/turf/closed/mineral/volcanic/lava_land_surface,
/area/lavaland/surface/outdoors)
"wn" = (
/obj/item/circular_saw/ashwalker,
/obj/structure/stone_tile/slab,
/turf/closed/mineral/volcanic/lava_land_surface,
/area/lavaland/surface/outdoors)
"wQ" = (
/obj/structure/stone_tile/slab,
/obj/effect/spawner/random/entertainment/coin{
	pixel_x = -8;
	pixel_y = -8
	},
/turf/open/misc/asteroid/basalt/lava_land_surface,
/area/ruin/unpowered)
"xy" = (
/obj/structure/stone_tile/slab,
/obj/effect/spawner/random/entertainment/coin{
	pixel_x = 8;
	pixel_y = -9
	},
/turf/closed/mineral/random/high_chance/volcanic,
/area/lavaland/surface/outdoors)
"xI" = (
/obj/structure/trap/fire{
	name = "Anctient runic spikes";
	desc = "A strange carving of some symbols. What's that for?";
	alpha = 180;
	icon = 'icons/obj/service/hydroponics/equipment.dmi';
	icon_state = "woodspike";
	light_color = "#FF1111";
	color = "#FF1111";
	max_integrity = 30
	},
/turf/closed/mineral/strange_rock/volcanic,
/area/lavaland/surface/outdoors)
"yt" = (
/obj/structure/stone_tile/slab,
/obj/item/xenoarch/useless_relic/magnified{
	name = "Ancient relic";
	desc = "Sort of relic that can be exported through Cargo."
	},
/turf/closed/mineral/random/high_chance/volcanic,
/area/lavaland/surface/outdoors)
"yN" = (
/obj/item/clothing/shoes/jackboots/ashwalker,
/obj/structure/stone_tile/slab,
/turf/open/misc/asteroid/basalt/lava_land_surface,
/area/ruin/unpowered)
"zN" = (
/obj/effect/spawner/random/structure/spikes,
/obj/effect/spawner/random/structure/orevein_longregen,
/turf/closed/mineral/random/high_chance/volcanic,
/area/ruin/unpowered)
"Ac" = (
/obj/structure/stone_tile/slab/cracked{
	dir = 4
	},
/obj/structure/stone_tile/slab/cracked{
	dir = 1
	},
/turf/open/lava/smooth/lava_land_surface,
/area/lavaland/surface/outdoors)
"Ai" = (
/obj/structure/stone_tile/block{
	dir = 1
	},
/turf/open/misc/asteroid/basalt/lava_land_surface,
/area/lavaland/surface/outdoors)
"At" = (
/obj/structure/stone_tile/block/cracked,
/turf/open/lava/smooth/lava_land_surface,
/area/lavaland/surface/outdoors)
"Bn" = (
/obj/structure/stone_tile/slab/cracked{
	dir = 4
	},
/obj/structure/stone_tile/slab/cracked{
	dir = 8
	},
/turf/closed/mineral/volcanic/lava_land_surface,
/area/lavaland/surface/outdoors)
"BQ" = (
/obj/structure/trap/fire{
	name = "Anctient runic spikes";
	desc = "A strange carving of some symbols. What's that for?";
	alpha = 180;
	icon = 'icons/obj/service/hydroponics/equipment.dmi';
	icon_state = "woodspike";
	light_color = "#FF1111";
	color = "#FF1111";
	max_integrity = 30
	},
/obj/effect/spawner/random/entertainment/coin{
	pixel_x = 4;
	pixel_y = -5
	},
/turf/closed/mineral/volcanic/lava_land_surface,
/area/lavaland/surface/outdoors)
"BX" = (
/obj/item/reagent_containers/cup/bowl/wood_bowl,
/obj/structure/stone_tile/slab,
/turf/closed/mineral/random/high_chance/volcanic,
/area/lavaland/surface/outdoors)
"CH" = (
/obj/structure/stone_tile/slab/cracked{
	dir = 4
	},
/turf/closed/mineral/random/high_chance/volcanic,
/area/ruin/unpowered)
"CI" = (
/obj/structure/stone_tile/block/cracked{
	dir = 4
	},
/mob/living/basic/mining/ancient_demon/goliath_pup,
/turf/open/misc/asteroid/basalt/lava_land_surface,
/area/lavaland/surface/outdoors)
"Dz" = (
/obj/item/ammo_casing/rebar,
/obj/effect/spawner/random/structure/orevein_longregen,
/turf/closed/mineral/volcanic/lava_land_surface,
/area/lavaland/surface/outdoors)
"DS" = (
/turf/closed/mineral/random/high_chance/volcanic,
/area/ruin/unpowered)
"DX" = (
/obj/structure/stone_tile/surrounding_tile,
/obj/structure/stone_tile/surrounding_tile{
	dir = 4
	},
/turf/open/lava/smooth/lava_land_surface,
/area/lavaland/surface/outdoors)
"EF" = (
/obj/structure/stone_tile/surrounding,
/obj/structure/stone_tile/center/cracked,
/turf/open/misc/asteroid/basalt/lava_land_surface,
/area/lavaland/surface/outdoors)
"Fg" = (
/obj/structure/stone_tile/slab/burnt,
/turf/open/lava/smooth/lava_land_surface,
/area/lavaland/surface/outdoors)
"Hc" = (
/obj/structure/stone_tile{
	dir = 1
	},
/obj/structure/stone_tile{
	dir = 4
	},
/obj/structure/stone_tile/burnt,
/turf/closed/mineral/volcanic/lava_land_surface,
/area/lavaland/surface/outdoors)
"HD" = (
/obj/structure/flora/rock/pile/style_random,
/obj/effect/spawner/random/entertainment/coin{
	pixel_x = -9;
	pixel_y = 7
	},
/turf/open/misc/asteroid/basalt/lava_land_surface,
/area/lavaland/surface/outdoors)
"HJ" = (
/obj/structure/stone_tile{
	dir = 1
	},
/obj/structure/stone_tile{
	dir = 4
	},
/obj/structure/stone_tile/burnt,
/turf/open/misc/asteroid/basalt/lava_land_surface,
/area/lavaland/surface/outdoors)
"HM" = (
/obj/effect/mapping_helpers/bombable_wall,
/turf/closed/indestructible/riveted/boss/wasteland,
/area/ruin/unpowered)
"HT" = (
/turf/closed/indestructible/riveted/boss,
/area/lavaland/surface/outdoors)
"Iz" = (
/obj/structure/stone_tile,
/obj/structure/stone_tile{
	dir = 8
	},
/turf/closed/mineral/random/high_chance/volcanic,
/area/lavaland/surface/outdoors)
"Jk" = (
/obj/structure/stone_tile/slab/cracked{
	dir = 6
	},
/turf/open/misc/asteroid/basalt/lava_land_surface,
/area/lavaland/surface/outdoors)
"Kk" = (
/obj/structure/stone_tile/surrounding,
/obj/structure/stone_tile/center/cracked,
/obj/effect/spawner/random/mob/necropolis_mob,
/turf/closed/mineral/random/high_chance/volcanic,
/area/lavaland/surface/outdoors)
"Ku" = (
/obj/structure/stone_tile{
	dir = 1
	},
/obj/structure/stone_tile{
	dir = 4
	},
/obj/structure/stone_tile/burnt,
/turf/open/lava/smooth/lava_land_surface,
/area/lavaland/surface/outdoors)
"Lh" = (
/obj/item/forging/hammer/primitive,
/obj/structure/stone_tile/slab,
/turf/closed/mineral/volcanic/lava_land_surface,
/area/lavaland/surface/outdoors)
"LH" = (
/obj/item/reagent_containers/cup/bowl/wood_bowl{
	pixel_x = 7;
	pixel_y = 1
	},
/obj/structure/stone_tile/slab,
/turf/open/misc/asteroid/basalt/lava_land_surface,
/area/ruin/unpowered)
"Mr" = (
/obj/structure/stone_tile,
/obj/structure/stone_tile{
	dir = 1
	},
/turf/closed/mineral/volcanic/lava_land_surface,
/area/lavaland/surface/outdoors)
"Mt" = (
/obj/structure/stone_tile{
	dir = 8
	},
/obj/effect/spawner/random/structure/spikes,
/turf/closed/mineral/volcanic/lava_land_surface,
/area/lavaland/surface/outdoors)
"Nv" = (
/obj/item/clothing/suit/ash_plates/decorated,
/obj/effect/spawner/random/mob/necropolis_mob,
/turf/closed/mineral/volcanic/lava_land_surface,
/area/lavaland/surface/outdoors)
"NP" = (
/obj/effect/spawner/random/structure/orevein_longregen,
/turf/closed/mineral/volcanic/lava_land_surface,
/area/lavaland/surface/outdoors)
"Oj" = (
/obj/structure/punji_sticks/spikes,
/turf/closed/mineral/random/high_chance/volcanic,
/area/lavaland/surface/outdoors)
"On" = (
/obj/structure/stone_tile/slab/cracked{
	dir = 6
	},
/turf/closed/mineral/volcanic/lava_land_surface,
/area/lavaland/surface/outdoors)
"OK" = (
/obj/structure/stone_tile/slab/cracked{
	dir = 4
	},
/obj/structure/stone_tile/slab/cracked{
	dir = 8
	},
/turf/closed/mineral/random/high_chance/volcanic,
/area/lavaland/surface/outdoors)
"Pl" = (
/obj/structure/stone_tile/slab,
/obj/effect/spawner/random/entertainment/coin{
	pixel_x = 5;
	pixel_y = -5
	},
/turf/open/misc/asteroid/basalt/lava_land_surface,
/area/ruin/unpowered)
"Po" = (
/obj/structure/stone_tile/slab,
/turf/open/misc/asteroid/basalt/lava_land_surface,
/area/lavaland/surface/outdoors)
"Pq" = (
/obj/structure/stone_tile,
/obj/effect/spawner/random/structure/spikes,
/turf/closed/mineral/random/high_chance/volcanic,
/area/lavaland/surface/outdoors)
"PN" = (
/obj/structure/punji_sticks/spikes,
/turf/closed/mineral/volcanic/lava_land_surface,
/area/lavaland/surface/outdoors)
"QM" = (
/obj/structure/stone_tile/slab,
/mob/living/basic/mining/ancient_demon,
/turf/open/misc/asteroid/basalt/lava_land_surface,
/area/lavaland/surface/outdoors)
"QP" = (
/obj/effect/spawner/random/structure/spikes,
/turf/closed/mineral/random/high_chance/volcanic,
/area/lavaland/surface/outdoors)
"Rb" = (
/obj/structure/stone_tile/slab/cracked{
	dir = 6
	},
/turf/closed/mineral/random/high_chance/volcanic,
/area/lavaland/surface/outdoors)
"Rg" = (
/obj/structure/stone_tile,
/obj/structure/stone_tile{
	dir = 1
	},
/mob/living/basic/mining/ancient_demon/goliath_pup,
/mob/living/basic/mining/ancient_demon/goliath_pup,
/mob/living/basic/mining/ancient_demon/goliath_pup,
/turf/closed/mineral/volcanic/lava_land_surface,
/area/lavaland/surface/outdoors)
"Rq" = (
/obj/structure/stone_tile/block{
	dir = 1
	},
/obj/structure/stone_tile/block/cracked,
/turf/open/lava/smooth/lava_land_surface,
/area/lavaland/surface/outdoors)
"Rt" = (
/obj/structure/stone_tile/block/burnt,
/obj/effect/spawner/random/structure/spikes,
/turf/open/misc/asteroid/basalt/lava_land_surface,
/area/lavaland/surface/outdoors)
"Rz" = (
/obj/structure/flora/rock/pile/style_random,
/mob/living/basic/mining/ancient_demon/goliath_pup,
/mob/living/basic/mining/ancient_demon/goliath_pup,
/turf/closed/mineral/volcanic/lava_land_surface,
/area/lavaland/surface/outdoors)
"RF" = (
/obj/structure/stone_tile/surrounding,
/obj/structure/stone_tile/center,
/turf/closed/mineral/volcanic/lava_land_surface,
/area/lavaland/surface/outdoors)
"RU" = (
/obj/item/crowbar/ashwalker,
/obj/structure/stone_tile/slab,
/turf/open/misc/asteroid/basalt/lava_land_surface,
/area/lavaland/surface/outdoors)
"Sn" = (
/obj/structure/flora/rock/pile/style_random,
/obj/effect/spawner/random/mob/necropolis_mob,
/turf/open/misc/asteroid/basalt/lava_land_surface,
/area/lavaland/surface/outdoors)
"SB" = (
/obj/structure/stone_tile/slab,
/turf/open/misc/asteroid/basalt/lava_land_surface,
/area/ruin/unpowered)
"SU" = (
/obj/structure/stone_tile/slab/cracked{
	dir = 4
	},
/turf/closed/mineral/random/high_chance/volcanic,
/area/lavaland/surface/outdoors)
"Tp" = (
/obj/structure/stone_tile/slab/cracked{
	dir = 6
	},
/obj/item/xenoarch/useless_relic{
	name = "Ancient relic";
	desc = "Sort of relic that can be exported through Cargo."
	},
/turf/closed/mineral/random/high_chance/volcanic,
/area/lavaland/surface/outdoors)
"Tz" = (
/obj/effect/spawner/random/structure/orevein_longregen,
/turf/closed/mineral/volcanic/lava_land_surface,
/area/ruin/unpowered)
"TO" = (
/obj/item/clothing/suit/cloak/ashencloak,
/obj/structure/stone_tile/slab,
/turf/closed/mineral/random/high_chance/volcanic,
/area/ruin/unpowered)
"TU" = (
/obj/effect/mapping_helpers/bombable_wall,
/turf/closed/indestructible/riveted/boss/wasteland,
/area/lavaland/surface/outdoors)
"Ub" = (
/obj/structure/stone_tile/slab/cracked{
	dir = 6
	},
/turf/closed/mineral/strange_rock/volcanic,
/area/lavaland/surface/outdoors)
"Ue" = (
/obj/structure/stone_tile,
/obj/structure/stone_tile{
	dir = 8
	},
/obj/structure/stone_tile{
	dir = 1
	},
/turf/closed/mineral/volcanic/lava_land_surface,
/area/lavaland/surface/outdoors)
"Uk" = (
/obj/item/kitchen/spoon,
/obj/structure/stone_tile/slab,
/turf/closed/mineral/random/high_chance/volcanic,
/area/lavaland/surface/outdoors)
"UX" = (
/obj/structure/stone_tile/block/burnt,
/turf/open/lava/smooth/lava_land_surface,
/area/lavaland/surface/outdoors)
"Vt" = (
/obj/structure/stone_tile/slab,
/turf/open/lava/smooth/lava_land_surface,
/area/lavaland/surface/outdoors)
"Vv" = (
/obj/structure/stone_tile/surrounding_tile{
	dir = 4
	},
/obj/structure/stone_tile/surrounding_tile,
/obj/effect/spawner/random/mob/necropolis_mob,
/turf/open/misc/asteroid/basalt/lava_land_surface,
/area/lavaland/surface/outdoors)
"Vz" = (
/obj/structure/stone_tile/surrounding_tile{
	dir = 1
	},
/turf/open/lava/smooth/lava_land_surface,
/area/lavaland/surface/outdoors)
"VJ" = (
/obj/structure/stone_tile{
	dir = 8
	},
/obj/structure/stone_tile{
	dir = 1
	},
/obj/structure/stone_tile/burnt,
/obj/structure/stone_tile/cracked{
	dir = 4
	},
/turf/open/misc/asteroid/basalt/lava_land_surface,
/area/lavaland/surface/outdoors)
"VQ" = (
/obj/structure/stone_tile/slab/cracked{
	dir = 4
	},
/obj/structure/stone_tile/slab/cracked{
	dir = 8
	},
/obj/item/xenoarch/useless_relic{
	name = "Ancient relic";
	desc = "Sort of relic that can be exported through Cargo."
	},
/turf/closed/mineral/random/high_chance/volcanic,
/area/ruin/unpowered)
"Wb" = (
/obj/effect/spawner/random/structure/orevein_longregen,
/turf/closed/mineral/random/high_chance/volcanic,
/area/ruin/unpowered)
"Wr" = (
/obj/structure/stone_tile/slab,
/obj/effect/spawner/random/entertainment/coin{
	pixel_x = -10;
	pixel_y = 0
	},
/turf/open/misc/asteroid/basalt/lava_land_surface,
/area/ruin/unpowered)
"WP" = (
/obj/structure/stone_tile/block{
	dir = 4
	},
/obj/structure/stone_tile/block{
	dir = 8
	},
/turf/closed/mineral/volcanic/lava_land_surface,
/area/lavaland/surface/outdoors)
"Xb" = (
/turf/closed/mineral/volcanic/lava_land_surface,
/area/lavaland/surface/outdoors)
"Xe" = (
/obj/structure/stone_tile{
	dir = 8
	},
/obj/structure/stone_tile{
	dir = 1
	},
/obj/structure/stone_tile/burnt,
/obj/structure/stone_tile/cracked{
	dir = 4
	},
/obj/effect/spawner/random/mob/necropolis_mob,
/turf/open/misc/asteroid/basalt/lava_land_surface,
/area/lavaland/surface/outdoors)
"Yd" = (
/turf/closed/indestructible/riveted/boss,
/area/ruin/unpowered)
"Ys" = (
/obj/structure/stone_tile/slab/cracked{
	dir = 6
	},
/obj/item/xenoarch/useless_relic{
	name = "Ancient relic";
	desc = "Sort of relic that can be exported through Cargo."
	},
/turf/closed/mineral/random/high_chance/volcanic,
/area/ruin/unpowered)
"YJ" = (
/obj/structure/stone_tile/block{
	dir = 4
	},
/turf/closed/mineral/volcanic/lava_land_surface,
/area/lavaland/surface/outdoors)
"Zh" = (
/obj/item/forging/tongs/primitive,
/obj/structure/stone_tile/slab,
/turf/closed/mineral/random/high_chance/volcanic,
/area/ruin/unpowered)
"Zp" = (
/obj/structure/stone_tile{
	dir = 8
	},
/obj/structure/stone_tile{
	dir = 1
	},
/obj/structure/stone_tile{
	dir = 4
	},
/turf/closed/mineral/volcanic/lava_land_surface,
/area/lavaland/surface/outdoors)
"Zw" = (
/obj/structure/stone_tile/slab,
/obj/item/clothing/gloves/military/ashwalk,
/obj/effect/spawner/random/mob/necropolis_mob,
/turf/closed/mineral/volcanic/lava_land_surface,
/area/lavaland/surface/outdoors)

(1,1,1) = {"
je
NP
sR
sR
cH
Rz
je
je
je
cH
QP
je
je
cH
ic
cH
Xb
je
cH
Dz
ib
Xb
Xb
je
"}
(2,1,1) = {"
cH
Zp
Yd
Yd
Yd
TU
Xb
TU
HT
HT
fW
HT
HT
HT
HT
HT
HT
HT
Yd
HM
Yd
HT
dH
cH
"}
(3,1,1) = {"
QP
Yd
Yd
Ys
nG
uo
Xb
Bn
vd
HT
HT
HT
nL
NP
RU
HT
vd
vd
nG
qA
CH
Yd
Yd
QP
"}
(4,1,1) = {"
cH
Yd
Wb
sR
BQ
nG
vd
je
vd
vd
HT
sR
sR
vd
rs
Vt
At
vd
aQ
sR
sR
jw
Yd
cH
"}
(5,1,1) = {"
je
Yd
jw
sR
Zw
Rb
je
je
nG
vd
HT
Tp
vd
Fg
ng
ng
ng
Fg
cH
BX
je
hd
Yd
cH
"}
(6,1,1) = {"
je
Yd
Yd
CH
vd
wn
je
je
je
HT
HT
HT
vd
ng
ng
ng
Ac
Po
nG
nG
nG
Yd
Yd
je
"}
(7,1,1) = {"
je
Hc
Yd
HM
HT
HT
je
Jk
HT
HT
rK
HT
ng
ng
HT
HT
HT
HT
vd
fB
Yd
Yd
ua
je
"}
(8,1,1) = {"
je
Xb
cH
cH
cH
cH
vd
Po
cH
sq
HD
ng
ng
je
ng
ng
ng
je
sq
nG
QP
je
je
je
"}
(9,1,1) = {"
je
Po
Mt
OK
WP
nG
RF
vd
Ue
Fg
Rq
DX
qy
uV
pg
Ku
Vt
dm
Po
WP
vd
VJ
Po
ue
"}
(10,1,1) = {"
Ai
Jk
HJ
vd
YJ
nG
Kk
vd
Xe
Po
UX
Vz
Vv
Rq
Fg
aa
Po
EF
Po
CI
vd
Pq
vd
Rt
"}
(11,1,1) = {"
je
je
je
cH
cH
cH
Rb
vd
cH
cH
je
ng
ng
ng
ng
je
Sn
ng
rs
Po
je
Xb
cH
je
"}
(12,1,1) = {"
cH
Zp
Yd
Yd
Yd
Yd
vd
Po
HT
HT
iN
HT
HT
ng
HT
HT
HT
ng
ng
vs
HT
HT
tX
je
"}
(13,1,1) = {"
cH
Yd
Yd
VQ
vy
nG
On
Po
QM
HT
HT
HT
ng
ng
ng
je
ng
ng
ng
ng
ng
HT
HT
je
"}
(14,1,1) = {"
cH
Yd
Wb
Wb
Uk
xI
vd
fG
Fg
ng
ng
ng
ng
je
ng
ng
ng
Fg
At
ng
ng
ng
HT
je
"}
(15,1,1) = {"
bO
Yd
Wb
nG
PN
vd
Po
Vt
id
ng
HT
At
Vt
Po
Fg
At
Vt
NP
NP
NP
ng
id
HT
je
"}
(16,1,1) = {"
je
Yd
SU
NP
Nv
Po
sV
ng
ng
ng
HT
nG
Ub
je
Po
sf
HT
NP
xy
Rb
sR
yt
HT
je
"}
(17,1,1) = {"
je
HT
NP
vd
Vt
Fg
Vt
ng
Vt
rs
HT
vd
vd
vd
NP
dl
HT
pU
sR
sR
yt
sR
HT
je
"}
(18,1,1) = {"
je
HT
HT
rs
ng
ng
HT
ng
Yd
Yd
Yd
HT
je
vd
HT
HT
HT
Yd
Yd
Yd
Yd
Yd
Yd
cH
"}
(19,1,1) = {"
je
HT
Po
ng
ng
ng
ng
ng
yN
ij
Yd
je
je
vd
nG
On
HT
ef
rZ
Zh
vy
me
Yd
QP
"}
(20,1,1) = {"
cH
HT
At
ng
Ac
ng
ng
rs
SB
sQ
Yd
je
nG
eE
QP
vd
cH
je
Tz
vy
zN
vy
Yd
cH
"}
(21,1,1) = {"
QP
HT
Fg
ng
Vt
At
Fg
SB
LH
Pl
Yd
Rb
nG
QP
nG
sR
cH
je
DS
mz
vy
au
Yd
QP
"}
(22,1,1) = {"
cH
HT
HT
rs
sf
Yd
ij
wQ
Wr
Yd
Yd
HT
nG
nG
On
Lh
HT
je
Tz
Tz
TO
Yd
Yd
Iz
"}
(23,1,1) = {"
cH
cK
HT
HT
HT
Yd
Yd
HM
Yd
Yd
wb
HT
HT
HT
Xb
cH
Xb
cH
HM
Yd
Yd
Yd
Ue
Xb
"}
(24,1,1) = {"
je
cH
cH
cH
je
je
je
je
cH
QP
QP
QP
cH
je
je
Rg
cH
sv
cH
Mr
Oj
Mr
Xb
je
"}
