//MAP CONVERTED BY dmm2tgm.py THIS HEADER COMMENT PREVENTS RECONVERSION, DO NOT REMOVE
"a" = (
/turf/open/lava/smooth/lava_land_surface,
/area/ruin/unpowered)
"b" = (
/obj/structure/stone_tile/slab/cracked,
/turf/closed/mineral/volcanic/lava_land_surface,
/area/ruin/unpowered)
"f" = (
/obj/structure/ore_vent/random{
	ore_vent_options = list("large" = 15, "medium" = 0, "small" = 0);
	name = "Large ore vent"
	},
/obj/structure/stone_tile/surrounding/cracked{
	dir = 6
	},
/turf/closed/mineral/volcanic/lava_land_surface,
/area/ruin/unpowered)
"j" = (
/turf/template_noop,
/area/template_noop)
"k" = (
/obj/effect/spawner/random/structure/spikes,
/turf/closed/mineral/volcanic/lava_land_surface,
/area/ruin/unpowered)
"n" = (
/obj/structure/stone_tile/surrounding_tile/cracked,
/turf/closed/mineral/volcanic/lava_land_surface,
/area/ruin/unpowered)
"o" = (
/turf/open/chasm/lavaland,
/area/ruin/unpowered)
"p" = (
/obj/structure/stone_tile/slab/cracked{
	dir = 5
	},
/obj/structure/stone_tile/slab/cracked{
	dir = 10
	},
/turf/open/chasm/lavaland,
/area/lavaland/surface/outdoors)
"v" = (
/obj/structure/stone_tile/slab/cracked{
	dir = 5
	},
/mob/living/basic/mining/brimdemon,
/turf/closed/mineral/volcanic/lava_land_surface,
/area/ruin/unpowered)
"w" = (
/turf/closed/indestructible/riveted/boss,
/area/ruin/unpowered)
"x" = (
/obj/structure/stone_tile/surrounding_tile/burnt{
	dir = 4
	},
/turf/open/lava/smooth/lava_land_surface,
/area/ruin/unpowered)
"y" = (
/obj/structure/flora/rock/style_random,
/turf/closed/mineral/volcanic/lava_land_surface,
/area/ruin/unpowered)
"z" = (
/obj/structure/stone_tile/surrounding/cracked{
	dir = 4
	},
/turf/open/chasm/lavaland,
/area/lavaland/surface/outdoors)
"B" = (
/obj/effect/mapping_helpers/bombable_wall,
/turf/closed/indestructible/riveted/boss/wasteland,
/area/ruin/unpowered)
"D" = (
/obj/structure/stone_tile/surrounding_tile/cracked{
	dir = 1
	},
/turf/closed/mineral/volcanic/lava_land_surface,
/area/ruin/unpowered)
"E" = (
/obj/structure/stone_tile/surrounding_tile/cracked{
	dir = 5
	},
/obj/effect/spawner/random/structure/spikes,
/turf/closed/mineral/volcanic/lava_land_surface,
/area/ruin/unpowered)
"F" = (
/obj/structure/stone_tile/surrounding/cracked{
	dir = 8
	},
/mob/living/basic/mining/brimdemon,
/turf/closed/mineral/volcanic/lava_land_surface,
/area/ruin/unpowered)
"J" = (
/obj/structure/stone_tile{
	dir = 8
	},
/obj/structure/stone_tile/surrounding_tile/cracked{
	dir = 9
	},
/obj/item/xenoarch/useless_relic/magnified{
	name = "Ancient relic";
	desc = "Sort of relic that can be exported through Cargo."
	},
/turf/closed/mineral/volcanic/lava_land_surface,
/area/ruin/unpowered)
"K" = (
/obj/structure/stone_tile/surrounding_tile/burnt,
/turf/open/lava/smooth/lava_land_surface,
/area/ruin/unpowered)
"N" = (
/obj/structure/stone_tile/surrounding_tile/cracked{
	dir = 9
	},
/obj/structure/stone_tile/surrounding_tile/cracked{
	dir = 8
	},
/turf/closed/mineral/volcanic/lava_land_surface,
/area/ruin/unpowered)
"O" = (
/obj/structure/flora/rock/pile/style_random,
/mob/living/basic/mining/brimdemon,
/turf/closed/mineral/volcanic/lava_land_surface,
/area/ruin/unpowered)
"P" = (
/turf/open/chasm/lavaland,
/area/lavaland/surface/outdoors)
"S" = (
/obj/structure/stone_tile/surrounding_tile/cracked,
/obj/effect/spawner/random/structure/spikes,
/turf/closed/mineral/volcanic/lava_land_surface,
/area/lavaland/surface/outdoors)
"V" = (
/turf/closed/mineral/strong{
	base_icon_state = "smoothrocks";
	icon = 'modular_nova/modules/liquids/icons/turf/smoothrocks.dmi';
	icon_state = "smoothrocks-55"
	},
/area/ruin/unpowered)
"X" = (
/obj/structure/stone_tile/block/cracked{
	pixel_y = -16
	},
/turf/open/lava/smooth/lava_land_surface,
/area/ruin/unpowered)

(1,1,1) = {"
j
w
w
B
w
w
j
"}
(2,1,1) = {"
w
w
a
V
a
w
w
"}
(3,1,1) = {"
w
a
x
D
a
a
w
"}
(4,1,1) = {"
w
a
w
k
B
a
w
"}
(5,1,1) = {"
w
V
V
v
n
a
w
"}
(6,1,1) = {"
w
V
w
f
w
B
w
"}
(7,1,1) = {"
w
V
J
O
y
X
w
"}
(8,1,1) = {"
w
o
B
F
w
a
w
"}
(9,1,1) = {"
w
o
E
b
K
a
w
"}
(10,1,1) = {"
w
w
N
a
a
w
w
"}
(11,1,1) = {"
j
w
w
B
w
w
j
"}
(12,1,1) = {"
j
j
P
z
p
S
j
"}
