//MAP CONVERTED BY dmm2tgm.py THIS HEADER COMMENT PREVENTS RECONVERSION, DO NOT REMOVE
"a" = (
/turf/template_noop,
/area/template_noop)
"e" = (
/obj/structure/flora/rock/pile/style_random,
/turf/closed/mineral/strong{
	base_icon_state = "smoothrocks";
	icon = 'modular_nova/modules/liquids/icons/turf/smoothrocks.dmi';
	icon_state = "smoothrocks-55"
	},
/area/lavaland/surface/outdoors)
"m" = (
/obj/structure/ore_vein/diamond,
/turf/closed/mineral/random/high_chance/volcanic,
/area/lavaland/surface/outdoors)
"r" = (
/obj/item/xenoarch/useless_relic/magnified{
	name = "Ancient relic";
	desc = "Sort of relic that can be exported through Cargo."
	},
/turf/closed/mineral/random/high_chance/volcanic,
/area/lavaland/surface/outdoors)
"v" = (
/obj/structure/ore_vein/silver,
/turf/closed/mineral/random/high_chance/volcanic,
/area/lavaland/surface/outdoors)
"w" = (
/obj/effect/spawner/random/mob/necropolis_mob,
/turf/closed/mineral/random/high_chance/volcanic,
/area/lavaland/surface/outdoors)
"x" = (
/obj/structure/ore_vein/plasma,
/obj/item/xenoarch/useless_relic/magnified{
	name = "Ancient relic";
	desc = "Sort of relic that can be exported through Cargo."
	},
/turf/closed/mineral/random/high_chance/volcanic,
/area/lavaland/surface/outdoors)
"z" = (
/turf/closed/indestructible/riveted/boss,
/area/lavaland/surface/outdoors)
"A" = (
/obj/structure/ore_vein,
/turf/closed/mineral/random/high_chance/volcanic,
/area/lavaland/surface/outdoors)
"G" = (
/obj/structure/ore_vein/iron,
/obj/effect/spawner/random/mob/necropolis_mob,
/turf/closed/mineral/random/high_chance/volcanic,
/area/lavaland/surface/outdoors)
"H" = (
/obj/structure/ore_vein/iron,
/turf/closed/mineral/random/high_chance/volcanic,
/area/lavaland/surface/outdoors)
"M" = (
/obj/structure/ore_vein/gold,
/turf/closed/mineral/random/high_chance/volcanic,
/area/lavaland/surface/outdoors)
"N" = (
/obj/structure/flora/rock/pile/style_random,
/obj/structure/ore_vein/gold,
/turf/closed/mineral/random/high_chance/volcanic,
/area/lavaland/surface/outdoors)
"S" = (
/turf/closed/mineral/random/high_chance/volcanic,
/area/lavaland/surface/outdoors)
"T" = (
/obj/structure/flora/rock/pile/style_random,
/turf/closed/mineral/random/high_chance/volcanic,
/area/lavaland/surface/outdoors)
"U" = (
/turf/closed/mineral/strong{
	base_icon_state = "smoothrocks";
	icon = 'modular_nova/modules/liquids/icons/turf/smoothrocks.dmi';
	icon_state = "smoothrocks-55"
	},
/area/lavaland/surface/outdoors)
"V" = (
/obj/structure/ore_vein,
/obj/effect/spawner/random/mob/necropolis_mob,
/turf/closed/mineral/random/high_chance/volcanic,
/area/lavaland/surface/outdoors)
"X" = (
/obj/structure/ore_vein/plasma,
/turf/closed/mineral/random/high_chance/volcanic,
/area/lavaland/surface/outdoors)

(1,1,1) = {"
a
a
a
a
a
a
a
a
a
a
a
z
z
z
z
a
"}
(2,1,1) = {"
a
a
a
a
a
a
a
z
a
a
U
U
S
H
z
z
"}
(3,1,1) = {"
a
a
a
a
a
a
a
z
a
U
U
S
T
S
S
z
"}
(4,1,1) = {"
z
a
z
z
z
a
a
z
a
e
m
S
V
S
S
z
"}
(5,1,1) = {"
z
U
U
S
z
z
a
z
z
z
v
S
S
x
m
z
"}
(6,1,1) = {"
z
U
S
m
T
z
a
a
a
U
S
M
S
S
S
z
"}
(7,1,1) = {"
z
S
v
S
S
z
U
a
a
U
U
H
S
M
S
z
"}
(8,1,1) = {"
z
H
w
S
M
v
U
a
a
z
z
z
X
w
A
z
"}
(9,1,1) = {"
z
S
S
X
S
S
U
a
a
a
a
z
S
S
T
U
"}
(10,1,1) = {"
z
S
N
S
G
S
z
z
z
a
a
z
S
m
S
U
"}
(11,1,1) = {"
z
S
m
r
M
T
z
a
a
a
a
z
U
S
v
U
"}
(12,1,1) = {"
z
S
S
A
S
S
z
a
a
a
a
a
U
H
U
U
"}
(13,1,1) = {"
z
U
X
S
m
S
z
a
a
a
a
a
z
z
z
a
"}
(14,1,1) = {"
z
U
S
S
T
U
U
a
a
a
a
a
a
a
a
a
"}
(15,1,1) = {"
a
U
U
H
U
U
a
a
a
a
a
a
a
a
a
a
"}
(16,1,1) = {"
a
a
z
z
z
z
z
z
z
a
a
a
a
a
a
a
"}
