//MAP CONVERTED BY dmm2tgm.py THIS HEADER COMMENT PREVENTS RECONVERSION, DO NOT REMOVE
"a" = (
/turf/open/lava/smooth/lava_land_surface,
/area/lavaland/surface/outdoors)
"b" = (
/turf/closed/mineral/strong{
	base_icon_state = "smoothrocks";
	icon = 'modular_nova/modules/liquids/icons/turf/smoothrocks.dmi';
	icon_state = "smoothrocks-55"
	},
/area/lavaland/surface/outdoors)
"j" = (
/obj/effect/spawner/random/structure/orevein_longregen,
/turf/closed/mineral/volcanic/lava_land_surface,
/area/lavaland/surface/outdoors)
"y" = (
/turf/open/chasm/lavaland,
/area/lavaland/surface/outdoors)
"z" = (
/obj/structure/ore_vent/random{
	ore_vent_options = list("large" = 0, "medium" = 15, "small" = 0);
	name = "Medium ore vent"
	},
/turf/closed/mineral/volcanic/lava_land_surface,
/area/lavaland/surface/outdoors)
"D" = (
/obj/effect/spawner/random/structure/orevein_longregen,
/turf/closed/mineral/strong{
	base_icon_state = "smoothrocks";
	icon = 'modular_nova/modules/liquids/icons/turf/smoothrocks.dmi';
	icon_state = "smoothrocks-55"
	},
/area/lavaland/surface/outdoors)
"I" = (
/obj/item/xenoarch/useless_relic{
	name = "Ancient relic";
	desc = "Sort of relic that can be exported through Cargo."
	},
/turf/closed/mineral/volcanic/lava_land_surface,
/area/lavaland/surface/outdoors)
"K" = (
/obj/structure/flora/rock/pile/style_random,
/turf/closed/mineral/volcanic/lava_land_surface,
/area/lavaland/surface/outdoors)
"V" = (
/turf/template_noop,
/area/template_noop)
"X" = (
/obj/structure/flora/rock/pile/style_random,
/mob/living/basic/mining/goliath,
/turf/closed/mineral/volcanic/lava_land_surface,
/area/lavaland/surface/outdoors)

(1,1,1) = {"
b
V
V
V
a
a
V
"}
(2,1,1) = {"
D
b
a
a
a
a
V
"}
(3,1,1) = {"
y
a
a
K
I
a
a
"}
(4,1,1) = {"
b
a
j
z
b
D
a
"}
(5,1,1) = {"
D
a
X
j
b
a
a
"}
(6,1,1) = {"
D
a
b
b
y
a
V
"}
(7,1,1) = {"
V
a
a
a
a
a
V
"}
