//MAP CONVERTED BY dmm2tgm.py THIS HEADER COMMENT PREVENTS RECONVERSION, DO NOT REMOVE
"a" = (
/turf/template_noop,
/area/template_noop)
"b" = (
/obj/structure/punji_sticks/spikes,
/turf/open/misc/asteroid/basalt/lava_land_surface,
/area/lavaland/surface/outdoors)
"e" = (
/turf/open/misc/asteroid/basalt/lava_land_surface,
/area/lavaland/surface/outdoors)
"g" = (
/obj/structure/stone_tile/block/cracked{
	dir = 1
	},
/obj/effect/spawner/random/mob/necropolis_mob,
/turf/closed/mineral/random/high_chance/volcanic,
/area/lavaland/surface/outdoors)
"h" = (
/obj/structure/flora/rock/pile/style_random,
/obj/structure/flora/rock/pile/style_random,
/turf/closed/mineral/random/high_chance/volcanic,
/area/lavaland/surface/outdoors)
"k" = (
/obj/structure/punji_sticks/spikes,
/turf/closed/mineral/random/high_chance/volcanic,
/area/lavaland/surface/outdoors)
"n" = (
/obj/structure/flora/rock/pile/style_random,
/obj/effect/spawner/random/mob/necropolis_mob,
/turf/closed/mineral/random/high_chance/volcanic,
/area/lavaland/surface/outdoors)
"r" = (
/obj/structure/punji_sticks/spikes,
/obj/effect/decal/cleanable/blood/old,
/turf/open/misc/asteroid/basalt/lava_land_surface,
/area/lavaland/surface/outdoors)
"s" = (
/obj/structure/flora/rock/style_random,
/turf/closed/mineral/random/high_chance/volcanic,
/area/lavaland/surface/outdoors)
"u" = (
/obj/effect/spawner/random/structure/spikes,
/turf/closed/mineral/volcanic/lava_land_surface,
/area/lavaland/surface/outdoors)
"v" = (
/obj/structure/punji_sticks/spikes,
/obj/effect/decal/cleanable/blood/gibs/old,
/turf/open/misc/asteroid/basalt/lava_land_surface,
/area/lavaland/surface/outdoors)
"y" = (
/obj/effect/spawner/random/mob/necropolis_mob,
/turf/closed/mineral/random/high_chance/volcanic,
/area/lavaland/surface/outdoors)
"B" = (
/obj/effect/spawner/random/structure/spikes,
/turf/closed/mineral/random/high_chance/volcanic,
/area/lavaland/surface/outdoors)
"C" = (
/obj/item/xenoarch/useless_relic{
	name = "Ancient relic";
	desc = "Sort of relic that can be exported through Cargo."
	},
/turf/open/misc/asteroid/basalt/lava_land_surface,
/area/lavaland/surface/outdoors)
"F" = (
/obj/structure/flora/rock/pile/style_random,
/turf/closed/mineral/random/high_chance/volcanic,
/area/lavaland/surface/outdoors)
"I" = (
/obj/structure/flora/rock/pile/style_random,
/obj/effect/spawner/random/structure/spikes,
/turf/closed/mineral/random/high_chance/volcanic,
/area/lavaland/surface/outdoors)
"L" = (
/obj/effect/decal/cleanable/blood/old,
/obj/item/xenoarch/useless_relic{
	name = "Ancient relic";
	desc = "Sort of relic that can be exported through Cargo."
	},
/turf/open/misc/asteroid/basalt/lava_land_surface,
/area/lavaland/surface/outdoors)
"P" = (
/obj/structure/flora/rock/pile/style_random,
/turf/closed/mineral/volcanic/lava_land_surface,
/area/lavaland/surface/outdoors)
"Q" = (
/obj/structure/healingfountain,
/obj/structure/stone_tile/slab,
/turf/closed/mineral/random/high_chance/volcanic,
/area/lavaland/surface/outdoors)
"R" = (
/obj/effect/decal/cleanable/blood/old,
/mob/living/basic/mining/ancient_demon/demoraptor,
/turf/open/misc/asteroid/basalt/lava_land_surface,
/area/lavaland/surface/outdoors)
"S" = (
/obj/effect/spawner/random/mob/necropolis_mob,
/turf/closed/mineral/volcanic/lava_land_surface,
/area/lavaland/surface/outdoors)
"U" = (
/turf/open/chasm/lavaland,
/area/lavaland/surface/outdoors)
"X" = (
/turf/closed/mineral/volcanic/lava_land_surface,
/area/lavaland/surface/outdoors)
"Y" = (
/turf/closed/mineral/random/high_chance/volcanic,
/area/lavaland/surface/outdoors)

(1,1,1) = {"
a
a
X
I
y
"}
(2,1,1) = {"
a
X
X
U
B
"}
(3,1,1) = {"
a
Y
U
U
X
"}
(4,1,1) = {"
X
k
U
r
X
"}
(5,1,1) = {"
Y
h
U
e
a
"}
(6,1,1) = {"
Y
U
U
P
a
"}
(7,1,1) = {"
u
U
b
Y
a
"}
(8,1,1) = {"
F
U
v
y
a
"}
(9,1,1) = {"
y
U
b
Y
a
"}
(10,1,1) = {"
Y
U
U
P
a
"}
(11,1,1) = {"
Y
b
U
b
a
"}
(12,1,1) = {"
X
L
U
b
X
"}
(13,1,1) = {"
a
X
U
U
u
"}
(14,1,1) = {"
a
F
C
U
F
"}
(15,1,1) = {"
a
s
v
U
Y
"}
(16,1,1) = {"
a
g
Q
U
y
"}
(17,1,1) = {"
a
s
U
U
Y
"}
(18,1,1) = {"
a
X
U
r
Y
"}
(19,1,1) = {"
n
b
U
Y
u
"}
(20,1,1) = {"
Y
U
U
F
a
"}
(21,1,1) = {"
B
U
b
Y
a
"}
(22,1,1) = {"
R
U
U
Y
a
"}
(23,1,1) = {"
X
Y
U
F
a
"}
(24,1,1) = {"
a
I
X
S
a
"}
