//MAP CONVERTED BY dmm2tgm.py THIS HEADER COMMENT PREVENTS RECONVERSION, DO NOT REMOVE
"bc" = (
/obj/structure/stone_tile,
/obj/structure/stone_tile{
	dir = 8
	},
/obj/structure/stone_tile{
	dir = 1
	},
/turf/open/lava/smooth/lava_land_surface,
/area/lavaland/surface/outdoors)
"bo" = (
/obj/structure/stone_tile/surrounding/cracked{
	dir = 6
	},
/obj/structure/stone_tile/center/cracked,
/turf/open/lava/smooth/lava_land_surface,
/area/lavaland/surface/outdoors)
"bL" = (
/obj/structure/stone_tile/burnt,
/turf/open/lava/smooth/lava_land_surface,
/area/lavaland/surface/outdoors)
"bU" = (
/obj/structure/stone_tile,
/turf/closed/mineral/volcanic/lava_land_surface,
/area/lavaland/surface/outdoors)
"cs" = (
/obj/structure/stone_tile{
	dir = 8
	},
/obj/structure/stone_tile{
	dir = 1
	},
/obj/structure/stone_tile/cracked,
/turf/open/misc/asteroid/basalt/lava_land_surface,
/area/lavaland/surface/outdoors)
"cw" = (
/obj/structure/stone_tile/slab/cracked,
/turf/open/lava/smooth/lava_land_surface,
/area/lavaland/surface/outdoors)
"cU" = (
/obj/effect/spawner/random/structure/orevein_longregen,
/turf/closed/mineral/volcanic/lava_land_surface,
/area/lavaland/surface/outdoors)
"de" = (
/obj/structure/stone_tile/surrounding_tile,
/obj/structure/stone_tile/surrounding_tile{
	dir = 4
	},
/turf/closed/mineral/volcanic/lava_land_surface,
/area/lavaland/surface/outdoors)
"eh" = (
/obj/effect/spawner/random/structure/spikes,
/turf/open/misc/asteroid/basalt/lava_land_surface,
/area/lavaland/surface/outdoors)
"gi" = (
/obj/structure/stone_tile{
	dir = 8
	},
/obj/structure/stone_tile{
	dir = 1
	},
/obj/structure/stone_tile/burnt,
/turf/closed/mineral/volcanic/lava_land_surface,
/area/lavaland/surface/outdoors)
"gY" = (
/obj/structure/stone_tile/surrounding_tile/burnt{
	dir = 8
	},
/turf/open/lava/smooth/lava_land_surface,
/area/lavaland/surface/outdoors)
"hA" = (
/obj/structure/flora/ash/stem_shroom,
/turf/closed/mineral/volcanic/lava_land_surface,
/area/lavaland/surface/outdoors)
"hT" = (
/obj/structure/stone_tile/slab/cracked,
/turf/closed/mineral/volcanic/lava_land_surface,
/area/lavaland/surface/outdoors)
"jV" = (
/obj/structure/stone_tile/cracked{
	dir = 4
	},
/turf/closed/mineral/volcanic/lava_land_surface,
/area/lavaland/surface/outdoors)
"jW" = (
/obj/structure/flora/rock/style_random,
/turf/closed/mineral/volcanic/lava_land_surface,
/area/lavaland/surface/outdoors)
"ka" = (
/obj/structure/stone_tile/block/cracked{
	dir = 1
	},
/turf/open/misc/asteroid/basalt/lava_land_surface,
/area/lavaland/surface/outdoors)
"lC" = (
/obj/structure/stone_tile/block/cracked{
	dir = 4
	},
/turf/closed/indestructible/riveted/boss,
/area/lavaland/surface/outdoors)
"lF" = (
/obj/structure/stone_tile{
	dir = 4
	},
/turf/closed/mineral/volcanic/lava_land_surface,
/area/lavaland/surface/outdoors)
"nq" = (
/obj/structure/stone_tile/slab/cracked{
	dir = 6
	},
/obj/item/xenoarch/useless_relic{
	name = "Ancient relic";
	desc = "Sort of relic that can be exported through Cargo."
	},
/turf/closed/mineral/volcanic/lava_land_surface,
/area/lavaland/surface/outdoors)
"nJ" = (
/obj/structure/stone_tile{
	dir = 8
	},
/obj/structure/stone_tile{
	dir = 1
	},
/obj/structure/stone_tile/cracked{
	dir = 4
	},
/turf/open/lava/smooth/lava_land_surface,
/area/lavaland/surface/outdoors)
"po" = (
/obj/structure/stone_tile/surrounding_tile,
/obj/structure/stone_tile/center,
/turf/closed/mineral/volcanic/lava_land_surface,
/area/lavaland/surface/outdoors)
"ro" = (
/obj/structure/stone_tile{
	dir = 8
	},
/obj/item/xenoarch/useless_relic{
	name = "Ancient relic";
	desc = "Sort of relic that can be exported through Cargo."
	},
/turf/closed/mineral/volcanic/lava_land_surface,
/area/lavaland/surface/outdoors)
"rI" = (
/obj/structure/stone_tile,
/turf/open/misc/asteroid/basalt/lava_land_surface,
/area/lavaland/surface/outdoors)
"rX" = (
/obj/structure/stone_tile/block/cracked,
/turf/open/misc/asteroid/basalt/lava_land_surface,
/area/lavaland/surface/outdoors)
"sd" = (
/obj/effect/mapping_helpers/bombable_wall,
/turf/closed/indestructible/riveted/boss/wasteland,
/area/lavaland/surface/outdoors)
"ty" = (
/obj/structure/stone_tile/surrounding_tile/cracked{
	dir = 4
	},
/turf/closed/mineral/volcanic/lava_land_surface,
/area/lavaland/surface/outdoors)
"tZ" = (
/turf/template_noop,
/area/template_noop)
"uL" = (
/obj/structure/stone_tile{
	dir = 4
	},
/obj/structure/stone_tile{
	dir = 8
	},
/turf/closed/mineral/volcanic/lava_land_surface,
/area/lavaland/surface/outdoors)
"uV" = (
/obj/structure/stone_tile/surrounding/cracked{
	dir = 6
	},
/turf/closed/mineral/volcanic/lava_land_surface,
/area/lavaland/surface/outdoors)
"va" = (
/obj/structure/stone_tile/slab,
/obj/item/flashlight/flare/torch,
/turf/closed/mineral/volcanic/lava_land_surface,
/area/lavaland/surface/outdoors)
"vd" = (
/obj/structure/stone_tile/surrounding/cracked,
/turf/closed/mineral/volcanic/lava_land_surface,
/area/lavaland/surface/outdoors)
"vh" = (
/obj/structure/railing/stone,
/obj/structure/flora/rock/pile/style_random,
/turf/closed/mineral/volcanic/lava_land_surface,
/area/lavaland/surface/outdoors)
"vr" = (
/obj/structure/stone_tile{
	dir = 4
	},
/turf/closed/indestructible/riveted/boss,
/area/lavaland/surface/outdoors)
"wq" = (
/obj/structure/stone_tile,
/obj/structure/stone_tile/cracked{
	dir = 4
	},
/turf/open/misc/asteroid/basalt/lava_land_surface,
/area/lavaland/surface/outdoors)
"wB" = (
/obj/structure/stone_tile/surrounding/cracked,
/turf/open/misc/asteroid/basalt/lava_land_surface,
/area/lavaland/surface/outdoors)
"wR" = (
/obj/structure/stone_tile/surrounding/cracked,
/obj/effect/spawner/random/mob/necropolis_mob,
/turf/closed/mineral/volcanic/lava_land_surface,
/area/lavaland/surface/outdoors)
"wY" = (
/obj/structure/stone_tile/block{
	dir = 1
	},
/obj/structure/stone_tile/block/cracked,
/turf/closed/mineral/volcanic/lava_land_surface,
/area/lavaland/surface/outdoors)
"xe" = (
/obj/structure/stone_tile/slab,
/obj/item/stack/sheet/bone,
/turf/closed/mineral/volcanic/lava_land_surface,
/area/lavaland/surface/outdoors)
"xt" = (
/obj/structure/stone_tile{
	dir = 1
	},
/turf/open/misc/asteroid/basalt/lava_land_surface,
/area/lavaland/surface/outdoors)
"yH" = (
/obj/structure/flora/rock/pile/style_random,
/obj/structure/stone_tile/surrounding_tile,
/turf/closed/mineral/volcanic/lava_land_surface,
/area/lavaland/surface/outdoors)
"zN" = (
/obj/structure/stone_tile/surrounding/cracked{
	dir = 4
	},
/turf/closed/mineral/volcanic/lava_land_surface,
/area/lavaland/surface/outdoors)
"Ag" = (
/obj/structure/stone_tile{
	dir = 8
	},
/turf/open/lava/smooth/lava_land_surface,
/area/lavaland/surface/outdoors)
"AV" = (
/obj/structure/stone_tile/surrounding/cracked{
	dir = 1
	},
/obj/structure/stone_tile/center/cracked,
/turf/closed/mineral/random/high_chance/volcanic,
/area/lavaland/surface/outdoors)
"Bk" = (
/obj/structure/stone_tile{
	dir = 4
	},
/turf/open/lava/smooth/lava_land_surface,
/area/lavaland/surface/outdoors)
"BQ" = (
/obj/structure/flora/ash/cap_shroom,
/turf/closed/mineral/random/high_chance/volcanic,
/area/lavaland/surface/outdoors)
"Ce" = (
/obj/structure/stone_tile/block{
	dir = 1
	},
/obj/effect/spawner/random/mob/necropolis_mob,
/turf/open/misc/asteroid/basalt/lava_land_surface,
/area/lavaland/surface/outdoors)
"Cp" = (
/obj/structure/stone_tile,
/obj/structure/stone_tile{
	dir = 8
	},
/obj/structure/stone_tile{
	dir = 4
	},
/obj/structure/stone_tile/cracked{
	dir = 1
	},
/turf/closed/mineral/volcanic/lava_land_surface,
/area/lavaland/surface/outdoors)
"Cv" = (
/obj/structure/stone_tile/block{
	dir = 8
	},
/turf/closed/mineral/volcanic/lava_land_surface,
/area/lavaland/surface/outdoors)
"CU" = (
/obj/structure/stone_tile/block{
	dir = 4
	},
/obj/structure/stone_tile/block/burnt{
	dir = 8
	},
/turf/open/misc/asteroid/basalt/lava_land_surface,
/area/lavaland/surface/outdoors)
"Dc" = (
/obj/structure/stone_tile/block/cracked{
	dir = 4
	},
/obj/structure/stone_tile{
	dir = 8
	},
/turf/closed/mineral/volcanic/lava_land_surface,
/area/lavaland/surface/outdoors)
"Dq" = (
/obj/structure/stone_tile/slab/cracked{
	dir = 1
	},
/turf/closed/mineral/volcanic/lava_land_surface,
/area/lavaland/surface/outdoors)
"Dr" = (
/obj/structure/stone_tile,
/obj/structure/stone_tile{
	dir = 4
	},
/turf/closed/mineral/volcanic/lava_land_surface,
/area/lavaland/surface/outdoors)
"DX" = (
/obj/structure/stone_tile/block{
	dir = 1
	},
/turf/closed/mineral/random/high_chance/volcanic,
/area/lavaland/surface/outdoors)
"Ey" = (
/obj/structure/stone_tile/block/burnt{
	dir = 4
	},
/turf/closed/mineral/volcanic/lava_land_surface,
/area/lavaland/surface/outdoors)
"EO" = (
/obj/structure/stone_tile/block/cracked{
	dir = 4
	},
/turf/closed/mineral/volcanic/lava_land_surface,
/area/lavaland/surface/outdoors)
"EW" = (
/obj/structure/stone_tile/block/cracked,
/obj/item/xenoarch/useless_relic/magnified{
	name = "Ancient relic";
	desc = "Sort of relic that can be exported through Cargo."
	},
/turf/closed/mineral/random/high_chance/volcanic,
/area/lavaland/surface/outdoors)
"GS" = (
/obj/structure/stone_tile{
	dir = 8
	},
/obj/structure/stone_tile{
	dir = 1
	},
/obj/structure/stone_tile/cracked{
	dir = 4
	},
/turf/closed/mineral/volcanic/lava_land_surface,
/area/lavaland/surface/outdoors)
"HQ" = (
/obj/structure/stone_tile{
	dir = 1
	},
/obj/structure/stone_tile/burnt,
/turf/closed/mineral/random/high_chance/volcanic,
/area/lavaland/surface/outdoors)
"HX" = (
/obj/effect/spawner/random/structure/orevein_longregen,
/turf/open/misc/asteroid/basalt/lava_land_surface,
/area/lavaland/surface/outdoors)
"Jq" = (
/obj/structure/stone_tile/slab,
/turf/closed/mineral/volcanic/lava_land_surface,
/area/lavaland/surface/outdoors)
"Kv" = (
/obj/structure/stone_tile/surrounding_tile{
	dir = 8
	},
/obj/effect/spawner/random/mob/necropolis_mob,
/turf/open/misc/asteroid/basalt/lava_land_surface,
/area/lavaland/surface/outdoors)
"KR" = (
/obj/structure/stone_tile/surrounding/burnt,
/obj/structure/stone_tile/center/burnt,
/turf/closed/mineral/volcanic/lava_land_surface,
/area/lavaland/surface/outdoors)
"KV" = (
/obj/item/coin/silver{
	pixel_x = -6;
	pixel_y = -7
	},
/turf/closed/mineral/volcanic/lava_land_surface,
/area/lavaland/surface/outdoors)
"Le" = (
/obj/structure/stone_tile/surrounding_tile/cracked{
	dir = 9
	},
/obj/structure/stone_tile/surrounding_tile/cracked{
	dir = 5
	},
/turf/closed/mineral/volcanic/lava_land_surface,
/area/lavaland/surface/outdoors)
"LN" = (
/obj/structure/stone_tile{
	dir = 1
	},
/turf/closed/mineral/volcanic/lava_land_surface,
/area/lavaland/surface/outdoors)
"LQ" = (
/obj/structure/stone_tile{
	dir = 8
	},
/obj/structure/stone_tile{
	dir = 4
	},
/turf/closed/mineral/volcanic/lava_land_surface,
/area/lavaland/surface/outdoors)
"Mb" = (
/obj/structure/stone_tile/slab/cracked{
	dir = 6
	},
/turf/closed/indestructible/riveted/boss,
/area/lavaland/surface/outdoors)
"Mm" = (
/obj/structure/stone_tile/block{
	dir = 1
	},
/obj/structure/stone_tile/block,
/turf/closed/mineral/volcanic/lava_land_surface,
/area/lavaland/surface/outdoors)
"MG" = (
/obj/structure/stone_tile/slab,
/obj/structure/stone_tile/slab,
/obj/effect/spawner/random/mob/necropolis_mob,
/turf/open/misc/asteroid/basalt/lava_land_surface,
/area/lavaland/surface/outdoors)
"MX" = (
/obj/structure/flora/ash/leaf_shroom,
/turf/closed/mineral/volcanic/lava_land_surface,
/area/lavaland/surface/outdoors)
"Ng" = (
/obj/structure/stone_tile/surrounding_tile/cracked{
	dir = 8
	},
/obj/item/xenoarch/useless_relic{
	name = "Ancient relic";
	desc = "Sort of relic that can be exported through Cargo."
	},
/turf/closed/mineral/volcanic/lava_land_surface,
/area/lavaland/surface/outdoors)
"NB" = (
/obj/structure/stone_tile/slab,
/obj/effect/spawner/random/mob/necropolis_mob,
/turf/closed/mineral/volcanic/lava_land_surface,
/area/lavaland/surface/outdoors)
"NI" = (
/turf/closed/mineral/volcanic/lava_land_surface,
/area/lavaland/surface/outdoors)
"NS" = (
/turf/open/lava/smooth/lava_land_surface,
/area/lavaland/surface/outdoors)
"Oi" = (
/obj/structure/flora/rock/style_random,
/turf/closed/mineral/random/high_chance/volcanic,
/area/lavaland/surface/outdoors)
"Ol" = (
/obj/structure/stone_tile{
	dir = 1
	},
/obj/structure/stone_tile{
	dir = 4
	},
/obj/structure/stone_tile/cracked,
/turf/closed/mineral/volcanic/lava_land_surface,
/area/lavaland/surface/outdoors)
"OA" = (
/obj/structure/railing/stone/right,
/obj/effect/spawner/random/structure/spikes,
/turf/closed/mineral/volcanic/lava_land_surface,
/area/lavaland/surface/outdoors)
"OD" = (
/obj/structure/stone_tile/block/cracked{
	dir = 1
	},
/turf/closed/mineral/volcanic/lava_land_surface,
/area/lavaland/surface/outdoors)
"OH" = (
/obj/structure/stone_tile/slab/cracked{
	dir = 4
	},
/turf/closed/mineral/volcanic/lava_land_surface,
/area/lavaland/surface/outdoors)
"OL" = (
/obj/structure/stone_tile/slab/burnt,
/turf/closed/mineral/random/high_chance/volcanic,
/area/lavaland/surface/outdoors)
"OT" = (
/obj/structure/stone_tile/surrounding_tile{
	dir = 1
	},
/obj/structure/stone_tile/surrounding_tile{
	dir = 8
	},
/obj/structure/stone_tile/center/cracked,
/turf/closed/mineral/volcanic/lava_land_surface,
/area/lavaland/surface/outdoors)
"Pm" = (
/obj/structure/stone_tile/slab/burnt,
/turf/open/lava/smooth/lava_land_surface,
/area/lavaland/surface/outdoors)
"PQ" = (
/obj/structure/stone_tile/block/cracked,
/turf/closed/mineral/random/high_chance/volcanic,
/area/lavaland/surface/outdoors)
"PY" = (
/obj/structure/flora/rock/pile/style_random,
/turf/closed/mineral/volcanic/lava_land_surface,
/area/lavaland/surface/outdoors)
"Rb" = (
/turf/closed/indestructible/riveted/boss,
/area/lavaland/surface/outdoors)
"RK" = (
/obj/structure/stone_tile/block/burnt,
/obj/structure/stone_tile/block/cracked{
	dir = 1
	},
/obj/effect/spawner/random/mob/necropolis_mob,
/turf/closed/mineral/volcanic/lava_land_surface,
/area/lavaland/surface/outdoors)
"Sf" = (
/obj/structure/stone_tile/block{
	dir = 1
	},
/obj/structure/stone_tile/block,
/obj/effect/spawner/random/mob/necropolis_mob,
/turf/closed/mineral/volcanic/lava_land_surface,
/area/lavaland/surface/outdoors)
"Sg" = (
/obj/effect/spawner/random/structure/spikes,
/turf/closed/mineral/volcanic/lava_land_surface,
/area/lavaland/surface/outdoors)
"Si" = (
/obj/structure/stone_tile{
	dir = 4
	},
/obj/structure/stone_tile/surrounding_tile/burnt{
	dir = 1
	},
/turf/open/lava/smooth/lava_land_surface,
/area/lavaland/surface/outdoors)
"Su" = (
/obj/structure/railing/stone,
/obj/structure/stone_tile/burnt,
/obj/item/xenoarch/useless_relic{
	name = "Ancient relic";
	desc = "Sort of relic that can be exported through Cargo."
	},
/turf/closed/mineral/volcanic/lava_land_surface,
/area/lavaland/surface/outdoors)
"SD" = (
/obj/structure/flora/ash/tall_shroom,
/turf/closed/mineral/random/high_chance/volcanic,
/area/lavaland/surface/outdoors)
"SM" = (
/obj/structure/stone_tile/burnt,
/obj/effect/spawner/random/structure/spikes,
/turf/closed/mineral/volcanic/lava_land_surface,
/area/lavaland/surface/outdoors)
"Ug" = (
/obj/structure/stone_tile/surrounding_tile{
	dir = 8
	},
/turf/closed/mineral/volcanic/lava_land_surface,
/area/lavaland/surface/outdoors)
"Us" = (
/obj/structure/stone_tile,
/turf/open/lava/smooth/lava_land_surface,
/area/lavaland/surface/outdoors)
"UC" = (
/obj/structure/stone_tile/block/cracked{
	dir = 4
	},
/turf/open/lava/smooth/lava_land_surface,
/area/lavaland/surface/outdoors)
"UX" = (
/obj/structure/stone_tile/surrounding_tile/burnt{
	dir = 4
	},
/turf/closed/mineral/volcanic/lava_land_surface,
/area/lavaland/surface/outdoors)
"Vy" = (
/obj/structure/railing/stone/left,
/obj/effect/spawner/random/structure/spikes,
/turf/closed/mineral/volcanic/lava_land_surface,
/area/lavaland/surface/outdoors)
"VT" = (
/obj/structure/stone_tile/surrounding_tile{
	dir = 8
	},
/turf/open/lava/smooth/lava_land_surface,
/area/lavaland/surface/outdoors)
"VW" = (
/obj/structure/stone_tile/surrounding_tile{
	dir = 8
	},
/obj/structure/stone_tile/surrounding_tile{
	dir = 1
	},
/obj/structure/stone_tile/center/cracked,
/turf/open/misc/asteroid/basalt/lava_land_surface,
/area/lavaland/surface/outdoors)
"Wv" = (
/obj/structure/stone_tile{
	dir = 8
	},
/turf/open/misc/asteroid/basalt/lava_land_surface,
/area/lavaland/surface/outdoors)
"WE" = (
/obj/structure/stone_tile{
	dir = 8
	},
/turf/closed/mineral/volcanic/lava_land_surface,
/area/lavaland/surface/outdoors)
"Xh" = (
/obj/structure/stone_tile/slab/cracked{
	dir = 6
	},
/turf/open/lava/smooth/lava_land_surface,
/area/lavaland/surface/outdoors)
"Yd" = (
/obj/structure/railing/stone,
/turf/closed/mineral/volcanic/lava_land_surface,
/area/lavaland/surface/outdoors)
"Yt" = (
/obj/structure/stone_tile/slab/cracked{
	dir = 6
	},
/turf/closed/mineral/volcanic/lava_land_surface,
/area/lavaland/surface/outdoors)
"YR" = (
/obj/structure/wall_torch/mount_only,
/turf/closed/indestructible/riveted/boss,
/area/lavaland/surface/outdoors)
"Zo" = (
/obj/item/coin/silver{
	pixel_x = -8;
	pixel_y = 6
	},
/turf/closed/mineral/volcanic/lava_land_surface,
/area/lavaland/surface/outdoors)
"ZT" = (
/obj/structure/stone_tile/slab/cracked{
	dir = 4
	},
/obj/structure/stone_tile/slab/cracked{
	dir = 8
	},
/turf/closed/mineral/volcanic/lava_land_surface,
/area/lavaland/surface/outdoors)
"ZU" = (
/obj/structure/stone_tile/slab,
/obj/item/reagent_containers/cup/bowl/wood_bowl,
/turf/closed/mineral/volcanic/lava_land_surface,
/area/lavaland/surface/outdoors)
"ZY" = (
/obj/structure/railing/stone,
/obj/structure/stone_tile{
	dir = 1
	},
/turf/closed/mineral/volcanic/lava_land_surface,
/area/lavaland/surface/outdoors)

(1,1,1) = {"
NS
tZ
cU
Sg
tZ
NI
Sg
cU
PY
Sg
tZ
jW
tZ
tZ
tZ
tZ
PY
tZ
tZ
tZ
"}
(2,1,1) = {"
NS
NS
YR
LN
cU
Sg
Dr
YR
cU
bU
PY
cU
LN
YR
Sg
NI
nq
tZ
PY
YR
"}
(3,1,1) = {"
tZ
NS
nJ
Pm
UC
cw
wB
NS
wq
NB
Mm
de
OT
wY
hT
Ol
OH
vd
va
LQ
"}
(4,1,1) = {"
OD
ZT
cs
MG
CU
gY
bo
cw
bc
Pm
HX
VW
po
Sf
xe
Cp
Dq
KR
hT
Dc
"}
(5,1,1) = {"
tZ
Sg
uV
nq
rI
uL
Sg
HX
Ag
NS
ka
eh
lF
NI
PY
NI
BQ
ZU
NI
Sg
"}
(6,1,1) = {"
tZ
SM
Vy
PY
Jq
yH
cU
Le
sd
NS
NS
Rb
Ng
Zo
cU
Oi
cU
UX
Rb
Sg
"}
(7,1,1) = {"
tZ
jV
Yd
Jq
OL
Sg
ty
sd
sd
rX
NS
Rb
Rb
Ug
cU
lF
ty
Rb
Rb
hA
"}
(8,1,1) = {"
cU
hA
vh
wR
KR
cU
Rb
Mb
AV
Kv
NS
Pm
Rb
sd
Jq
xt
lC
Rb
zN
tZ
"}
(9,1,1) = {"
cU
WE
ZY
Yt
va
MX
vr
EW
DX
EO
Wv
NS
Xh
Bk
VT
Ce
Rb
ro
PY
tZ
"}
(10,1,1) = {"
tZ
cU
Su
OD
RK
Sg
Rb
PQ
SD
HQ
lF
Sg
tZ
tZ
bL
NS
Si
Us
NS
tZ
"}
(11,1,1) = {"
tZ
PY
Yd
NI
Jq
KV
Rb
Rb
Ey
bU
cU
tZ
tZ
tZ
tZ
vd
Rb
NS
NS
NS
"}
(12,1,1) = {"
tZ
tZ
OA
GS
gi
tZ
tZ
sd
tZ
tZ
Cv
tZ
tZ
tZ
tZ
Ey
sd
Cv
tZ
NS
"}
