//MAP CONVERTED BY dmm2tgm.py THIS HEADER COMMENT PREVENTS RECONVERSION, DO NOT REMOVE
"ak" = (
/obj/structure/stone_tile/surrounding_tile/cracked{
	dir = 4
	},
/obj/structure/stone_tile/surrounding_tile/burnt,
/turf/closed/mineral/volcanic/lava_land_surface,
/area/lavaland/surface/outdoors)
"ao" = (
/obj/structure/stone_tile/slab,
/obj/item/xenoarch/useless_relic{
	name = "Ancient relic";
	desc = "Sort of relic that can be exported through Cargo."
	},
/turf/closed/mineral/volcanic/lava_land_surface,
/area/lavaland/surface/outdoors)
"ap" = (
/obj/structure/stone_tile/slab/cracked,
/obj/effect/spawner/random/mob/necropolis_mob,
/turf/closed/mineral/volcanic/lava_land_surface,
/area/lavaland/surface/outdoors)
"bH" = (
/obj/structure/stone_tile/surrounding_tile,
/obj/structure/stone_tile/surrounding_tile{
	dir = 4
	},
/obj/effect/spawner/random/mob/goliath,
/turf/open/misc/asteroid/basalt/lava_land_surface,
/area/ruin/unpowered)
"cA" = (
/obj/structure/stone_tile/block{
	dir = 8
	},
/obj/structure/stone_tile/block/burnt{
	dir = 4
	},
/turf/open/misc/asteroid/basalt/lava_land_surface,
/area/ruin/unpowered)
"dI" = (
/obj/item/stack/sheet/animalhide/goliath_hide,
/turf/open/misc/asteroid/basalt/lava_land_surface,
/area/ruin/unpowered)
"dP" = (
/obj/structure/stone_tile{
	dir = 8
	},
/obj/structure/stone_tile{
	dir = 1
	},
/obj/structure/stone_tile/cracked{
	dir = 4
	},
/obj/effect/mob_spawn/corpse/human/miner,
/turf/open/misc/asteroid/basalt/lava_land_surface,
/area/ruin/unpowered)
"dT" = (
/obj/structure/stone_tile/slab/burnt,
/obj/effect/spawner/random/mob/goliath,
/turf/closed/mineral/volcanic/lava_land_surface,
/area/lavaland/surface/outdoors)
"ge" = (
/obj/structure/stone_tile/block/burnt{
	dir = 8
	},
/obj/effect/spawner/random/mob/goliath,
/turf/closed/mineral/volcanic/lava_land_surface,
/area/ruin/unpowered)
"gp" = (
/obj/structure/stone_tile{
	dir = 1
	},
/obj/structure/stone_tile{
	dir = 4
	},
/turf/closed/mineral/random/high_chance/volcanic,
/area/ruin/unpowered)
"gZ" = (
/obj/structure/stone_tile/surrounding/cracked{
	dir = 6
	},
/turf/closed/mineral/volcanic/lava_land_surface,
/area/lavaland/surface/outdoors)
"hr" = (
/turf/open/misc/asteroid/basalt/lava_land_surface,
/area/ruin/unpowered)
"hC" = (
/obj/structure/stone_tile/block/cracked{
	dir = 8
	},
/obj/effect/decal/cleanable/blood/tracks{
	desc = "Your instincts say you shouldn't be following these.";
	icon_state = "ltrails_1";
	dir = 2
	},
/turf/open/misc/asteroid/basalt/lava_land_surface,
/area/ruin/unpowered)
"hF" = (
/obj/structure/stone_tile/surrounding/burnt,
/obj/structure/stone_tile/center/burnt,
/obj/effect/decal/cleanable/blood/old,
/obj/effect/spawner/random/mob/goliath,
/turf/open/misc/asteroid/basalt/lava_land_surface,
/area/ruin/unpowered)
"hP" = (
/obj/structure/stone_tile{
	dir = 8
	},
/obj/structure/stone_tile{
	dir = 1
	},
/obj/structure/stone_tile/burnt,
/turf/open/misc/asteroid/basalt/lava_land_surface,
/area/ruin/unpowered)
"hZ" = (
/obj/structure/stone_tile/block,
/obj/effect/decal/cleanable/blood/old,
/obj/effect/spawner/random/mob/goliath,
/turf/open/misc/asteroid/basalt/lava_land_surface,
/area/ruin/unpowered)
"ib" = (
/obj/structure/stone_tile/surrounding_tile{
	dir = 4
	},
/obj/structure/stone_tile/center/burnt,
/turf/open/misc/asteroid/basalt/lava_land_surface,
/area/ruin/unpowered)
"ig" = (
/obj/structure/stone_tile/surrounding_tile/burnt{
	dir = 1
	},
/obj/structure/stone_tile/surrounding_tile/burnt{
	dir = 8
	},
/obj/structure/stone_tile/center/cracked,
/turf/closed/mineral/volcanic/lava_land_surface,
/area/lavaland/surface/outdoors)
"iM" = (
/obj/structure/stone_tile/surrounding_tile{
	dir = 8
	},
/obj/structure/stone_tile/surrounding_tile/cracked{
	dir = 1
	},
/turf/closed/mineral/volcanic/lava_land_surface,
/area/lavaland/surface/outdoors)
"iT" = (
/obj/structure/stone_tile/slab,
/obj/item/ceramic/cup{
	pixel_x = -6;
	pixel_y = -6
	},
/turf/closed/mineral/volcanic/lava_land_surface,
/area/ruin/unpowered)
"iV" = (
/obj/structure/stone_tile/cracked{
	dir = 4
	},
/obj/effect/decal/cleanable/blood/tracks{
	desc = "Your instincts say you shouldn't be following these.";
	dir = 8;
	icon_state = "ltrails_1"
	},
/obj/effect/spawner/random/mob/goliath,
/turf/open/misc/asteroid/basalt/lava_land_surface,
/area/ruin/unpowered)
"iY" = (
/obj/effect/spawner/random/mob/goliath,
/turf/closed/mineral/volcanic/lava_land_surface,
/area/lavaland/surface/outdoors)
"jg" = (
/obj/structure/flora/rock/style_random,
/obj/effect/spawner/random/mob/goliath,
/turf/closed/mineral/volcanic/lava_land_surface,
/area/ruin/unpowered)
"jE" = (
/obj/structure/stone_tile/slab/cracked{
	dir = 6
	},
/turf/open/misc/asteroid/basalt/lava_land_surface,
/area/ruin/unpowered)
"jU" = (
/obj/structure/flora/rock/style_random,
/turf/closed/mineral/random/high_chance/volcanic,
/area/ruin/unpowered)
"kV" = (
/obj/item/shield/goliath,
/obj/effect/decal/cleanable/blood/tracks{
	desc = "Your instincts say you shouldn't be following these.";
	icon_state = "ltrails_1";
	dir = 10
	},
/turf/open/misc/asteroid/basalt/lava_land_surface,
/area/ruin/unpowered)
"kW" = (
/obj/structure/stone_tile/surrounding_tile/cracked,
/obj/structure/stone_tile/surrounding_tile/burnt{
	dir = 4
	},
/turf/closed/mineral/volcanic/lava_land_surface,
/area/lavaland/surface/outdoors)
"lW" = (
/obj/structure/stone_tile/block,
/obj/effect/spawner/random/structure/spikes,
/turf/closed/mineral/volcanic/lava_land_surface,
/area/lavaland/surface/outdoors)
"ma" = (
/obj/effect/spawner/random/structure/spikes,
/turf/closed/mineral/random/high_chance/volcanic,
/area/ruin/unpowered)
"mq" = (
/obj/structure/stone_tile/cracked{
	dir = 8
	},
/turf/closed/mineral/strong{
	base_icon_state = "smoothrocks";
	icon = 'modular_nova/modules/liquids/icons/turf/smoothrocks.dmi';
	icon_state = "smoothrocks-55"
	},
/area/lavaland/surface/outdoors)
"mv" = (
/obj/structure/stone_tile/surrounding_tile{
	dir = 4
	},
/obj/structure/stone_tile/surrounding_tile,
/turf/closed/mineral/volcanic/lava_land_surface,
/area/ruin/unpowered)
"ne" = (
/obj/structure/stone_tile/slab,
/turf/closed/mineral/volcanic/lava_land_surface,
/area/lavaland/surface/outdoors)
"ng" = (
/turf/closed/mineral/random/high_chance/volcanic,
/area/ruin/unpowered)
"nk" = (
/obj/structure/stone_tile,
/obj/structure/stone_tile{
	dir = 8
	},
/obj/structure/stone_tile{
	dir = 1
	},
/obj/structure/stone_tile{
	dir = 4
	},
/turf/closed/mineral/random/high_chance/volcanic,
/area/ruin/unpowered)
"nM" = (
/obj/structure/stone_tile/surrounding/cracked{
	dir = 1
	},
/turf/closed/mineral/volcanic/lava_land_surface,
/area/lavaland/surface/outdoors)
"nO" = (
/obj/structure/flora/rock/pile/style_random,
/turf/open/misc/asteroid/basalt/lava_land_surface,
/area/ruin/unpowered)
"nR" = (
/obj/structure/stone_tile/block{
	dir = 8
	},
/turf/closed/mineral/random/high_chance/volcanic,
/area/ruin/unpowered)
"nX" = (
/obj/structure/stone_tile/surrounding_tile{
	dir = 4
	},
/obj/effect/spawner/random/mob/goliath,
/turf/closed/mineral/volcanic/lava_land_surface,
/area/lavaland/surface/outdoors)
"oa" = (
/obj/structure/stone_tile/block{
	dir = 4
	},
/obj/structure/stone_tile/block{
	dir = 8
	},
/turf/open/misc/asteroid/basalt/lava_land_surface,
/area/ruin/unpowered)
"ox" = (
/obj/effect/decal/cleanable/blood/tracks{
	desc = "Your instincts say you shouldn't be following these.";
	dir = 8;
	icon_state = "ltrails_1"
	},
/obj/effect/spawner/random/mob/goliath,
/turf/open/misc/asteroid/basalt/lava_land_surface,
/area/ruin/unpowered)
"pe" = (
/obj/effect/decal/cleanable/blood/old{
	icon_state = "floor4-old";
	pixel_y = 10;
	pixel_x = 5
	},
/turf/open/misc/asteroid/basalt/lava_land_surface,
/area/ruin/unpowered)
"ph" = (
/turf/closed/mineral/volcanic/lava_land_surface,
/area/lavaland/surface/outdoors)
"pN" = (
/obj/structure/stone_tile/slab,
/turf/open/misc/asteroid/basalt/lava_land_surface,
/area/ruin/unpowered)
"qo" = (
/obj/structure/stone_tile/block,
/turf/closed/mineral/volcanic/lava_land_surface,
/area/lavaland/surface/outdoors)
"rg" = (
/obj/structure/stone_tile/slab/cracked,
/turf/closed/mineral/volcanic/lava_land_surface,
/area/lavaland/surface/outdoors)
"rm" = (
/obj/structure/stone_tile/surrounding/cracked,
/obj/structure/stone_tile/center/cracked,
/turf/closed/mineral/volcanic/lava_land_surface,
/area/lavaland/surface/outdoors)
"rN" = (
/obj/structure/flora/rock/pile/style_random,
/turf/closed/mineral/volcanic/lava_land_surface,
/area/ruin/unpowered)
"rX" = (
/obj/structure/stone_tile/surrounding/cracked{
	dir = 1
	},
/obj/effect/spawner/random/mob/goliath,
/turf/closed/mineral/volcanic/lava_land_surface,
/area/lavaland/surface/outdoors)
"sB" = (
/obj/structure/stone_tile/block{
	dir = 1
	},
/obj/structure/stone_tile/block/cracked,
/turf/closed/mineral/random/high_chance/volcanic,
/area/ruin/unpowered)
"sM" = (
/obj/structure/stone_tile/surrounding,
/obj/structure/stone_tile/center/cracked,
/turf/closed/mineral/random/high_chance/volcanic,
/area/ruin/unpowered)
"td" = (
/obj/structure/stone_tile/surrounding_tile{
	dir = 8
	},
/obj/structure/stone_tile/center/burnt,
/turf/closed/mineral/random/high_chance/volcanic,
/area/ruin/unpowered)
"uB" = (
/obj/structure/stone_tile/block{
	dir = 8
	},
/obj/effect/mob_spawn/corpse/watcher/goliath_chewed,
/obj/effect/decal/cleanable/blood/old,
/turf/open/misc/asteroid/basalt/lava_land_surface,
/area/ruin/unpowered)
"uQ" = (
/obj/structure/stone_tile{
	dir = 1
	},
/obj/structure/stone_tile,
/obj/structure/stone_tile{
	dir = 8
	},
/turf/closed/mineral/volcanic/lava_land_surface,
/area/lavaland/surface/outdoors)
"vg" = (
/obj/structure/stone_tile/slab/cracked,
/obj/item/xenoarch/useless_relic{
	name = "Ancient relic";
	desc = "Sort of relic that can be exported through Cargo."
	},
/turf/closed/mineral/volcanic/lava_land_surface,
/area/lavaland/surface/outdoors)
"vo" = (
/obj/structure/stone_tile/slab/cracked{
	dir = 6
	},
/turf/closed/mineral/volcanic/lava_land_surface,
/area/ruin/unpowered)
"vy" = (
/obj/structure/stone_tile/cracked,
/obj/effect/spawner/random/structure/spikes,
/turf/closed/mineral/volcanic/lava_land_surface,
/area/lavaland/surface/outdoors)
"vA" = (
/obj/structure/stone_tile/slab/burnt,
/turf/closed/mineral/volcanic/lava_land_surface,
/area/lavaland/surface/outdoors)
"wd" = (
/turf/template_noop,
/area/template_noop)
"wB" = (
/obj/structure/stone_tile/block/cracked{
	pixel_y = -16
	},
/obj/structure/stone_tile,
/obj/structure/stone_tile/cracked{
	dir = 8
	},
/obj/effect/spawner/random/mob/necropolis_mob,
/turf/closed/mineral/volcanic/lava_land_surface,
/area/lavaland/surface/outdoors)
"wO" = (
/obj/structure/stone_tile/surrounding_tile/burnt{
	dir = 1
	},
/obj/effect/spawner/random/mob/necropolis_mob,
/turf/closed/mineral/volcanic/lava_land_surface,
/area/lavaland/surface/outdoors)
"xd" = (
/obj/structure/stone_tile/block/cracked{
	dir = 1
	},
/obj/structure/stone_tile{
	dir = 8
	},
/obj/effect/spawner/random/mob/goliath,
/turf/closed/mineral/volcanic/lava_land_surface,
/area/lavaland/surface/outdoors)
"xG" = (
/obj/structure/stone_tile/surrounding_tile,
/turf/open/misc/asteroid/basalt/lava_land_surface,
/area/ruin/unpowered)
"xK" = (
/obj/structure/stone_tile/block/cracked{
	dir = 4
	},
/turf/closed/mineral/volcanic/lava_land_surface,
/area/lavaland/surface/outdoors)
"zf" = (
/obj/structure/stone_tile{
	dir = 1
	},
/obj/effect/spawner/random/mob/necropolis_mob,
/turf/closed/mineral/volcanic/lava_land_surface,
/area/lavaland/surface/outdoors)
"zP" = (
/obj/structure/stone_tile/surrounding_tile{
	dir = 8
	},
/obj/item/stack/sheet/animalhide/goliath_hide,
/turf/open/misc/asteroid/basalt/lava_land_surface,
/area/ruin/unpowered)
"Ag" = (
/obj/structure/stone_tile/block/burnt,
/obj/effect/spawner/random/structure/spikes,
/turf/closed/mineral/volcanic/lava_land_surface,
/area/ruin/unpowered)
"Ah" = (
/obj/structure/stone_tile/block,
/obj/structure/stone_tile/block/cracked{
	dir = 1
	},
/turf/open/misc/asteroid/basalt/lava_land_surface,
/area/ruin/unpowered)
"AG" = (
/obj/structure/stone_tile/block/cracked{
	dir = 1
	},
/turf/closed/mineral/strong{
	base_icon_state = "smoothrocks";
	icon = 'modular_nova/modules/liquids/icons/turf/smoothrocks.dmi';
	icon_state = "smoothrocks-55"
	},
/area/lavaland/surface/outdoors)
"AK" = (
/obj/effect/spawner/random/structure/spikes,
/turf/closed/mineral/volcanic/lava_land_surface,
/area/lavaland/surface/outdoors)
"AW" = (
/obj/structure/stone_tile/block/burnt,
/turf/closed/mineral/volcanic/lava_land_surface,
/area/lavaland/surface/outdoors)
"Bf" = (
/obj/structure/stone_tile/cracked{
	dir = 1
	},
/turf/closed/mineral/volcanic/lava_land_surface,
/area/lavaland/surface/outdoors)
"Bi" = (
/turf/closed/mineral/volcanic/lava_land_surface,
/area/ruin/unpowered)
"Bn" = (
/obj/effect/spawner/random/mob/necropolis_mob,
/turf/closed/mineral/volcanic/lava_land_surface,
/area/lavaland/surface/outdoors)
"BL" = (
/obj/structure/stone_tile/slab/cracked{
	dir = 6
	},
/obj/item/xenoarch/useless_relic/magnified{
	name = "Ancient relic";
	desc = "Sort of relic that can be exported through Cargo."
	},
/turf/closed/mineral/volcanic/lava_land_surface,
/area/ruin/unpowered)
"BN" = (
/obj/structure/stone_tile{
	dir = 8
	},
/obj/structure/stone_tile{
	dir = 1
	},
/obj/structure/stone_tile{
	dir = 4
	},
/turf/closed/mineral/random/high_chance/volcanic,
/area/ruin/unpowered)
"BR" = (
/obj/structure/stone_tile/surrounding_tile{
	dir = 1
	},
/obj/structure/stone_tile/surrounding_tile{
	dir = 8
	},
/turf/closed/mineral/volcanic/lava_land_surface,
/area/ruin/unpowered)
"BS" = (
/obj/structure/stone_tile/slab/cracked{
	dir = 10
	},
/obj/structure/flora/rock/pile/style_random,
/obj/effect/decal/cleanable/blood,
/obj/item/knife/hunting,
/obj/effect/spawner/random/mob/goliath,
/turf/open/misc/asteroid/basalt/lava_land_surface,
/area/ruin/unpowered)
"BT" = (
/obj/structure/stone_tile/block/cracked{
	dir = 8
	},
/turf/closed/mineral/volcanic/lava_land_surface,
/area/lavaland/surface/outdoors)
"Cg" = (
/obj/structure/stone_tile/surrounding_tile,
/obj/effect/spawner/random/structure/spikes,
/turf/closed/mineral/volcanic/lava_land_surface,
/area/lavaland/surface/outdoors)
"Ci" = (
/obj/structure/flora/ash/cacti,
/turf/closed/mineral/volcanic/lava_land_surface,
/area/lavaland/surface/outdoors)
"DA" = (
/obj/structure/flora/ash/cacti,
/turf/closed/mineral/volcanic/lava_land_surface,
/area/ruin/unpowered)
"DE" = (
/obj/item/xenoarch/useless_relic/magnified{
	name = "Ancient relic";
	desc = "Sort of relic that can be exported through Cargo."
	},
/turf/closed/mineral/random/high_chance/volcanic,
/area/ruin/unpowered)
"DL" = (
/obj/structure/stone_tile/surrounding,
/turf/closed/mineral/volcanic/lava_land_surface,
/area/lavaland/surface/outdoors)
"DW" = (
/obj/structure/stone_tile/slab/cracked{
	dir = 8
	},
/turf/closed/mineral/volcanic/lava_land_surface,
/area/lavaland/surface/outdoors)
"Ee" = (
/obj/structure/stone_tile/block/cracked,
/obj/structure/stone_tile/block/burnt{
	dir = 1
	},
/turf/closed/indestructible/riveted/boss,
/area/lavaland/surface/outdoors)
"Ei" = (
/obj/structure/stone_tile/surrounding_tile{
	dir = 1
	},
/obj/structure/stone_tile/surrounding_tile{
	dir = 8
	},
/obj/structure/closet/crate/necropolis/tendril,
/turf/closed/mineral/volcanic/lava_land_surface,
/area/ruin/unpowered)
"Er" = (
/obj/structure/stone_tile/surrounding/burnt,
/turf/closed/mineral/volcanic/lava_land_surface,
/area/lavaland/surface/outdoors)
"EZ" = (
/obj/structure/stone_tile/slab,
/turf/closed/mineral/volcanic/lava_land_surface,
/area/ruin/unpowered)
"Fj" = (
/obj/structure/flora/rock/pile/style_random,
/mob/living/basic/mining/brimdemon,
/obj/item/xenoarch/useless_relic{
	name = "Ancient relic";
	desc = "Sort of relic that can be exported through Cargo."
	},
/turf/closed/mineral/volcanic/lava_land_surface,
/area/lavaland/surface/outdoors)
"Fp" = (
/obj/effect/spawner/random/mob/goliath,
/turf/open/misc/asteroid/basalt/lava_land_surface,
/area/ruin/unpowered)
"FP" = (
/obj/structure/stone_tile/surrounding/cracked{
	dir = 6
	},
/obj/item/stack/sheet/animalhide/goliath_hide,
/obj/item/seeds/wheat/meat,
/obj/item/seeds/wheat/meat,
/obj/item/seeds/wheat/meat,
/mob/living/basic/mining/goliath/ancient/immortal/broodmother,
/turf/open/misc/asteroid/basalt/lava_land_surface,
/area/ruin/unpowered)
"FW" = (
/obj/effect/decal/cleanable/blood/tracks{
	desc = "Your instincts say you shouldn't be following these.";
	icon_state = "ltrails_1";
	dir = 5
	},
/obj/effect/spawner/random/mob/goliath,
/turf/open/misc/asteroid/basalt/lava_land_surface,
/area/ruin/unpowered)
"Hb" = (
/obj/structure/stone_tile/surrounding,
/obj/structure/stone_tile/center,
/turf/closed/mineral/volcanic/lava_land_surface,
/area/ruin/unpowered)
"Hk" = (
/obj/structure/stone_tile/block,
/obj/structure/stone_tile{
	dir = 1
	},
/obj/effect/spawner/random/mob/necropolis_mob,
/turf/closed/mineral/volcanic/lava_land_surface,
/area/lavaland/surface/outdoors)
"HF" = (
/obj/structure/stone_tile/block/burnt{
	dir = 4
	},
/turf/closed/mineral/volcanic/lava_land_surface,
/area/lavaland/surface/outdoors)
"Ji" = (
/obj/structure/flora/rock/pile/style_random,
/turf/closed/mineral/volcanic/lava_land_surface,
/area/lavaland/surface/outdoors)
"JF" = (
/obj/structure/stone_tile,
/obj/structure/stone_tile{
	dir = 1
	},
/obj/structure/stone_tile/burnt{
	dir = 4
	},
/turf/closed/mineral/volcanic/lava_land_surface,
/area/lavaland/surface/outdoors)
"Ke" = (
/obj/structure/stone_tile/block,
/obj/structure/stone_tile/block/cracked{
	dir = 1
	},
/turf/closed/indestructible/riveted/boss,
/area/lavaland/surface/outdoors)
"KA" = (
/obj/structure/stone_tile/cracked{
	dir = 4
	},
/obj/effect/spawner/random/mob/goliath,
/turf/closed/mineral/volcanic/lava_land_surface,
/area/lavaland/surface/outdoors)
"KF" = (
/obj/effect/decal/cleanable/blood/old{
	icon_state = "floor4-old"
	},
/turf/open/misc/asteroid/basalt/lava_land_surface,
/area/ruin/unpowered)
"KT" = (
/obj/structure/stone_tile/slab/cracked{
	dir = 4
	},
/obj/effect/decal/cleanable/blood/old{
	icon_state = "floor4-old";
	pixel_y = 10;
	pixel_x = 5
	},
/turf/open/misc/asteroid/basalt/lava_land_surface,
/area/ruin/unpowered)
"KU" = (
/obj/structure/stone_tile/surrounding_tile/cracked{
	dir = 1
	},
/obj/structure/stone_tile/surrounding_tile,
/obj/structure/stone_tile/surrounding_tile{
	dir = 4
	},
/obj/structure/stone_tile/surrounding_tile{
	dir = 8
	},
/obj/structure/stone_tile/center/cracked,
/turf/closed/mineral/volcanic/lava_land_surface,
/area/lavaland/surface/outdoors)
"LE" = (
/obj/structure/stone_tile/surrounding/cracked{
	dir = 1
	},
/obj/structure/stone_tile/surrounding/cracked,
/turf/closed/mineral/volcanic/lava_land_surface,
/area/lavaland/surface/outdoors)
"LY" = (
/obj/effect/mapping_helpers/bombable_wall,
/turf/closed/indestructible/riveted/boss/wasteland,
/area/ruin/unpowered)
"LZ" = (
/obj/structure/stone_tile/block{
	dir = 1
	},
/obj/structure/stone_tile/block,
/turf/open/misc/asteroid/basalt/lava_land_surface,
/area/ruin/unpowered)
"Mp" = (
/obj/effect/decal/cleanable/blood/old,
/turf/open/misc/asteroid/basalt/lava_land_surface,
/area/ruin/unpowered)
"Mw" = (
/obj/structure/stone_tile/block/cracked{
	dir = 1
	},
/obj/structure/stone_tile/block,
/obj/item/flashlight/flare/torch,
/turf/open/misc/asteroid/basalt/lava_land_surface,
/area/lavaland/surface/outdoors)
"OE" = (
/obj/structure/stone_tile/block{
	dir = 8
	},
/obj/structure/stone_tile/block/cracked{
	dir = 4
	},
/obj/effect/spawner/random/mob/necropolis_mob,
/turf/closed/mineral/volcanic/lava_land_surface,
/area/lavaland/surface/outdoors)
"Pm" = (
/obj/structure/stone_tile/slab/cracked,
/turf/closed/mineral/random/high_chance/volcanic,
/area/ruin/unpowered)
"PM" = (
/turf/closed/indestructible/riveted/boss,
/area/ruin/unpowered)
"PX" = (
/obj/structure/stone_tile,
/obj/structure/stone_tile{
	dir = 8
	},
/obj/structure/stone_tile/cracked{
	dir = 4
	},
/turf/closed/mineral/volcanic/lava_land_surface,
/area/lavaland/surface/outdoors)
"QM" = (
/obj/effect/spawner/random/mob/goliath,
/turf/closed/mineral/random/high_chance/volcanic,
/area/ruin/unpowered)
"QQ" = (
/obj/structure/stone_tile/block/cracked{
	dir = 1
	},
/obj/structure/stone_tile{
	dir = 8
	},
/turf/closed/mineral/volcanic/lava_land_surface,
/area/lavaland/surface/outdoors)
"QZ" = (
/obj/structure/wall_torch/mount_only,
/turf/closed/indestructible/riveted/boss,
/area/ruin/unpowered)
"Re" = (
/obj/effect/decal/cleanable/blood/tracks{
	desc = "Your instincts say you shouldn't be following these.";
	icon_state = "ltrails_1";
	dir = 4
	},
/turf/open/misc/asteroid/basalt/lava_land_surface,
/area/ruin/unpowered)
"Sc" = (
/obj/structure/stone_tile/slab/burnt,
/obj/effect/spawner/random/mob/necropolis_mob,
/turf/closed/mineral/volcanic/lava_land_surface,
/area/lavaland/surface/outdoors)
"Ts" = (
/obj/structure/flora/rock/pile/style_random,
/obj/effect/spawner/random/structure/spikes,
/turf/open/misc/asteroid/basalt/lava_land_surface,
/area/lavaland/surface/outdoors)
"TU" = (
/obj/structure/stone_tile/slab/cracked,
/turf/open/misc/asteroid/basalt/lava_land_surface,
/area/ruin/unpowered)
"UB" = (
/obj/structure/stone_tile/slab/burnt,
/turf/open/misc/asteroid/basalt/lava_land_surface,
/area/ruin/unpowered)
"UP" = (
/obj/structure/stone_tile/cracked{
	dir = 4
	},
/turf/closed/mineral/volcanic/lava_land_surface,
/area/lavaland/surface/outdoors)
"UZ" = (
/obj/item/stack/sheet/animalhide/goliath_hide,
/obj/effect/spawner/random/mob/goliath,
/turf/open/misc/asteroid/basalt/lava_land_surface,
/area/ruin/unpowered)
"Vl" = (
/obj/structure/stone_tile/block/burnt{
	dir = 4
	},
/turf/closed/mineral/strong{
	base_icon_state = "smoothrocks";
	icon = 'modular_nova/modules/liquids/icons/turf/smoothrocks.dmi';
	icon_state = "smoothrocks-55"
	},
/area/lavaland/surface/outdoors)
"VE" = (
/obj/structure/stone_tile/block/cracked,
/turf/open/misc/asteroid/basalt/lava_land_surface,
/area/lavaland/surface/outdoors)
"WN" = (
/obj/structure/stone_tile,
/obj/structure/stone_tile{
	dir = 1
	},
/obj/structure/stone_tile/cracked{
	dir = 4
	},
/turf/open/misc/asteroid/basalt/lava_land_surface,
/area/ruin/unpowered)
"Xu" = (
/obj/structure/stone_tile/slab/burnt,
/turf/closed/mineral/random/high_chance/volcanic,
/area/ruin/unpowered)
"Xv" = (
/turf/closed/indestructible/riveted/boss,
/area/lavaland/surface/outdoors)
"XB" = (
/obj/structure/stone_tile/surrounding/cracked,
/obj/structure/stone_tile/center/burnt,
/turf/closed/mineral/strong{
	base_icon_state = "smoothrocks";
	icon = 'modular_nova/modules/liquids/icons/turf/smoothrocks.dmi';
	icon_state = "smoothrocks-55"
	},
/area/lavaland/surface/outdoors)
"XF" = (
/obj/structure/stone_tile/block/burnt,
/obj/structure/stone_tile/burnt{
	dir = 4
	},
/obj/structure/stone_tile/cracked{
	dir = 1
	},
/turf/closed/mineral/strong{
	base_icon_state = "smoothrocks";
	icon = 'modular_nova/modules/liquids/icons/turf/smoothrocks.dmi';
	icon_state = "smoothrocks-55"
	},
/area/lavaland/surface/outdoors)
"Yv" = (
/obj/structure/stone_tile/surrounding/cracked,
/obj/structure/stone_tile/center/burnt,
/turf/closed/mineral/volcanic/lava_land_surface,
/area/lavaland/surface/outdoors)
"Yy" = (
/obj/structure/stone_tile,
/obj/structure/stone_tile{
	dir = 8
	},
/turf/closed/mineral/random/high_chance/volcanic,
/area/ruin/unpowered)
"YE" = (
/obj/structure/stone_tile{
	dir = 1
	},
/obj/structure/stone_tile/block,
/turf/closed/mineral/volcanic/lava_land_surface,
/area/lavaland/surface/outdoors)
"Zt" = (
/obj/structure/stone_tile,
/obj/structure/stone_tile{
	dir = 8
	},
/turf/open/misc/asteroid/basalt/lava_land_surface,
/area/ruin/unpowered)
"Zz" = (
/obj/structure/stone_tile/cracked{
	dir = 8
	},
/obj/effect/spawner/random/structure/spikes,
/turf/closed/mineral/volcanic/lava_land_surface,
/area/lavaland/surface/outdoors)
"ZE" = (
/obj/structure/stone_tile/cracked,
/obj/effect/decal/cleanable/blood/old{
	icon_state = "floor4-old";
	pixel_y = 10;
	pixel_x = 5
	},
/turf/open/misc/asteroid/basalt/lava_land_surface,
/area/ruin/unpowered)

(1,1,1) = {"
wd
wd
wd
Ts
Bf
vy
BT
wd
xK
Ji
xK
wd
"}
(2,1,1) = {"
wd
wd
Bn
VE
AK
DW
AK
Zz
Ci
Zz
wd
wd
"}
(3,1,1) = {"
wd
ph
XB
Mw
XF
vA
gZ
Hk
qo
Xv
lW
wd
"}
(4,1,1) = {"
wd
Er
PM
TU
PM
ao
DL
QQ
ph
Xv
AK
wd
"}
(5,1,1) = {"
wd
rX
QZ
BS
PM
PM
AG
YE
Xv
Xv
ph
wd
"}
(6,1,1) = {"
wd
uQ
PM
iV
PM
nR
mq
AK
Ji
xd
zf
wd
"}
(7,1,1) = {"
wd
Cg
Vl
FW
hC
kV
PM
AK
AK
KA
qo
wd
"}
(8,1,1) = {"
wd
Ji
PM
ma
ma
ox
PM
PM
PM
PM
wd
wd
"}
(9,1,1) = {"
wd
AK
PM
jg
hZ
Re
Xu
PM
BL
PM
wd
wd
"}
(10,1,1) = {"
wd
nX
PM
EZ
Zt
dP
nk
DA
gp
PM
AK
wd
"}
(11,1,1) = {"
wd
Yv
PM
PM
mv
pN
KT
zP
ma
PM
Ji
ph
"}
(12,1,1) = {"
rm
rg
Fj
PM
sM
oa
ge
hF
ng
LY
LY
ph
"}
(13,1,1) = {"
LE
wB
PM
PM
sB
bH
td
Ah
vo
Fp
LY
Bn
"}
(14,1,1) = {"
ne
KU
PM
iT
Ag
Mp
ib
LZ
nO
pe
LY
ph
"}
(15,1,1) = {"
ap
AK
PM
Ei
FP
cA
uB
Hb
Bi
Fp
PM
iY
"}
(16,1,1) = {"
wd
PX
PM
PM
BR
pN
TU
xG
KF
dI
PM
Ji
"}
(17,1,1) = {"
wd
AK
PM
rN
Yy
BN
WN
Pm
hP
ng
LY
AK
"}
(18,1,1) = {"
wd
dT
PM
Bi
Fp
ZE
UB
jU
jE
DE
PM
ph
"}
(19,1,1) = {"
wd
AK
PM
Bi
ng
Bi
UZ
nO
hr
QM
PM
ph
"}
(20,1,1) = {"
wd
DL
PM
PM
LY
PM
ng
KF
Bi
Bi
PM
ph
"}
(21,1,1) = {"
wd
AK
ph
Xv
AK
PM
PM
LY
LY
PM
PM
iY
"}
(22,1,1) = {"
wd
wd
nX
ne
UP
vg
Ee
ak
iM
Xv
AK
wd
"}
(23,1,1) = {"
wd
wd
wd
Sc
JF
vA
Ke
ig
kW
AW
AK
wd
"}
(24,1,1) = {"
wd
wd
wd
wd
wd
wO
nM
HF
OE
gZ
wd
wd
"}
