//MAP CONVERTED BY dmm2tgm.py THIS HEADER COMMENT PREVENTS RECONVERSION, DO NOT REMOVE
"a" = (
/turf/closed/indestructible/riveted/boss/wasteland,
/area/lavaland/surface/outdoors)
"b" = (
/obj/effect/spawner/random/structure/spikes,
/turf/closed/mineral/volcanic/lava_land_surface,
/area/lavaland/surface/outdoors)
"c" = (
/mob/living/basic/mining/watcher,
/obj/effect/decal/cleanable/blood/splatter,
/turf/open/misc/asteroid/basalt/lava_land_surface,
/area/ruin/unpowered)
"d" = (
/obj/structure/stone_tile/surrounding/cracked,
/obj/structure/stone_tile/center/cracked,
/turf/open/misc/asteroid/basalt/lava_land_surface,
/area/ruin/unpowered)
"e" = (
/obj/item/food/egg/watcher,
/turf/open/misc/asteroid/basalt/wasteland/basin,
/area/ruin/unpowered)
"f" = (
/obj/structure/stone_tile/surrounding_tile{
	dir = 1
	},
/obj/effect/decal/cleanable/blood/old,
/turf/open/misc/asteroid/basalt/wasteland,
/area/ruin/unpowered)
"g" = (
/obj/structure/stone_tile/block{
	dir = 1
	},
/turf/closed/mineral/random/high_chance/volcanic,
/area/lavaland/surface/outdoors)
"h" = (
/obj/structure/stone_tile/block/cracked,
/obj/structure/stone_tile{
	dir = 4
	},
/obj/effect/spawner/random/mob/necropolis_mob,
/turf/closed/mineral/random/high_chance/volcanic,
/area/lavaland/surface/outdoors)
"i" = (
/obj/effect/decal/cleanable/blood/gibs/bubblegum,
/turf/open/misc/asteroid/basalt/lava_land_surface,
/area/ruin/unpowered)
"j" = (
/turf/closed/mineral/random/high_chance/volcanic,
/area/ruin/unpowered)
"k" = (
/obj/structure/stone_tile{
	dir = 1
	},
/obj/effect/spawner/random/mob/necropolis_mob,
/turf/closed/mineral/volcanic/lava_land_surface,
/area/lavaland/surface/outdoors)
"l" = (
/obj/structure/stone_tile/cracked{
	pixel_x = 16
	},
/turf/open/misc/asteroid/basalt/lava_land_surface,
/area/ruin/unpowered)
"m" = (
/turf/open/misc/asteroid/basalt/lava_land_surface,
/area/ruin/unpowered)
"n" = (
/mob/living/basic/mining/watcher,
/turf/open/misc/asteroid/basalt/lava_land_surface,
/area/ruin/unpowered)
"o" = (
/turf/closed/indestructible/riveted/boss/wasteland,
/area/ruin/unpowered)
"p" = (
/obj/effect/mapping_helpers/bombable_wall,
/turf/closed/indestructible/riveted/boss/wasteland,
/area/ruin/unpowered)
"q" = (
/obj/structure/stone_tile{
	dir = 8
	},
/obj/effect/spawner/random/structure/spikes,
/turf/closed/mineral/volcanic/lava_land_surface,
/area/lavaland/surface/outdoors)
"r" = (
/obj/structure/stone_tile{
	dir = 1
	},
/obj/structure/stone_tile,
/obj/effect/spawner/random/mob/necropolis_mob,
/turf/closed/mineral/volcanic/lava_land_surface,
/area/lavaland/surface/outdoors)
"s" = (
/obj/structure/stone_tile/surrounding/cracked{
	dir = 6
	},
/mob/living/basic/mining/watcher/magmawing,
/turf/open/misc/asteroid/basalt/wasteland,
/area/ruin/unpowered)
"t" = (
/obj/structure/flora/ash/fireblossom,
/turf/open/misc/asteroid/basalt/wasteland,
/area/ruin/unpowered)
"v" = (
/obj/effect/spawner/random/structure/spikes,
/turf/closed/mineral/random/high_chance/volcanic,
/area/lavaland/surface/outdoors)
"w" = (
/obj/effect/decal/cleanable/blood/gibs/up,
/turf/open/misc/asteroid/basalt/lava_land_surface,
/area/ruin/unpowered)
"y" = (
/obj/structure/stone_tile/block/cracked{
	dir = 1
	},
/obj/structure/stone_tile,
/obj/effect/spawner/random/mob/necropolis_mob,
/turf/closed/mineral/volcanic/lava_land_surface,
/area/lavaland/surface/outdoors)
"z" = (
/obj/structure/stone_tile/burnt{
	dir = 8
	},
/obj/effect/spawner/random/structure/spikes,
/turf/closed/mineral/volcanic/lava_land_surface,
/area/lavaland/surface/outdoors)
"A" = (
/obj/effect/mapping_helpers/bombable_wall,
/turf/closed/indestructible/riveted/boss/wasteland,
/area/lavaland/surface/outdoors)
"C" = (
/obj/structure/stone_tile/surrounding_tile{
	dir = 8
	},
/obj/effect/decal/cleanable/blood/innards,
/turf/open/misc/asteroid/basalt/wasteland,
/area/ruin/unpowered)
"D" = (
/obj/structure/stone_tile/block/cracked{
	pixel_y = -16
	},
/turf/open/misc/asteroid/basalt/lava_land_surface,
/area/ruin/unpowered)
"E" = (
/obj/structure/flora/rock/style_random,
/turf/open/misc/asteroid/basalt/lava_land_surface,
/area/ruin/unpowered)
"F" = (
/obj/structure/stone_tile/slab,
/turf/open/misc/asteroid/basalt/lava_land_surface,
/area/ruin/unpowered)
"G" = (
/mob/living/basic/mining/watcher,
/obj/effect/decal/cleanable/blood/gibs/core,
/turf/open/misc/asteroid/basalt/lava_land_surface,
/area/ruin/unpowered)
"H" = (
/obj/structure/stone_tile/slab/cracked,
/turf/open/misc/asteroid/basalt/lava_land_surface,
/area/ruin/unpowered)
"I" = (
/obj/structure/flora/ash/stem_shroom,
/turf/open/misc/asteroid/basalt/lava_land_surface,
/area/ruin/unpowered)
"J" = (
/obj/structure/stone_tile/surrounding_tile,
/obj/effect/decal/cleanable/blood/gibs/body,
/mob/living/basic/mining/watcher/icewing,
/turf/open/misc/asteroid/basalt/wasteland,
/area/ruin/unpowered)
"K" = (
/turf/template_noop,
/area/template_noop)
"L" = (
/obj/effect/decal/cleanable/blood,
/turf/open/misc/asteroid/basalt/lava_land_surface,
/area/ruin/unpowered)
"M" = (
/obj/effect/decal/cleanable/blood/gibs/old,
/turf/open/misc/asteroid/basalt/lava_land_surface,
/area/ruin/unpowered)
"O" = (
/obj/effect/decal/cleanable/blood/gibs/limb,
/obj/effect/decal/cleanable/blood/drip,
/turf/open/misc/asteroid/basalt/lava_land_surface,
/area/ruin/unpowered)
"P" = (
/obj/structure/stone_tile/burnt{
	dir = 8
	},
/obj/structure/stone_tile,
/obj/structure/stone_tile/cracked{
	dir = 1
	},
/turf/closed/mineral/volcanic/lava_land_surface,
/area/lavaland/surface/outdoors)
"Q" = (
/obj/structure/flora/rock/pile/style_random,
/turf/open/misc/asteroid/basalt/wasteland,
/area/ruin/unpowered)
"R" = (
/obj/effect/decal/cleanable/blood/gibs/down,
/turf/open/misc/asteroid/basalt/lava_land_surface,
/area/ruin/unpowered)
"S" = (
/obj/structure/stone_tile/block{
	dir = 1
	},
/obj/structure/stone_tile{
	dir = 8
	},
/turf/closed/mineral/volcanic/lava_land_surface,
/area/lavaland/surface/outdoors)
"T" = (
/obj/effect/mob_spawn/corpse/goliath/pierced,
/turf/open/misc/asteroid/basalt/wasteland,
/area/ruin/unpowered)
"U" = (
/obj/structure/flora/ash/tall_shroom,
/turf/open/misc/asteroid/basalt/lava_land_surface,
/area/ruin/unpowered)
"W" = (
/obj/structure/flora/rock/pile/style_random,
/turf/open/misc/asteroid/basalt/lava_land_surface,
/area/ruin/unpowered)
"Y" = (
/obj/structure/flora/ash/cacti,
/turf/open/misc/asteroid/basalt/lava_land_surface,
/area/ruin/unpowered)
"Z" = (
/obj/effect/mob_spawn/corpse/watcher/goliath_chewed,
/turf/open/misc/asteroid/basalt/wasteland,
/area/ruin/unpowered)

(1,1,1) = {"
K
K
b
a
a
v
b
a
a
K
K
K
"}
(2,1,1) = {"
K
b
v
o
o
p
o
o
o
z
K
K
"}
(3,1,1) = {"
b
S
o
o
j
j
W
I
o
o
h
q
"}
(4,1,1) = {"
a
o
o
j
j
M
l
G
j
o
o
a
"}
(5,1,1) = {"
a
o
j
D
Z
Q
t
L
j
j
o
a
"}
(6,1,1) = {"
v
o
F
O
Q
J
e
C
H
j
o
K
"}
(7,1,1) = {"
b
o
W
c
t
e
s
Q
R
W
o
K
"}
(8,1,1) = {"
a
o
j
j
E
T
f
t
m
Y
o
a
"}
(9,1,1) = {"
a
o
o
j
j
w
i
n
d
o
o
A
"}
(10,1,1) = {"
K
y
o
o
j
W
m
U
o
o
P
r
"}
(11,1,1) = {"
K
K
g
o
o
o
p
o
o
v
b
K
"}
(12,1,1) = {"
K
K
k
a
a
v
v
a
a
b
K
K
"}
