//MAP CONVERTED BY dmm2tgm.py THIS HEADER COMMENT PREVENTS RECONVERSION, DO NOT REMOVE
"a" = (
/obj/structure/stone_tile/surrounding/cracked{
	dir = 4
	},
/turf/open/chasm/lavaland,
/area/ruin/unpowered)
"b" = (
/obj/structure/stone_tile/surrounding/cracked{
	dir = 1
	},
/obj/structure/stone_tile/slab/cracked{
	dir = 1
	},
/turf/open/indestructible/necropolis,
/area/ruin/unpowered)
"d" = (
/turf/open/misc/asteroid/basalt/lava_land_surface,
/area/ruin/unpowered)
"f" = (
/obj/structure/punji_sticks/spikes,
/turf/open/misc/asteroid/basalt/lava_land_surface,
/area/ruin/unpowered)
"g" = (
/obj/effect/mapping_helpers/bombable_wall,
/obj/structure/stone_tile/slab,
/turf/closed/indestructible/riveted/boss/wasteland,
/area/ruin/unpowered)
"h" = (
/obj/structure/stone_tile/surrounding_tile/cracked{
	dir = 4
	},
/turf/open/chasm/lavaland,
/area/ruin/unpowered)
"i" = (
/obj/structure/stone_tile/surrounding_tile/cracked,
/turf/open/chasm/lavaland,
/area/ruin/unpowered)
"j" = (
/obj/structure/stone_tile/block/cracked{
	dir = 4
	},
/turf/open/indestructible/necropolis,
/area/ruin/unpowered)
"l" = (
/turf/open/chasm/lavaland,
/area/ruin/unpowered)
"m" = (
/obj/structure/stone_tile/block/cracked{
	dir = 1
	},
/turf/open/indestructible/necropolis,
/area/ruin/unpowered)
"q" = (
/obj/effect/decal/remains/human/smokey,
/turf/open/misc/asteroid/basalt/lava_land_surface,
/area/ruin/unpowered)
"r" = (
/obj/structure/stone_tile/block{
	dir = 4
	},
/turf/open/chasm/lavaland,
/area/ruin/unpowered)
"s" = (
/obj/effect/mapping_helpers/bombable_wall,
/obj/structure/stone_tile/slab/cracked,
/turf/closed/indestructible/riveted/boss/wasteland,
/area/ruin/unpowered)
"u" = (
/obj/structure/flora/rock/pile/style_random,
/turf/open/misc/asteroid/basalt/lava_land_surface,
/area/ruin/unpowered)
"v" = (
/obj/structure/stone_tile/surrounding_tile/cracked{
	dir = 1
	},
/turf/open/chasm/lavaland,
/area/ruin/unpowered)
"w" = (
/obj/structure/stone_tile/surrounding/cracked{
	dir = 4
	},
/turf/open/indestructible/necropolis,
/area/ruin/unpowered)
"x" = (
/obj/effect/mapping_helpers/bombable_wall,
/turf/closed/indestructible/riveted/boss/wasteland,
/area/ruin/unpowered)
"z" = (
/obj/structure/stone_tile/block/burnt{
	dir = 8
	},
/turf/open/indestructible/necropolis,
/area/ruin/unpowered)
"A" = (
/obj/structure/stone_tile/surrounding/cracked{
	dir = 4
	},
/obj/structure/stone_tile/center/cracked,
/turf/open/misc/asteroid/basalt/lava_land_surface,
/area/ruin/unpowered)
"B" = (
/obj/structure/stone_tile/slab/burnt,
/turf/open/misc/asteroid/basalt/lava_land_surface,
/area/ruin/unpowered)
"C" = (
/obj/structure/stone_tile/slab,
/turf/open/misc/asteroid/basalt/lava_land_surface,
/area/ruin/unpowered)
"D" = (
/obj/structure/stone_tile/block/cracked{
	dir = 4
	},
/turf/open/chasm/lavaland,
/area/ruin/unpowered)
"E" = (
/turf/template_noop,
/area/template_noop)
"F" = (
/obj/effect/mapping_helpers/bombable_wall,
/obj/structure/fluff/big_chain{
	pixel_y = 12
	},
/turf/closed/indestructible/riveted/boss/wasteland,
/area/ruin/unpowered)
"G" = (
/obj/effect/mapping_helpers/bombable_wall,
/turf/closed/indestructible/riveted/boss/wasteland,
/area/lavaland/surface/outdoors)
"H" = (
/obj/structure/stone_tile/surrounding/cracked{
	dir = 8
	},
/obj/structure/stone_tile/slab/cracked{
	dir = 8
	},
/turf/open/indestructible/necropolis,
/area/ruin/unpowered)
"I" = (
/obj/structure/stone_tile/surrounding_tile/cracked{
	dir = 5
	},
/obj/structure/stone_tile/center/burnt,
/mob/living/simple_animal/hostile/megafauna/wendigo{
	name = "Hunger";
	speed = 1;
	health = 1500;
	maxHealth = 1500;
	desc = "An ancient demon, a spirit of the old nature. Chained. Hungry.";
	light_color = "#333333";
	color = "#333333";
	crusher_loot = list(/obj/item/crusher_trophy/wendigo_horn,/obj/structure/closet/crate/necropolis/tendril);
	loot = list(/obj/item/seeds/grass/fairy,/obj/item/book/granter/action/spell/summonitem)
	},
/obj/effect/decal/cleanable/grand_remains,
/obj/effect/gibspawner/human/bodypartless,
/obj/item/gun/ballistic/bow/tribalbow/ashen{
	projectile_damage_multiplier = 3;
	name = "Living bow";
	attack_speed = 6;
	desc = "Some sort of primitive projectile weapon made of bone and wrapped sinew, something wrong with it. This feels... Angry. Somehow."
	},
/obj/structure/marker_beacon/burgundy,
/obj/item/stack/ore/diamond{
	amount = 25
	},
/turf/open/indestructible/necropolis,
/area/ruin/unpowered)
"J" = (
/obj/structure/stone_tile/slab/cracked{
	dir = 4
	},
/obj/structure/stone_tile/slab/cracked{
	dir = 8
	},
/turf/open/misc/asteroid/basalt/lava_land_surface,
/area/ruin/unpowered)
"K" = (
/obj/structure/stone_tile/block/burnt,
/turf/open/indestructible/necropolis,
/area/ruin/unpowered)
"L" = (
/obj/structure/stone_tile/block/burnt{
	dir = 8
	},
/turf/open/chasm/lavaland,
/area/ruin/unpowered)
"M" = (
/obj/structure/stone_tile/burnt{
	dir = 1
	},
/obj/structure/stone_tile/burnt{
	dir = 4
	},
/turf/open/chasm/lavaland,
/area/ruin/unpowered)
"N" = (
/obj/structure/stone_tile/cracked{
	dir = 4
	},
/obj/structure/stone_tile/block/burnt,
/turf/open/chasm/lavaland,
/area/ruin/unpowered)
"O" = (
/obj/effect/mapping_helpers/bombable_wall,
/obj/structure/stone_tile/slab/burnt,
/turf/closed/indestructible/riveted/boss/wasteland,
/area/ruin/unpowered)
"P" = (
/obj/structure/stone_tile/cracked{
	dir = 4
	},
/obj/structure/stone_tile/surrounding_tile/cracked{
	dir = 8
	},
/turf/open/chasm/lavaland,
/area/ruin/unpowered)
"Q" = (
/obj/structure/stone_tile/surrounding/cracked{
	dir = 6
	},
/turf/open/misc/asteroid/basalt/lava_land_surface,
/area/ruin/unpowered)
"S" = (
/obj/structure/stone_tile/surrounding/cracked,
/turf/open/indestructible/necropolis,
/area/ruin/unpowered)
"T" = (
/obj/structure/stone_tile/block/cracked,
/obj/structure/stone_tile/cracked{
	dir = 1
	},
/turf/open/chasm/lavaland,
/area/ruin/unpowered)
"U" = (
/obj/structure/stone_tile/cracked{
	dir = 8
	},
/turf/open/chasm/lavaland,
/area/ruin/unpowered)
"V" = (
/obj/structure/stone_tile/slab/cracked{
	dir = 10
	},
/obj/structure/stone_tile/surrounding/cracked{
	dir = 8
	},
/turf/open/chasm/lavaland,
/area/ruin/unpowered)
"W" = (
/obj/structure/stone_tile/block/cracked{
	dir = 8
	},
/turf/open/chasm/lavaland,
/area/ruin/unpowered)
"X" = (
/obj/structure/stone_tile/burnt,
/turf/open/chasm/lavaland,
/area/ruin/unpowered)
"Z" = (
/obj/structure/stone_tile/surrounding_tile/cracked{
	dir = 9
	},
/obj/structure/stone_tile/surrounding_tile/burnt{
	dir = 8
	},
/turf/open/chasm/lavaland,
/area/ruin/unpowered)

(1,1,1) = {"
E
E
G
G
E
E
E
G
G
E
E
E
E
E
E
"}
(2,1,1) = {"
E
x
x
x
x
x
x
x
x
x
E
E
E
E
E
"}
(3,1,1) = {"
x
F
u
f
x
x
q
u
d
F
x
x
x
E
E
"}
(4,1,1) = {"
x
d
q
l
l
x
l
l
u
q
F
u
x
x
x
"}
(5,1,1) = {"
x
x
l
l
l
x
l
l
l
l
l
f
f
x
x
"}
(6,1,1) = {"
x
x
l
F
x
x
x
F
U
l
l
l
l
h
F
"}
(7,1,1) = {"
x
q
l
x
b
j
w
x
V
N
L
Z
W
P
s
"}
(8,1,1) = {"
x
x
x
x
K
I
m
x
C
B
A
J
Q
C
g
"}
(9,1,1) = {"
x
u
l
x
H
z
S
x
a
T
D
v
r
M
O
"}
(10,1,1) = {"
x
x
l
F
x
x
x
F
X
i
l
l
l
v
F
"}
(11,1,1) = {"
x
x
l
l
l
x
l
l
l
l
l
f
u
x
x
"}
(12,1,1) = {"
x
q
f
l
l
x
l
l
q
d
F
q
x
x
x
"}
(13,1,1) = {"
x
F
d
u
x
x
q
f
u
F
x
x
x
E
E
"}
(14,1,1) = {"
E
x
x
x
x
x
x
x
x
x
E
E
E
E
E
"}
(15,1,1) = {"
E
E
G
G
E
E
E
G
G
E
E
E
E
E
E
"}
