//MAP CONVERTED BY dmm2tgm.py THIS HEADER COMMENT PREVENTS RECONVERSION, DO NOT REMOVE
"a" = (
/turf/template_noop,
/area/template_noop)
"c" = (
/obj/structure/stone_tile/surrounding/cracked{
	dir = 8
	},
/obj/structure/stone_tile/slab/cracked{
	dir = 8
	},
/turf/open/indestructible/necropolis,
/area/ruin/unpowered)
"e" = (
/obj/structure/stone_tile/block/burnt{
	dir = 8
	},
/turf/open/indestructible/necropolis,
/area/ruin/unpowered)
"f" = (
/turf/open/misc/asteroid/basalt/lava_land_surface,
/area/ruin/unpowered)
"h" = (
/obj/structure/stone_tile/slab/cracked{
	dir = 4
	},
/obj/structure/stone_tile/slab/cracked{
	dir = 8
	},
/turf/open/misc/asteroid/basalt/lava_land_surface,
/area/ruin/unpowered)
"i" = (
/obj/structure/stone_tile/burnt{
	dir = 1
	},
/obj/structure/stone_tile/burnt{
	dir = 4
	},
/turf/open/chasm/lavaland,
/area/ruin/unpowered)
"j" = (
/obj/structure/stone_tile/block/cracked{
	dir = 4
	},
/turf/open/indestructible/necropolis,
/area/ruin/unpowered)
"l" = (
/obj/structure/stone_tile/burnt,
/turf/open/chasm/lavaland,
/area/ruin/unpowered)
"m" = (
/obj/structure/punji_sticks/spikes,
/turf/open/misc/asteroid/basalt/lava_land_surface,
/area/ruin/unpowered)
"o" = (
/obj/structure/stone_tile/surrounding/cracked,
/turf/open/indestructible/necropolis,
/area/ruin/unpowered)
"p" = (
/obj/structure/stone_tile/block/cracked,
/obj/structure/stone_tile/cracked{
	dir = 1
	},
/turf/open/chasm/lavaland,
/area/ruin/unpowered)
"q" = (
/obj/structure/stone_tile/surrounding_tile/cracked{
	dir = 5
	},
/obj/structure/stone_tile/center/burnt,
/mob/living/simple_animal/hostile/megafauna/wendigo{
	name = "Hunger";
	speed = 1;
	health = 1500;
	maxHealth = 1500;
	desc = "An ancient demon, a spirit of the old nature. Chained. Hungry.";
	light_color = "#333333";
	color = "#333333";
	crusher_loot = list(/obj/item/crusher_trophy/wendigo_horn,/obj/structure/closet/crate/necropolis/tendril);
	loot = list(/obj/item/seeds/grass/fairy,/obj/item/book/granter/action/spell/summonitem)
	},
/obj/effect/decal/cleanable/grand_remains,
/obj/effect/gibspawner/human/bodypartless,
/obj/item/gun/ballistic/bow/tribalbow/ashen{
	projectile_damage_multiplier = 3;
	name = "Living bow";
	attack_speed = 6;
	desc = "Some sort of primitive projectile weapon made of bone and wrapped sinew, something wrong with it. This feels... Angry. Somehow."
	},
/obj/structure/marker_beacon/burgundy,
/obj/item/stack/ore/diamond{
	amount = 25
	},
/turf/open/indestructible/necropolis,
/area/ruin/unpowered)
"r" = (
/obj/structure/stone_tile/block/burnt,
/turf/open/indestructible/necropolis,
/area/ruin/unpowered)
"s" = (
/obj/effect/decal/remains/human/smokey,
/turf/open/misc/asteroid/basalt/lava_land_surface,
/area/ruin/unpowered)
"t" = (
/obj/effect/mapping_helpers/bombable_wall,
/obj/structure/stone_tile/slab/cracked,
/turf/closed/indestructible/riveted/boss/wasteland,
/area/lavaland/surface/outdoors)
"u" = (
/obj/effect/mapping_helpers/bombable_wall,
/obj/structure/fluff/big_chain{
	pixel_y = 12
	},
/turf/closed/indestructible/riveted/boss/wasteland,
/area/ruin/unpowered)
"v" = (
/obj/structure/stone_tile/cracked{
	dir = 4
	},
/obj/structure/stone_tile/surrounding_tile/cracked{
	dir = 8
	},
/turf/open/chasm/lavaland,
/area/ruin/unpowered)
"w" = (
/obj/structure/stone_tile/surrounding/cracked{
	dir = 4
	},
/turf/open/chasm/lavaland,
/area/ruin/unpowered)
"x" = (
/obj/structure/flora/rock/pile/style_random,
/turf/open/misc/asteroid/basalt/lava_land_surface,
/area/ruin/unpowered)
"y" = (
/obj/structure/stone_tile/surrounding_tile/cracked,
/turf/open/chasm/lavaland,
/area/ruin/unpowered)
"z" = (
/obj/structure/stone_tile/cracked{
	dir = 8
	},
/turf/open/chasm/lavaland,
/area/ruin/unpowered)
"A" = (
/obj/structure/stone_tile/surrounding/cracked{
	dir = 1
	},
/obj/structure/stone_tile/slab/cracked{
	dir = 1
	},
/turf/open/indestructible/necropolis,
/area/ruin/unpowered)
"B" = (
/obj/effect/mapping_helpers/bombable_wall,
/obj/structure/fluff/big_chain{
	pixel_y = 12
	},
/turf/closed/indestructible/riveted/boss/wasteland,
/area/lavaland/surface/outdoors)
"C" = (
/obj/structure/stone_tile/block/burnt{
	dir = 8
	},
/turf/open/chasm/lavaland,
/area/ruin/unpowered)
"E" = (
/obj/structure/stone_tile/surrounding/cracked{
	dir = 6
	},
/turf/open/misc/asteroid/basalt/lava_land_surface,
/area/ruin/unpowered)
"F" = (
/obj/structure/stone_tile/surrounding/cracked{
	dir = 4
	},
/turf/open/indestructible/necropolis,
/area/ruin/unpowered)
"G" = (
/obj/effect/mapping_helpers/bombable_wall,
/obj/structure/stone_tile/slab/burnt,
/turf/closed/indestructible/riveted/boss/wasteland,
/area/lavaland/surface/outdoors)
"H" = (
/obj/structure/stone_tile/block{
	dir = 4
	},
/turf/open/chasm/lavaland,
/area/ruin/unpowered)
"I" = (
/obj/effect/mapping_helpers/bombable_wall,
/obj/structure/stone_tile/slab,
/turf/closed/indestructible/riveted/boss/wasteland,
/area/lavaland/surface/outdoors)
"J" = (
/obj/structure/stone_tile/block/cracked{
	dir = 4
	},
/turf/open/chasm/lavaland,
/area/ruin/unpowered)
"K" = (
/obj/structure/stone_tile/cracked{
	dir = 4
	},
/obj/structure/stone_tile/block/burnt,
/turf/open/chasm/lavaland,
/area/ruin/unpowered)
"L" = (
/obj/effect/mapping_helpers/bombable_wall,
/turf/closed/indestructible/riveted/boss/wasteland,
/area/ruin/unpowered)
"M" = (
/obj/structure/stone_tile/slab/cracked{
	dir = 10
	},
/obj/structure/stone_tile/surrounding/cracked{
	dir = 8
	},
/turf/open/chasm/lavaland,
/area/ruin/unpowered)
"N" = (
/obj/structure/stone_tile/block/cracked{
	dir = 8
	},
/turf/open/chasm/lavaland,
/area/ruin/unpowered)
"O" = (
/obj/structure/stone_tile/block/cracked{
	dir = 1
	},
/turf/open/indestructible/necropolis,
/area/ruin/unpowered)
"P" = (
/obj/structure/stone_tile/surrounding_tile/cracked{
	dir = 9
	},
/obj/structure/stone_tile/surrounding_tile/burnt{
	dir = 8
	},
/turf/open/chasm/lavaland,
/area/ruin/unpowered)
"R" = (
/obj/structure/stone_tile/surrounding_tile/cracked{
	dir = 1
	},
/turf/open/chasm/lavaland,
/area/ruin/unpowered)
"T" = (
/obj/structure/stone_tile/surrounding_tile/cracked{
	dir = 4
	},
/turf/open/chasm/lavaland,
/area/ruin/unpowered)
"U" = (
/obj/structure/stone_tile/slab/burnt,
/turf/open/misc/asteroid/basalt/lava_land_surface,
/area/ruin/unpowered)
"V" = (
/obj/effect/mapping_helpers/bombable_wall,
/turf/closed/indestructible/riveted/boss/wasteland,
/area/lavaland/surface/outdoors)
"X" = (
/turf/open/chasm/lavaland,
/area/ruin/unpowered)
"Y" = (
/obj/structure/stone_tile/surrounding/cracked{
	dir = 4
	},
/obj/structure/stone_tile/center/cracked,
/turf/open/misc/asteroid/basalt/lava_land_surface,
/area/ruin/unpowered)
"Z" = (
/obj/structure/stone_tile/slab,
/turf/open/misc/asteroid/basalt/lava_land_surface,
/area/ruin/unpowered)

(1,1,1) = {"
a
a
V
V
a
a
a
V
V
a
a
a
a
a
a
"}
(2,1,1) = {"
a
V
V
V
V
V
V
V
V
V
a
a
a
a
a
"}
(3,1,1) = {"
V
B
x
m
L
L
s
x
f
B
V
V
V
a
a
"}
(4,1,1) = {"
V
f
s
X
X
L
X
X
x
s
u
x
V
V
V
"}
(5,1,1) = {"
V
L
X
X
X
L
X
X
X
X
X
m
m
L
V
"}
(6,1,1) = {"
V
L
X
u
L
L
L
u
z
X
X
X
X
T
B
"}
(7,1,1) = {"
V
s
X
L
A
j
F
L
M
K
C
P
N
v
t
"}
(8,1,1) = {"
V
L
L
L
r
q
O
L
Z
U
Y
h
E
Z
I
"}
(9,1,1) = {"
V
x
X
L
c
e
o
L
w
p
J
R
H
i
G
"}
(10,1,1) = {"
V
L
X
u
L
L
L
u
l
y
X
X
X
R
B
"}
(11,1,1) = {"
V
L
X
X
X
L
X
X
X
X
X
m
x
L
V
"}
(12,1,1) = {"
V
s
m
X
X
L
X
X
s
f
u
s
V
V
V
"}
(13,1,1) = {"
V
B
f
x
L
L
s
m
x
B
V
V
V
a
a
"}
(14,1,1) = {"
a
V
V
V
V
V
V
V
V
V
a
a
a
a
a
"}
(15,1,1) = {"
a
a
V
V
a
a
a
V
V
a
a
a
a
a
a
"}
