//MAP CONVERTED BY dmm2tgm.py THIS HEADER COMMENT PREVENTS RECONVERSION, DO NOT REMOVE
"a" = (
/turf/closed/indestructible/riveted/boss/wasteland,
/area/lavaland/surface/outdoors)
"b" = (
/turf/closed/mineral/volcanic/lava_land_surface,
/area/lavaland/surface/outdoors)
"c" = (
/mob/living/basic/mining/watcher,
/obj/effect/decal/cleanable/blood/splatter,
/turf/open/misc/asteroid/basalt/lava_land_surface,
/area/ruin/unpowered)
"d" = (
/obj/structure/stone_tile/surrounding/cracked,
/obj/structure/stone_tile/center/cracked,
/turf/open/misc/asteroid/basalt/lava_land_surface,
/area/ruin/unpowered)
"e" = (
/obj/item/food/egg/watcher,
/turf/open/misc/asteroid/basalt/wasteland/basin,
/area/ruin/unpowered)
"f" = (
/obj/structure/stone_tile/surrounding_tile{
	dir = 1
	},
/obj/effect/decal/cleanable/blood/old,
/turf/open/misc/asteroid/basalt/wasteland,
/area/ruin/unpowered)
"g" = (
/obj/structure/stone_tile/block{
	dir = 1
	},
/turf/closed/mineral/random/high_chance/volcanic,
/area/lavaland/surface/outdoors)
"h" = (
/obj/structure/stone_tile/block/cracked,
/obj/structure/stone_tile{
	dir = 4
	},
/turf/closed/mineral/random/high_chance/volcanic,
/area/lavaland/surface/outdoors)
"i" = (
/obj/effect/decal/cleanable/blood/gibs/bubblegum,
/turf/open/misc/asteroid/basalt/lava_land_surface,
/area/ruin/unpowered)
"j" = (
/turf/closed/mineral/random/high_chance/volcanic,
/area/ruin/unpowered)
"k" = (
/obj/structure/stone_tile{
	dir = 1
	},
/turf/closed/mineral/volcanic/lava_land_surface,
/area/lavaland/surface/outdoors)
"l" = (
/obj/structure/stone_tile/cracked{
	pixel_x = 16
	},
/turf/open/misc/asteroid/basalt/lava_land_surface,
/area/ruin/unpowered)
"m" = (
/turf/open/misc/asteroid/basalt/lava_land_surface,
/area/ruin/unpowered)
"n" = (
/mob/living/basic/mining/watcher,
/turf/open/misc/asteroid/basalt/lava_land_surface,
/area/ruin/unpowered)
"p" = (
/turf/closed/mineral/random/high_chance/volcanic,
/area/lavaland/surface/outdoors)
"q" = (
/obj/structure/stone_tile{
	dir = 8
	},
/turf/closed/mineral/volcanic/lava_land_surface,
/area/lavaland/surface/outdoors)
"r" = (
/obj/structure/stone_tile{
	dir = 1
	},
/obj/structure/stone_tile,
/turf/closed/mineral/volcanic/lava_land_surface,
/area/lavaland/surface/outdoors)
"s" = (
/mob/living/basic/mining/watcher/magmawing,
/obj/structure/stone_tile/surrounding/cracked{
	dir = 6
	},
/turf/open/misc/asteroid/basalt/wasteland,
/area/ruin/unpowered)
"t" = (
/obj/structure/flora/ash/fireblossom,
/turf/open/misc/asteroid/basalt/wasteland,
/area/ruin/unpowered)
"v" = (
/obj/structure/trap/damage{
	name = "Anctient runic spikes";
	desc = "A strange carving of some symbols. What's that for?";
	icon = 'icons/obj/service/hydroponics/equipment.dmi';
	icon_state = "woodspike";
	light_color = "#DDFFDD";
	color = "#77FF77";
	alpha = 180
	},
/turf/closed/mineral/random/high_chance/volcanic,
/area/lavaland/surface/outdoors)
"w" = (
/obj/effect/decal/cleanable/blood/gibs/up,
/turf/open/misc/asteroid/basalt/lava_land_surface,
/area/ruin/unpowered)
"y" = (
/obj/structure/stone_tile/block/cracked{
	dir = 1
	},
/obj/structure/stone_tile,
/turf/closed/mineral/volcanic/lava_land_surface,
/area/lavaland/surface/outdoors)
"z" = (
/obj/structure/stone_tile/burnt{
	dir = 8
	},
/turf/closed/mineral/volcanic/lava_land_surface,
/area/lavaland/surface/outdoors)
"A" = (
/obj/effect/mapping_helpers/bombable_wall,
/turf/closed/indestructible/riveted/boss/wasteland,
/area/lavaland/surface/outdoors)
"C" = (
/obj/structure/stone_tile/surrounding_tile{
	dir = 8
	},
/obj/effect/decal/cleanable/blood/innards,
/turf/open/misc/asteroid/basalt/wasteland,
/area/ruin/unpowered)
"D" = (
/obj/structure/stone_tile/block/cracked{
	pixel_y = -16
	},
/turf/open/misc/asteroid/basalt/lava_land_surface,
/area/ruin/unpowered)
"E" = (
/obj/structure/flora/rock/style_random,
/turf/open/misc/asteroid/basalt/lava_land_surface,
/area/ruin/unpowered)
"F" = (
/obj/structure/stone_tile/slab,
/turf/open/misc/asteroid/basalt/lava_land_surface,
/area/ruin/unpowered)
"G" = (
/mob/living/basic/mining/watcher,
/obj/effect/decal/cleanable/blood/gibs/core,
/turf/open/misc/asteroid/basalt/lava_land_surface,
/area/ruin/unpowered)
"H" = (
/obj/structure/stone_tile/slab/cracked,
/turf/open/misc/asteroid/basalt/lava_land_surface,
/area/ruin/unpowered)
"I" = (
/obj/structure/flora/ash/stem_shroom,
/turf/open/misc/asteroid/basalt/lava_land_surface,
/area/ruin/unpowered)
"J" = (
/mob/living/basic/mining/watcher/icewing,
/obj/structure/stone_tile/surrounding_tile,
/obj/effect/decal/cleanable/blood/gibs/body,
/turf/open/misc/asteroid/basalt/wasteland,
/area/ruin/unpowered)
"K" = (
/turf/template_noop,
/area/template_noop)
"L" = (
/obj/effect/decal/cleanable/blood,
/turf/open/misc/asteroid/basalt/lava_land_surface,
/area/ruin/unpowered)
"M" = (
/obj/effect/decal/cleanable/blood/gibs/old,
/turf/open/misc/asteroid/basalt/lava_land_surface,
/area/ruin/unpowered)
"N" = (
/obj/structure/trap/fire{
	name = "Anctient runic spikes";
	desc = "A strange carving of some symbols. What's that for?";
	alpha = 180;
	icon = 'icons/obj/service/hydroponics/equipment.dmi';
	icon_state = "woodspike";
	light_color = "#FF1111";
	color = "#FF1111"
	},
/turf/closed/mineral/random/high_chance/volcanic,
/area/lavaland/surface/outdoors)
"O" = (
/obj/effect/decal/cleanable/blood/gibs/limb,
/obj/effect/decal/cleanable/blood/drip,
/turf/open/misc/asteroid/basalt/lava_land_surface,
/area/ruin/unpowered)
"P" = (
/obj/structure/stone_tile/burnt{
	dir = 8
	},
/obj/structure/stone_tile,
/obj/structure/stone_tile/cracked{
	dir = 1
	},
/turf/closed/mineral/volcanic/lava_land_surface,
/area/lavaland/surface/outdoors)
"Q" = (
/obj/structure/flora/rock/pile/style_random,
/turf/open/misc/asteroid/basalt/wasteland,
/area/ruin/unpowered)
"R" = (
/obj/effect/decal/cleanable/blood/gibs/down,
/turf/open/misc/asteroid/basalt/lava_land_surface,
/area/ruin/unpowered)
"S" = (
/obj/structure/stone_tile/block{
	dir = 1
	},
/obj/structure/stone_tile{
	dir = 8
	},
/turf/closed/mineral/volcanic/lava_land_surface,
/area/lavaland/surface/outdoors)
"T" = (
/obj/effect/mob_spawn/corpse/goliath/pierced,
/turf/open/misc/asteroid/basalt/wasteland,
/area/ruin/unpowered)
"U" = (
/obj/structure/flora/ash/tall_shroom,
/turf/open/misc/asteroid/basalt/lava_land_surface,
/area/ruin/unpowered)
"W" = (
/obj/structure/flora/rock/pile/style_random,
/turf/open/misc/asteroid/basalt/lava_land_surface,
/area/ruin/unpowered)
"Y" = (
/obj/structure/flora/ash/cacti,
/turf/open/misc/asteroid/basalt/lava_land_surface,
/area/ruin/unpowered)
"Z" = (
/obj/effect/mob_spawn/corpse/watcher/goliath_chewed,
/turf/open/misc/asteroid/basalt/wasteland,
/area/ruin/unpowered)

(1,1,1) = {"
K
K
b
a
a
v
b
a
a
K
K
K
"}
(2,1,1) = {"
K
b
p
a
a
A
a
a
a
z
K
K
"}
(3,1,1) = {"
b
S
a
a
j
j
W
I
a
a
h
q
"}
(4,1,1) = {"
a
a
a
j
j
M
l
G
j
a
a
a
"}
(5,1,1) = {"
a
a
j
D
Z
Q
t
L
j
j
a
a
"}
(6,1,1) = {"
p
a
F
O
Q
J
e
C
H
j
a
K
"}
(7,1,1) = {"
b
a
W
c
t
e
s
Q
R
W
a
K
"}
(8,1,1) = {"
a
a
j
j
E
T
f
t
m
Y
a
a
"}
(9,1,1) = {"
a
a
a
j
j
w
i
n
d
a
a
A
"}
(10,1,1) = {"
K
y
a
a
j
W
m
U
a
a
P
r
"}
(11,1,1) = {"
K
K
g
a
a
a
A
a
a
p
b
K
"}
(12,1,1) = {"
K
K
k
a
a
p
N
a
a
b
K
K
"}
