//MAP CONVERTED BY dmm2tgm.py THIS HEADER COMMENT PREVENTS RECONVERSION, DO NOT REMOVE
"a" = (
/obj/item/organ/internal/tongue/cat/tajaran,
/obj/effect/glowing_rune,
/obj/item/reagent_containers/hypospray/medipen/survival/luxury,
/turf/open/floor/plating/rust{
	initial_gas_mix = "LAVALAND_ATMOS"
	},
/area/ruin/unpowered)
"c" = (
/obj/structure/trap/damage{
	name = "Anctient runic spikes";
	desc = "A strange carving of some symbols. What's that for?";
	icon = 'icons/obj/service/hydroponics/equipment.dmi';
	icon_state = "woodspike";
	light_color = "#DDFFDD";
	color = "#77FF77";
	alpha = 180
	},
/turf/closed/mineral/volcanic/lava_land_surface,
/area/lavaland/surface/outdoors)
"h" = (
/turf/closed/wall/r_wall/rust,
/area/lavaland/surface/outdoors)
"j" = (
/obj/effect/glowing_rune,
/turf/closed/wall/r_wall/rust,
/area/lavaland/surface/outdoors)
"k" = (
/obj/structure/punji_sticks/spikes,
/turf/closed/mineral/volcanic/lava_land_surface,
/area/lavaland/surface/outdoors)
"l" = (
/obj/structure/destructible/eldritch_crucible,
/obj/effect/decal/cleanable/grand_remains/cheese,
/obj/item/reagent_containers/cup/beaker/eldritch,
/obj/item/food/kebab/monkey{
	pixel_y = 5
	},
/turf/open/floor/plating/rust{
	initial_gas_mix = "LAVALAND_ATMOS"
	},
/area/ruin/unpowered)
"m" = (
/obj/item/clothing/neck/fake_heretic_amulet,
/obj/effect/decal/cleanable/blood/old{
	icon_state = "gibbl1"
	},
/obj/item/storage/box/medipens,
/obj/effect/spawner/random/maintenance,
/turf/open/floor/plating/rust{
	initial_gas_mix = "LAVALAND_ATMOS"
	},
/area/ruin/unpowered)
"o" = (
/turf/template_noop,
/area/template_noop)
"p" = (
/obj/effect/decal/cleanable/blood/old,
/mob/living/basic/heretic_summon/raw_prophet/ruins,
/turf/open/floor/plating/rust{
	initial_gas_mix = "LAVALAND_ATMOS"
	},
/area/ruin/unpowered)
"v" = (
/obj/effect/decal/cleanable/blood/old{
	icon_state = "floor4-old";
	pixel_y = 10;
	pixel_x = 5
	},
/obj/effect/glowing_rune,
/turf/open/floor/plating/rust{
	initial_gas_mix = "LAVALAND_ATMOS"
	},
/area/ruin/unpowered)
"w" = (
/mob/living/basic/heretic_summon/raw_prophet/ruins,
/obj/effect/gibspawner/human/bodypartless,
/obj/effect/glowing_rune,
/turf/open/floor/plating/rust{
	initial_gas_mix = "LAVALAND_ATMOS"
	},
/area/ruin/unpowered)
"z" = (
/obj/effect/spawner/random/maintenance,
/obj/effect/mapping_helpers/burnt_floor,
/turf/open/floor/plating/rust{
	initial_gas_mix = "LAVALAND_ATMOS"
	},
/area/ruin/unpowered)
"A" = (
/obj/structure/door_assembly/door_assembly_min,
/turf/open/floor/plating/rust{
	initial_gas_mix = "LAVALAND_ATMOS"
	},
/area/lavaland/surface/outdoors)
"B" = (
/obj/effect/glowing_rune,
/turf/closed/indestructible/riveted/boss,
/area/lavaland/surface/outdoors)
"D" = (
/obj/item/xenoarch/useless_relic{
	name = "Ancient relic";
	desc = "Sort of relic that can be exported through Cargo."
	},
/turf/closed/mineral/volcanic/lava_land_surface,
/area/lavaland/surface/outdoors)
"F" = (
/turf/closed/indestructible/riveted/boss,
/area/lavaland/surface/outdoors)
"H" = (
/turf/closed/mineral/volcanic/lava_land_surface,
/area/lavaland/surface/outdoors)
"I" = (
/obj/effect/gibspawner/human,
/obj/item/melee/sickly_blade/rust,
/obj/item/stack/sheet/animalhide/monkey,
/turf/open/floor/plating/rust{
	initial_gas_mix = "LAVALAND_ATMOS"
	},
/area/ruin/unpowered)
"J" = (
/obj/structure/trap/fire{
	name = "Anctient runic spikes";
	desc = "A strange carving of some symbols. What's that for?";
	alpha = 180;
	icon = 'icons/obj/service/hydroponics/equipment.dmi';
	icon_state = "woodspike";
	light_color = "#FF1111";
	color = "#FF1111"
	},
/turf/closed/mineral/volcanic/lava_land_surface,
/area/lavaland/surface/outdoors)
"K" = (
/obj/effect/mapping_helpers/bombable_wall,
/obj/structure/trap/eldritch/tentacle,
/turf/closed/indestructible/riveted/boss/wasteland,
/area/lavaland/surface/outdoors)
"M" = (
/obj/effect/mob_spawn/corpse/human/monkey,
/obj/effect/mapping_helpers/broken_floor,
/turf/open/floor/plating/rust{
	initial_gas_mix = "LAVALAND_ATMOS"
	},
/area/ruin/unpowered)
"N" = (
/obj/effect/spawner/random/maintenance,
/obj/item/organ/internal/brain/felinid,
/obj/effect/mapping_helpers/broken_floor,
/turf/open/floor/plating/rust{
	initial_gas_mix = "LAVALAND_ATMOS"
	},
/area/ruin/unpowered)
"P" = (
/obj/effect/mapping_helpers/broken_floor,
/turf/open/floor/plating/rust{
	initial_gas_mix = "LAVALAND_ATMOS"
	},
/area/ruin/unpowered)
"Y" = (
/obj/effect/mapping_helpers/burnt_floor,
/obj/effect/glowing_rune,
/mob/living/basic/heretic_summon/raw_prophet/ruins{
	name = "\improper Prophet of Agony";
	light_color = "#77FF77";
	color = "#77FF77";
	damage_coeff = list("brute" = 1, "burn" = 1, "toxin" = 1, "stamina" = 0, "oxygen" = 0);
	melee_damage_type = "toxin";
	health = 240;
	melee_attack_cooldown = 2;
	light_power = 12;
	light_range = 2;
	lighting_cutoff_blue = 35;
	lighting_cutoff_green = 15;
	lighting_cutoff_red = 25
	},
/turf/open/floor/plating/rust{
	initial_gas_mix = "LAVALAND_ATMOS"
	},
/area/ruin/unpowered)
"Z" = (
/obj/structure/lattice,
/turf/open/misc/asteroid/basalt/lava_land_surface,
/area/lavaland/surface/outdoors)

(1,1,1) = {"
o
c
H
F
c
H
F
o
o
"}
(2,1,1) = {"
k
H
D
F
K
F
F
c
H
"}
(3,1,1) = {"
H
H
F
B
P
h
F
F
k
"}
(4,1,1) = {"
c
F
m
w
M
N
h
F
A
"}
(5,1,1) = {"
F
F
Y
l
v
P
h
F
Z
"}
(6,1,1) = {"
F
j
I
a
p
P
F
F
o
"}
(7,1,1) = {"
F
F
h
z
F
K
c
H
H
"}
(8,1,1) = {"
o
F
F
F
F
c
h
H
J
"}
(9,1,1) = {"
o
o
F
F
F
H
j
k
o
"}
