//MAP CONVERTED BY dmm2tgm.py THIS HEADER COMMENT PREVENTS RECONVERSION, DO NOT REMOVE
"a" = (
/turf/template_noop,
/area/template_noop)
"e" = (
/obj/structure/flora/rock/pile/style_random,
/turf/closed/mineral/strong{
	base_icon_state = "smoothrocks";
	icon = 'modular_nova/modules/liquids/icons/turf/smoothrocks.dmi';
	icon_state = "smoothrocks-55"
	},
/area/lavaland/surface/outdoors)
"n" = (
/obj/effect/spawner/random/structure/orevein_longregen,
/turf/closed/mineral/volcanic/lava_land_surface,
/area/lavaland/surface/outdoors)
"r" = (
/obj/item/xenoarch/useless_relic/magnified{
	name = "Ancient relic";
	desc = "Sort of relic that can be exported through Cargo."
	},
/obj/effect/spawner/random/structure/orevein_longregen,
/turf/closed/mineral/volcanic/lava_land_surface,
/area/lavaland/surface/outdoors)
"s" = (
/obj/structure/flora/rock/pile/style_random,
/turf/closed/mineral/volcanic/lava_land_surface,
/area/lavaland/surface/outdoors)
"w" = (
/obj/effect/spawner/random/mob/necropolis_mob,
/turf/closed/mineral/random/high_chance/volcanic,
/area/lavaland/surface/outdoors)
"z" = (
/turf/closed/indestructible/riveted/boss,
/area/lavaland/surface/outdoors)
"E" = (
/obj/effect/spawner/random/mob/necropolis_mob,
/turf/closed/mineral/volcanic/lava_land_surface,
/area/lavaland/surface/outdoors)
"M" = (
/turf/closed/mineral/volcanic/lava_land_surface,
/area/lavaland/surface/outdoors)
"S" = (
/turf/closed/mineral/random/high_chance/volcanic,
/area/lavaland/surface/outdoors)
"T" = (
/obj/structure/flora/rock/pile/style_random,
/turf/closed/mineral/random/high_chance/volcanic,
/area/lavaland/surface/outdoors)
"U" = (
/turf/closed/mineral/strong{
	base_icon_state = "smoothrocks";
	icon = 'modular_nova/modules/liquids/icons/turf/smoothrocks.dmi';
	icon_state = "smoothrocks-55"
	},
/area/lavaland/surface/outdoors)
"V" = (
/obj/effect/spawner/random/mob/necropolis_mob,
/obj/effect/spawner/random/structure/orevein_longregen,
/turf/closed/mineral/random/high_chance/volcanic,
/area/lavaland/surface/outdoors)
"X" = (
/obj/effect/spawner/random/structure/orevein_longregen,
/turf/closed/mineral/random/high_chance/volcanic,
/area/lavaland/surface/outdoors)

(1,1,1) = {"
a
a
a
a
a
a
a
a
a
a
a
z
z
z
z
a
"}
(2,1,1) = {"
a
a
a
a
a
a
a
z
a
a
U
U
S
M
z
z
"}
(3,1,1) = {"
a
a
a
a
a
a
a
z
a
U
U
M
s
n
S
z
"}
(4,1,1) = {"
z
a
z
z
z
a
a
z
a
e
n
M
V
X
X
z
"}
(5,1,1) = {"
z
U
U
n
z
z
a
z
z
z
n
X
X
r
n
z
"}
(6,1,1) = {"
z
U
M
n
T
z
a
a
a
U
M
X
S
X
n
z
"}
(7,1,1) = {"
z
M
n
n
M
z
U
a
a
U
U
M
X
X
n
z
"}
(8,1,1) = {"
z
M
E
X
n
X
U
a
a
z
z
z
X
w
S
z
"}
(9,1,1) = {"
z
M
n
X
M
n
U
a
a
a
a
z
M
X
T
U
"}
(10,1,1) = {"
z
n
s
M
w
X
z
z
z
a
a
z
S
n
X
U
"}
(11,1,1) = {"
z
M
n
r
X
s
z
a
a
a
a
z
U
M
S
U
"}
(12,1,1) = {"
z
M
X
M
n
n
z
a
a
a
a
a
U
S
U
U
"}
(13,1,1) = {"
z
U
n
X
M
S
z
a
a
a
a
a
z
z
z
a
"}
(14,1,1) = {"
z
U
S
n
s
U
U
a
a
a
a
a
a
a
a
a
"}
(15,1,1) = {"
a
U
U
M
U
U
a
a
a
a
a
a
a
a
a
a
"}
(16,1,1) = {"
a
a
z
z
z
z
z
z
z
a
a
a
a
a
a
a
"}
