//MAP CONVERTED BY dmm2tgm.py THIS HEADER COMMENT PREVENTS RECONVERSION, DO NOT REMOVE
"ai" = (
/mob/living/basic/mining/watcher,
/obj/structure/stone_tile/slab,
/turf/open/misc/asteroid/basalt/lava_land_surface,
/area/ruin/unpowered)
"bY" = (
/obj/structure/stone_tile/block,
/turf/open/misc/asteroid/basalt/lava_land_surface,
/area/lavaland/surface/outdoors)
"cE" = (
/obj/structure/stone_tile,
/obj/structure/stone_tile{
	dir = 1
	},
/obj/structure/stone_tile/burnt{
	dir = 4
	},
/turf/open/lava/smooth/lava_land_surface,
/area/ruin/unpowered)
"dj" = (
/obj/structure/stone_tile/block/cracked,
/obj/structure/stone_tile/block{
	dir = 1
	},
/turf/open/lava/smooth/lava_land_surface,
/area/ruin/unpowered)
"ea" = (
/obj/item/claymore,
/turf/closed/mineral/random/high_chance/volcanic,
/area/ruin/unpowered)
"ew" = (
/obj/structure/stone_tile/slab,
/obj/item/spear/bonespear,
/turf/closed/mineral/random/high_chance/volcanic,
/area/lavaland/surface/outdoors)
"eV" = (
/obj/structure/stone_tile/burnt{
	dir = 4
	},
/obj/structure/stone_tile/burnt{
	dir = 1
	},
/obj/structure/stone_tile,
/obj/structure/stone_tile{
	dir = 8
	},
/turf/open/lava/smooth/lava_land_surface,
/area/ruin/unpowered)
"fx" = (
/obj/structure/stone_tile/block{
	dir = 1
	},
/turf/closed/mineral/volcanic/lava_land_surface,
/area/lavaland/surface/outdoors)
"fy" = (
/obj/structure/stone_tile/slab,
/obj/structure/millstone,
/turf/closed/mineral/random/high_chance/volcanic,
/area/lavaland/surface/outdoors)
"fY" = (
/mob/living/basic/mining/legion,
/turf/closed/mineral/random/high_chance/volcanic,
/area/lavaland/surface/outdoors)
"hj" = (
/obj/structure/stone_tile/burnt,
/turf/open/lava/smooth/lava_land_surface,
/area/lavaland/surface/outdoors)
"hW" = (
/obj/structure/stone_tile,
/obj/structure/stone_tile{
	dir = 4
	},
/obj/structure/stone_tile{
	dir = 8
	},
/obj/structure/stone_tile{
	dir = 1
	},
/turf/closed/mineral/volcanic/lava_land_surface,
/area/lavaland/surface/outdoors)
"jh" = (
/obj/structure/stone_tile/block,
/obj/structure/punji_sticks/spikes,
/turf/closed/mineral/random/high_chance/volcanic,
/area/lavaland/surface/outdoors)
"jt" = (
/obj/structure/stone_tile/burnt,
/turf/open/lava/smooth/lava_land_surface,
/area/ruin/unpowered)
"jX" = (
/obj/structure/large_mortar,
/turf/closed/mineral/volcanic/lava_land_surface,
/area/lavaland/surface/outdoors)
"ku" = (
/obj/structure/stone_tile,
/obj/structure/stone_tile{
	dir = 4
	},
/obj/structure/stone_tile{
	dir = 8
	},
/obj/structure/stone_tile{
	dir = 1
	},
/turf/open/misc/asteroid/basalt/lava_land_surface,
/area/ruin/unpowered)
"ld" = (
/obj/structure/stone_tile/block,
/turf/closed/mineral/volcanic/lava_land_surface,
/area/lavaland/surface/outdoors)
"ls" = (
/turf/open/lava/smooth/lava_land_surface,
/area/lavaland/surface/outdoors)
"lH" = (
/obj/structure/punji_sticks/spikes,
/turf/closed/mineral/volcanic/lava_land_surface,
/area/ruin/unpowered)
"lK" = (
/obj/structure/stone_tile{
	dir = 1
	},
/turf/open/lava/smooth/lava_land_surface,
/area/ruin/unpowered)
"mJ" = (
/obj/structure/flora/ash/cacti,
/turf/open/misc/asteroid/basalt/lava_land_surface,
/area/lavaland/surface/outdoors)
"nl" = (
/obj/structure/stone_tile/slab,
/obj/structure/necropolis_gate/locked,
/turf/open/misc/asteroid/basalt/lava_land_surface,
/area/ruin/unpowered)
"oj" = (
/obj/structure/stone_tile/slab,
/turf/closed/mineral/random/high_chance/volcanic,
/area/lavaland/surface/outdoors)
"oK" = (
/obj/structure/stone_tile/slab/cracked{
	dir = 5
	},
/obj/structure/stone_tile/slab/cracked{
	dir = 10
	},
/turf/open/lava/smooth/lava_land_surface,
/area/ruin/unpowered)
"oT" = (
/obj/structure/flora/ash/cap_shroom,
/turf/open/misc/asteroid/basalt/lava_land_surface,
/area/lavaland/surface/outdoors)
"oZ" = (
/obj/effect/mapping_helpers/bombable_wall,
/turf/closed/indestructible/riveted/boss/wasteland,
/area/lavaland/surface/outdoors)
"pg" = (
/obj/structure/punji_sticks/spikes,
/turf/closed/mineral/volcanic/lava_land_surface,
/area/lavaland/surface/outdoors)
"qO" = (
/obj/structure/stone_tile/block/cracked,
/obj/structure/stone_tile{
	dir = 1
	},
/turf/open/lava/smooth/lava_land_surface,
/area/ruin/unpowered)
"qP" = (
/obj/structure/stone_tile/slab,
/obj/item/fireaxe/boneaxe,
/turf/closed/mineral/random/high_chance/volcanic,
/area/lavaland/surface/outdoors)
"rh" = (
/obj/item/reagent_containers/cup/glass/drinkingglass/filled/nuka_cola{
	name = "Mountain Dew"
	},
/turf/closed/mineral/volcanic/lava_land_surface,
/area/ruin/unpowered)
"rt" = (
/obj/structure/flora/rock/pile/style_random,
/turf/closed/mineral/random/high_chance/volcanic,
/area/lavaland/surface/outdoors)
"sS" = (
/obj/structure/stone_tile/slab,
/turf/closed/mineral/volcanic/lava_land_surface,
/area/lavaland/surface/outdoors)
"sW" = (
/obj/structure/stone_tile/block/cracked,
/turf/open/lava/smooth/lava_land_surface,
/area/ruin/unpowered)
"tw" = (
/obj/structure/stone_tile/block,
/obj/structure/stone_tile/block/burnt{
	dir = 1
	},
/turf/open/lava/smooth/lava_land_surface,
/area/ruin/unpowered)
"tC" = (
/obj/structure/stone_tile/block/cracked{
	dir = 1
	},
/obj/structure/stone_tile/burnt,
/turf/open/lava/smooth/lava_land_surface,
/area/ruin/unpowered)
"ub" = (
/obj/structure/stone_tile/slab,
/turf/open/misc/asteroid/basalt/lava_land_surface,
/area/lavaland/surface/outdoors)
"uq" = (
/turf/open/misc/asteroid/basalt/lava_land_surface,
/area/lavaland/surface/outdoors)
"uP" = (
/turf/open/lava/smooth/lava_land_surface,
/area/ruin/unpowered)
"uV" = (
/obj/structure/flora/ash/cacti,
/turf/closed/mineral/volcanic/lava_land_surface,
/area/lavaland/surface/outdoors)
"ve" = (
/obj/structure/stone_tile/slab,
/mob/living/basic/mining/legion/dwarf,
/turf/closed/mineral/volcanic/lava_land_surface,
/area/lavaland/surface/outdoors)
"vf" = (
/obj/item/ammo_casing/arrow/bone,
/turf/closed/mineral/volcanic/lava_land_surface,
/area/lavaland/surface/outdoors)
"vT" = (
/obj/structure/stone_tile/slab,
/turf/closed/mineral/volcanic/lava_land_surface,
/area/ruin/unpowered)
"wT" = (
/obj/item/organ/external/spines,
/turf/closed/mineral/random/high_chance/volcanic,
/area/lavaland/surface/outdoors)
"ye" = (
/obj/structure/stone_tile/slab,
/obj/structure/closet/crate/wooden/storage_barrel,
/turf/closed/mineral/volcanic/lava_land_surface,
/area/lavaland/surface/outdoors)
"yf" = (
/turf/closed/mineral/volcanic/lava_land_surface,
/area/lavaland/surface/outdoors)
"yp" = (
/obj/structure/stone_tile/slab/cracked,
/turf/open/lava/smooth/lava_land_surface,
/area/ruin/unpowered)
"yJ" = (
/obj/structure/flora/ash/leaf_shroom,
/turf/closed/mineral/volcanic/lava_land_surface,
/area/ruin/unpowered)
"yN" = (
/obj/structure/punji_sticks/spikes,
/turf/closed/mineral/random/high_chance/volcanic,
/area/lavaland/surface/outdoors)
"Aa" = (
/obj/structure/stone_tile/block/cracked{
	dir = 1
	},
/obj/structure/stone_tile/burnt{
	dir = 8
	},
/turf/open/lava/smooth/lava_land_surface,
/area/ruin/unpowered)
"AA" = (
/turf/closed/mineral/random/high_chance/volcanic,
/area/lavaland/surface/outdoors)
"AY" = (
/mob/living/basic/mining/watcher/magmawing,
/obj/structure/stone_tile/slab,
/turf/open/lava/smooth/lava_land_surface,
/area/ruin/unpowered)
"DM" = (
/turf/closed/indestructible/riveted/boss,
/area/lavaland/surface/outdoors)
"EL" = (
/obj/structure/flora/rock/style_random,
/turf/open/misc/asteroid/basalt/lava_land_surface,
/area/lavaland/surface/outdoors)
"Gi" = (
/obj/structure/stone_tile/slab,
/turf/closed/mineral/random/high_chance/volcanic,
/area/ruin/unpowered)
"GR" = (
/obj/structure/stone_tile/burnt{
	dir = 8
	},
/turf/open/lava/smooth/lava_land_surface,
/area/ruin/unpowered)
"Hd" = (
/obj/item/stack/sheet/bone,
/turf/closed/mineral/random/high_chance/volcanic,
/area/lavaland/surface/outdoors)
"HX" = (
/obj/structure/stone_tile/block{
	dir = 1
	},
/turf/closed/mineral/random/high_chance/volcanic,
/area/lavaland/surface/outdoors)
"Il" = (
/obj/structure/stone_tile/burnt{
	dir = 1
	},
/turf/closed/mineral/volcanic/lava_land_surface,
/area/lavaland/surface/outdoors)
"JK" = (
/obj/structure/stone_tile{
	dir = 4
	},
/turf/closed/mineral/volcanic/lava_land_surface,
/area/lavaland/surface/outdoors)
"KX" = (
/turf/template_noop,
/area/template_noop)
"Lt" = (
/turf/closed/indestructible/riveted/boss,
/area/ruin/unpowered)
"LA" = (
/obj/structure/stone_tile/slab/cracked{
	dir = 4
	},
/obj/structure/stone_tile/slab/cracked{
	dir = 8
	},
/turf/open/lava/smooth/lava_land_surface,
/area/ruin/unpowered)
"LB" = (
/obj/structure/flora/rock/pile/style_random,
/turf/open/misc/asteroid/basalt/lava_land_surface,
/area/lavaland/surface/outdoors)
"MJ" = (
/obj/structure/flora/rock/pile/style_random,
/turf/closed/mineral/volcanic/lava_land_surface,
/area/lavaland/surface/outdoors)
"MR" = (
/obj/structure/flora/ash/tall_shroom,
/obj/item/food/grown/mushroom/amanita,
/turf/closed/mineral/volcanic/lava_land_surface,
/area/lavaland/surface/outdoors)
"Ou" = (
/obj/structure/stone_tile/slab,
/obj/item/stack/sheet/bone,
/turf/closed/mineral/random/high_chance/volcanic,
/area/lavaland/surface/outdoors)
"Pl" = (
/obj/structure/flora/ash/stem_shroom,
/turf/closed/mineral/volcanic/lava_land_surface,
/area/lavaland/surface/outdoors)
"Rh" = (
/obj/structure/stone_tile/slab/cracked{
	dir = 4
	},
/obj/structure/stone_tile/slab/cracked{
	dir = 8
	},
/obj/structure/stone_tile/slab/cracked{
	dir = 1
	},
/turf/open/lava/smooth/lava_land_surface,
/area/ruin/unpowered)
"Tv" = (
/obj/structure/stone_tile/slab,
/turf/open/misc/asteroid/basalt/lava_land_surface,
/area/ruin/unpowered)
"TE" = (
/obj/structure/flora/rock/pile/style_random,
/turf/closed/mineral/volcanic/lava_land_surface,
/area/ruin/unpowered)
"Ue" = (
/obj/structure/stone_tile/slab,
/obj/structure/closet/crate/necropolis,
/obj/item/organ/internal/eyes/night_vision/ashwalker,
/turf/closed/mineral/volcanic/lava_land_surface,
/area/lavaland/surface/outdoors)
"Uh" = (
/obj/structure/stone_tile/block/burnt{
	dir = 8
	},
/turf/open/lava/smooth/lava_land_surface,
/area/ruin/unpowered)
"UP" = (
/obj/structure/stone_tile/slab/cracked{
	dir = 5
	},
/turf/open/lava/smooth/lava_land_surface,
/area/ruin/unpowered)
"Vv" = (
/obj/structure/stone_tile/block,
/turf/closed/mineral/random/high_chance/volcanic,
/area/lavaland/surface/outdoors)
"WP" = (
/mob/living/basic/mining/watcher,
/obj/structure/stone_tile/slab,
/turf/open/lava/smooth/lava_land_surface,
/area/ruin/unpowered)
"XW" = (
/obj/structure/stone_tile/block/cracked{
	dir = 1
	},
/obj/structure/stone_tile/block,
/turf/open/lava/smooth/lava_land_surface,
/area/ruin/unpowered)
"Yj" = (
/obj/structure/stone_tile/block/cracked{
	dir = 1
	},
/turf/open/lava/smooth/lava_land_surface,
/area/ruin/unpowered)
"ZX" = (
/obj/structure/stone_tile/slab,
/turf/open/lava/smooth/lava_land_surface,
/area/ruin/unpowered)

(1,1,1) = {"
KX
KX
KX
pg
yf
MJ
KX
KX
yf
yf
yf
yf
pg
KX
KX
KX
"}
(2,1,1) = {"
KX
KX
KX
JK
DM
DM
DM
Lt
Lt
yp
yf
DM
DM
yf
KX
KX
"}
(3,1,1) = {"
KX
KX
KX
eV
sS
oZ
ew
yf
Lt
dj
KX
DM
ye
vf
KX
KX
"}
(4,1,1) = {"
KX
KX
KX
ZX
Pl
DM
oj
ve
hW
KX
KX
hW
oj
AA
pg
KX
"}
(5,1,1) = {"
KX
KX
KX
ZX
rh
DM
uV
Ou
Lt
ZX
KX
Lt
sS
oj
DM
yf
"}
(6,1,1) = {"
KX
pg
KX
Yj
Lt
DM
DM
DM
Lt
lK
ZX
Lt
DM
rt
DM
DM
"}
(7,1,1) = {"
yf
fx
KX
ZX
ZX
MJ
oj
Ue
Lt
uP
cE
Lt
wT
oj
DM
ld
"}
(8,1,1) = {"
DM
fx
KX
yp
ZX
DM
oj
rt
sW
uP
uP
ku
Ou
sS
DM
bY
"}
(9,1,1) = {"
KX
fx
DM
uP
yf
DM
qP
MR
Lt
jt
oK
Lt
fy
pg
DM
LB
"}
(10,1,1) = {"
KX
fx
DM
Aa
DM
Lt
Lt
Lt
Lt
ai
Gi
Lt
DM
pg
DM
bY
"}
(11,1,1) = {"
yf
fx
KX
KX
rt
AA
uP
Rh
ZX
Tv
Gi
oj
ub
ub
oZ
ld
"}
(12,1,1) = {"
MJ
yf
KX
KX
ZX
AA
AA
TE
jt
uP
tC
ub
KX
KX
DM
ld
"}
(13,1,1) = {"
yf
pg
DM
WP
ZX
Lt
Lt
uP
DM
DM
DM
DM
KX
DM
DM
jh
"}
(14,1,1) = {"
yf
HX
DM
ZX
yp
Lt
qO
uP
EL
DM
DM
hj
KX
LB
DM
Vv
"}
(15,1,1) = {"
DM
HX
oZ
KX
yJ
Lt
sW
uP
LA
uq
ls
ls
ls
mJ
DM
yf
"}
(16,1,1) = {"
DM
HX
DM
lH
Lt
Lt
Lt
GR
ZX
ZX
yp
ZX
XW
Lt
Lt
yf
"}
(17,1,1) = {"
pg
HX
DM
KX
KX
vT
vT
ZX
ZX
AY
ZX
ZX
ZX
Tv
nl
yf
"}
(18,1,1) = {"
yf
yf
DM
KX
Lt
Lt
Lt
Il
ZX
Tv
ZX
ZX
tw
Lt
Lt
yf
"}
(19,1,1) = {"
yf
pg
yf
KX
KX
Lt
ea
Hd
MJ
oT
uP
uP
uP
UP
DM
pg
"}
(20,1,1) = {"
yf
yf
AA
KX
Yj
Lt
ls
rt
AA
DM
Lt
sW
uP
uP
yf
yf
"}
(21,1,1) = {"
yf
AA
yN
ZX
ZX
Lt
DM
DM
DM
DM
mJ
KX
Uh
Lt
yf
KX
"}
(22,1,1) = {"
yf
pg
yf
sW
oK
ZX
jX
DM
oj
sS
sS
KX
KX
KX
yf
KX
"}
(23,1,1) = {"
KX
yf
yf
uP
uP
yp
yf
fY
yN
DM
DM
DM
DM
KX
KX
KX
"}
(24,1,1) = {"
KX
KX
yf
KX
KX
KX
KX
yf
KX
DM
pg
KX
KX
KX
KX
KX
"}
