//MAP CONVERTED BY dmm2tgm.py THIS HEADER COMMENT PREVENTS RECONVERSION, DO NOT REMOVE
"aq" = (
/obj/structure/stone_tile/block/cracked{
	dir = 1
	},
/turf/closed/mineral/volcanic/lava_land_surface,
/area/lavaland/surface/outdoors)
"bo" = (
/obj/structure/stone_tile/slab,
/obj/item/clothing/head/hooded/cloakhood/drake,
/turf/closed/mineral/random/high_chance/volcanic,
/area/ruin/unpowered)
"bz" = (
/obj/structure/stone_tile/surrounding_tile{
	dir = 4
	},
/obj/structure/stone_tile/surrounding_tile,
/turf/closed/mineral/random/high_chance/volcanic,
/area/lavaland/surface/outdoors)
"cy" = (
/obj/structure/stone_tile/slab,
/turf/open/lava/smooth/lava_land_surface,
/area/lavaland/surface/outdoors)
"cD" = (
/obj/structure/stone_tile/block/cracked,
/turf/closed/mineral/random/high_chance/volcanic,
/area/lavaland/surface/outdoors)
"cM" = (
/obj/structure/stone_tile{
	dir = 1
	},
/obj/structure/stone_tile/surrounding_tile/cracked,
/turf/open/lava/smooth/lava_land_surface,
/area/lavaland/surface/outdoors)
"cS" = (
/obj/structure/stone_tile/block{
	dir = 4
	},
/obj/effect/spawner/random/entertainment/coin,
/turf/closed/mineral/random/high_chance/volcanic,
/area/lavaland/surface/outdoors)
"cU" = (
/obj/structure/stone_tile/block{
	dir = 8
	},
/turf/closed/mineral/random/high_chance/volcanic,
/area/lavaland/surface/outdoors)
"dk" = (
/obj/structure/stone_tile/block{
	dir = 1
	},
/turf/open/lava/smooth/lava_land_surface,
/area/lavaland/surface/outdoors)
"dt" = (
/obj/structure/stone_tile/block,
/obj/structure/stone_tile/block{
	dir = 1
	},
/turf/open/lava/smooth/lava_land_surface,
/area/lavaland/surface/outdoors)
"dA" = (
/obj/structure/sink/oil_well,
/turf/closed/mineral/volcanic/lava_land_surface,
/area/lavaland/surface/outdoors)
"dC" = (
/obj/structure/stone_tile/block,
/obj/effect/spawner/random/structure/spikes,
/turf/closed/mineral/random/high_chance/volcanic,
/area/lavaland/surface/outdoors)
"dW" = (
/obj/structure/stone_tile/surrounding/cracked,
/obj/effect/spawner/random/entertainment/coin,
/turf/closed/mineral/volcanic/lava_land_surface,
/area/lavaland/surface/outdoors)
"dZ" = (
/obj/structure/stone_tile/block,
/obj/structure/stone_tile/block{
	dir = 1
	},
/turf/closed/mineral/volcanic/lava_land_surface,
/area/lavaland/surface/outdoors)
"eO" = (
/obj/structure/stone_tile/block{
	dir = 1
	},
/obj/structure/stone_tile/block/cracked,
/turf/open/lava/smooth/lava_land_surface,
/area/lavaland/surface/outdoors)
"eT" = (
/obj/structure/stone_tile/block,
/obj/structure/stone_tile/block/cracked{
	dir = 1
	},
/turf/open/lava/smooth/lava_land_surface,
/area/lavaland/surface/outdoors)
"fz" = (
/obj/structure/stone_tile/slab,
/turf/closed/mineral/strong{
	base_icon_state = "smoothrocks";
	icon = 'modular_nova/modules/liquids/icons/turf/smoothrocks.dmi';
	icon_state = "smoothrocks-55"
	},
/area/ruin/unpowered)
"fA" = (
/obj/item/reagent_containers/cup/bowl/wood_bowl{
	pixel_x = -4;
	pixel_y = 6
	},
/obj/structure/stone_tile,
/turf/closed/mineral/random/high_chance/volcanic,
/area/lavaland/surface/outdoors)
"fE" = (
/obj/structure/stone_tile/surrounding,
/obj/structure/stone_tile/center,
/obj/structure/reagent_water_basin,
/turf/closed/mineral/random/high_chance/volcanic,
/area/ruin/unpowered)
"fO" = (
/obj/structure/flora/rock/pile/style_random,
/turf/closed/mineral/random/high_chance/volcanic,
/area/lavaland/surface/outdoors)
"fT" = (
/obj/structure/stone_tile/surrounding/cracked,
/obj/structure/stone_tile/center/burnt,
/turf/open/lava/smooth/lava_land_surface,
/area/lavaland/surface/outdoors)
"hb" = (
/obj/structure/millstone,
/obj/structure/stone_tile/surrounding,
/obj/structure/stone_tile/center,
/turf/closed/mineral/random/high_chance/volcanic,
/area/ruin/unpowered)
"hv" = (
/obj/structure/stone_tile/surrounding/burnt,
/obj/structure/stone_tile/center,
/mob/living/basic/mining/ancient_demon,
/turf/closed/mineral/random/high_chance/volcanic,
/area/lavaland/surface/outdoors)
"ip" = (
/obj/item/reagent_containers/cup/mortar{
	pixel_y = 12;
	pixel_x = -10
	},
/obj/structure/stone_tile{
	dir = 8
	},
/turf/closed/mineral/volcanic/lava_land_surface,
/area/lavaland/surface/outdoors)
"iE" = (
/obj/structure/stone_tile/slab,
/mob/living/basic/mining/ancient_demon,
/turf/closed/mineral/random/high_chance/volcanic,
/area/ruin/unpowered)
"iW" = (
/obj/structure/stone_tile/center/burnt,
/obj/structure/stone_tile/surrounding/cracked{
	dir = 1
	},
/obj/item/xenoarch/useless_relic{
	name = "Ancient relic";
	desc = "Sort of relic that can be exported through Cargo."
	},
/turf/closed/mineral/volcanic/lava_land_surface,
/area/lavaland/surface/outdoors)
"iX" = (
/obj/structure/stone_tile/slab/burnt,
/obj/effect/decal/cleanable/dirt,
/turf/open/misc/asteroid/basalt/lava_land_surface,
/area/lavaland/surface/outdoors)
"jD" = (
/obj/structure/stone_tile,
/obj/structure/stone_tile{
	dir = 1
	},
/obj/structure/stone_tile{
	dir = 8
	},
/obj/structure/stone_tile{
	dir = 4
	},
/turf/closed/mineral/random/high_chance/volcanic,
/area/lavaland/surface/outdoors)
"jE" = (
/obj/structure/stone_tile{
	dir = 4
	},
/turf/open/lava/smooth/lava_land_surface,
/area/lavaland/surface/outdoors)
"jZ" = (
/obj/structure/stone_tile,
/obj/structure/stone_tile/surrounding_tile/cracked{
	dir = 8
	},
/turf/open/lava/smooth/lava_land_surface,
/area/lavaland/surface/outdoors)
"kJ" = (
/obj/structure/stone_tile{
	dir = 8
	},
/turf/closed/mineral/random/high_chance/volcanic,
/area/lavaland/surface/outdoors)
"kP" = (
/obj/structure/table/wood,
/obj/item/reagent_containers/cup/primitive_centrifuge{
	pixel_x = -14;
	pixel_y = -1
	},
/obj/item/reagent_containers/cup/glass/bottle/small{
	pixel_x = 7;
	pixel_y = 12
	},
/obj/item/reagent_containers/cup/glass/bottle/small{
	pixel_x = 3;
	pixel_y = 5
	},
/obj/structure/stone_tile/surrounding,
/obj/structure/stone_tile/center,
/turf/closed/mineral/volcanic/lava_land_surface,
/area/ruin/unpowered)
"lq" = (
/obj/structure/stone_tile/slab/cracked{
	dir = 4
	},
/obj/structure/stone_tile/slab/cracked{
	dir = 8
	},
/turf/closed/mineral/random/high_chance/volcanic,
/area/lavaland/surface/outdoors)
"lQ" = (
/obj/structure/stone_tile,
/obj/structure/stone_tile{
	dir = 1
	},
/obj/structure/stone_tile{
	dir = 8
	},
/obj/structure/stone_tile{
	dir = 4
	},
/obj/item/xenoarch/useless_relic{
	name = "Ancient relic";
	desc = "Sort of relic that can be exported through Cargo."
	},
/turf/closed/mineral/random/high_chance/volcanic,
/area/lavaland/surface/outdoors)
"lW" = (
/obj/structure/stone_tile/surrounding_tile/burnt,
/turf/open/lava/smooth/lava_land_surface,
/area/lavaland/surface/outdoors)
"md" = (
/obj/structure/stone_tile/slab,
/turf/closed/mineral/volcanic/lava_land_surface,
/area/lavaland/surface/outdoors)
"mq" = (
/obj/structure/reagent_crafting_bench,
/obj/structure/stone_tile/surrounding,
/obj/structure/stone_tile/center,
/turf/closed/mineral/random/high_chance/volcanic,
/area/ruin/unpowered)
"mw" = (
/obj/structure/stone_tile/block/cracked{
	dir = 1
	},
/turf/open/lava/smooth/lava_land_surface,
/area/lavaland/surface/outdoors)
"mG" = (
/obj/structure/stone_tile/slab/cracked,
/turf/closed/mineral/random/high_chance/volcanic,
/area/lavaland/surface/outdoors)
"ng" = (
/obj/structure/stone_tile{
	dir = 4
	},
/turf/closed/mineral/random/high_chance/volcanic,
/area/lavaland/surface/outdoors)
"nm" = (
/obj/structure/stone_tile/surrounding_tile/cracked{
	dir = 1
	},
/obj/effect/gibspawner/human/bodypartless,
/mob/living/basic/mining/ancient_demon,
/turf/open/indestructible/necropolis,
/area/ruin/unpowered)
"og" = (
/obj/structure/reagent_anvil,
/obj/structure/stone_tile/surrounding,
/obj/structure/stone_tile/center,
/obj/item/xenoarch/useless_relic/magnified{
	name = "Ancient relic";
	desc = "Sort of relic that can be exported through Cargo."
	},
/turf/closed/mineral/random/high_chance/volcanic,
/area/ruin/unpowered)
"oQ" = (
/obj/effect/mapping_helpers/bombable_wall,
/turf/closed/indestructible/riveted/boss/wasteland,
/area/ruin/unpowered)
"pF" = (
/turf/closed/mineral/random/high_chance/volcanic,
/area/lavaland/surface/outdoors)
"pH" = (
/obj/structure/stone_tile/surrounding,
/obj/structure/stone_tile/center,
/turf/closed/mineral/volcanic/lava_land_surface,
/area/lavaland/surface/outdoors)
"qc" = (
/obj/structure/stone_tile/block,
/obj/structure/stone_tile{
	dir = 1
	},
/turf/closed/mineral/random/high_chance/volcanic,
/area/lavaland/surface/outdoors)
"qQ" = (
/obj/structure/stone_tile/slab,
/obj/item/stack/ore/iron,
/obj/item/stack/ore/iron{
	pixel_y = 7;
	pixel_x = 12
	},
/obj/effect/spawner/random/entertainment/drugs,
/turf/closed/mineral/random/high_chance/volcanic,
/area/ruin/unpowered)
"rb" = (
/obj/structure/stone_tile/block,
/obj/structure/stone_tile{
	dir = 1
	},
/turf/closed/mineral/volcanic/lava_land_surface,
/area/lavaland/surface/outdoors)
"re" = (
/obj/structure/stone_tile/surrounding,
/obj/structure/stone_tile/center/cracked,
/turf/open/lava/smooth/lava_land_surface,
/area/lavaland/surface/outdoors)
"ro" = (
/obj/structure/stone_tile{
	dir = 8
	},
/turf/closed/mineral/volcanic/lava_land_surface,
/area/lavaland/surface/outdoors)
"rQ" = (
/obj/structure/stone_tile/surrounding_tile/cracked{
	dir = 8
	},
/turf/open/lava/smooth/lava_land_surface,
/area/lavaland/surface/outdoors)
"sa" = (
/obj/structure/stone_tile/slab/burnt,
/obj/item/reagent_containers/cup/bowl/wood_bowl,
/turf/closed/mineral/random/high_chance/volcanic,
/area/lavaland/surface/outdoors)
"sQ" = (
/obj/structure/stone_tile{
	dir = 1
	},
/turf/closed/mineral/volcanic/lava_land_surface,
/area/lavaland/surface/outdoors)
"tr" = (
/obj/structure/stone_tile/surrounding/burnt,
/turf/closed/mineral/volcanic/lava_land_surface,
/area/lavaland/surface/outdoors)
"tv" = (
/obj/structure/stone_tile/surrounding/cracked{
	pixel_x = 1;
	pixel_y = -1
	},
/obj/effect/decal/cleanable/blood/gibs/down,
/obj/item/xenoarch/useless_relic/magnified{
	name = "Ancient relic";
	desc = "Sort of relic that can be exported through Cargo."
	},
/turf/open/indestructible/necropolis,
/area/ruin/unpowered)
"tA" = (
/obj/item/forging/billow/primitive,
/obj/structure/stone_tile/surrounding,
/obj/structure/stone_tile/center,
/obj/item/stack/ore/iron{
	pixel_y = -17;
	pixel_x = 10
	},
/turf/closed/mineral/volcanic/lava_land_surface,
/area/ruin/unpowered)
"tD" = (
/obj/structure/stone_tile{
	dir = 1
	},
/obj/structure/stone_tile{
	dir = 8
	},
/obj/structure/stone_tile{
	dir = 4
	},
/turf/open/lava/smooth/lava_land_surface,
/area/lavaland/surface/outdoors)
"tG" = (
/obj/structure/stone_tile/burnt{
	dir = 1
	},
/turf/closed/mineral/volcanic/lava_land_surface,
/area/lavaland/surface/outdoors)
"ub" = (
/obj/structure/stone_tile/slab/cracked{
	dir = 1
	},
/obj/structure/stone_tile/surrounding_tile/cracked,
/turf/open/lava/smooth/lava_land_surface,
/area/lavaland/surface/outdoors)
"us" = (
/obj/effect/spawner/random/structure/spikes,
/turf/closed/mineral/random/high_chance/volcanic,
/area/lavaland/surface/outdoors)
"ut" = (
/obj/effect/spawner/random/structure/spikes,
/turf/closed/mineral/volcanic/lava_land_surface,
/area/lavaland/surface/outdoors)
"uS" = (
/obj/structure/flora/rock/pile/style_random,
/obj/effect/spawner/random/structure/spikes,
/turf/closed/mineral/random/high_chance/volcanic,
/area/lavaland/surface/outdoors)
"vo" = (
/obj/structure/stone_tile/surrounding/burnt,
/obj/structure/stone_tile/center/cracked,
/turf/open/lava/smooth/lava_land_surface,
/area/lavaland/surface/outdoors)
"vt" = (
/obj/structure/large_mortar,
/obj/item/pestle,
/obj/structure/stone_tile/surrounding,
/obj/structure/stone_tile/center,
/obj/structure/table/wood,
/turf/closed/mineral/random/high_chance/volcanic,
/area/ruin/unpowered)
"vG" = (
/obj/structure/stone_tile/surrounding,
/obj/structure/stone_tile/center/burnt,
/turf/open/lava/smooth/lava_land_surface,
/area/lavaland/surface/outdoors)
"vN" = (
/obj/structure/stone_tile{
	dir = 8
	},
/obj/effect/spawner/random/structure/spikes,
/turf/closed/mineral/volcanic/lava_land_surface,
/area/lavaland/surface/outdoors)
"vT" = (
/obj/structure/reagent_forge,
/obj/item/stack/sheet/mineral/coal/ten{
	pixel_y = -12
	},
/obj/structure/stone_tile/surrounding,
/obj/structure/stone_tile/center,
/turf/closed/mineral/volcanic/lava_land_surface,
/area/ruin/unpowered)
"wa" = (
/turf/closed/indestructible/riveted/boss,
/area/ruin/unpowered)
"wI" = (
/obj/structure/stone_tile{
	dir = 8
	},
/obj/structure/stone_tile/burnt{
	dir = 1
	},
/turf/closed/mineral/volcanic/lava_land_surface,
/area/lavaland/surface/outdoors)
"wN" = (
/obj/structure/stone_tile/surrounding_tile{
	dir = 8
	},
/obj/structure/stone_tile/surrounding_tile{
	dir = 1
	},
/turf/closed/mineral/random/high_chance/volcanic,
/area/lavaland/surface/outdoors)
"xl" = (
/obj/structure/stone_tile/block{
	dir = 8
	},
/turf/closed/mineral/volcanic/lava_land_surface,
/area/lavaland/surface/outdoors)
"yo" = (
/obj/structure/stone_tile/slab,
/obj/item/crowbar/ashwalker,
/turf/closed/mineral/volcanic/lava_land_surface,
/area/ruin/unpowered)
"yC" = (
/obj/structure/stone_tile/surrounding/cracked,
/obj/structure/stone_tile/center/burnt,
/turf/closed/mineral/volcanic/lava_land_surface,
/area/lavaland/surface/outdoors)
"yJ" = (
/obj/structure/stone_tile/slab,
/obj/item/stack/ore/iron{
	pixel_y = 5;
	pixel_x = -10
	},
/obj/item/forging/hammer/primitive,
/turf/closed/mineral/random/high_chance/volcanic,
/area/ruin/unpowered)
"Ai" = (
/obj/structure/stone_tile/block{
	dir = 4
	},
/turf/closed/mineral/volcanic/lava_land_surface,
/area/lavaland/surface/outdoors)
"Ap" = (
/obj/structure/stone_tile/slab/burnt,
/turf/closed/mineral/random/high_chance/volcanic,
/area/lavaland/surface/outdoors)
"BK" = (
/obj/structure/stone_tile/surrounding/cracked{
	dir = 4
	},
/turf/closed/mineral/volcanic/lava_land_surface,
/area/lavaland/surface/outdoors)
"BP" = (
/obj/structure/flora/rock/pile/style_random,
/obj/effect/spawner/random/structure/spikes,
/turf/open/misc/asteroid/basalt/lava_land_surface,
/area/lavaland/surface/outdoors)
"BS" = (
/obj/structure/stone_tile/slab,
/obj/item/reagent_containers/cup/bowl/wood_bowl{
	pixel_x = -9;
	pixel_y = -6
	},
/turf/open/lava/smooth/lava_land_surface,
/area/lavaland/surface/outdoors)
"BT" = (
/obj/structure/stone_tile{
	dir = 8
	},
/turf/open/lava/smooth/lava_land_surface,
/area/lavaland/surface/outdoors)
"Cf" = (
/obj/structure/stone_tile/surrounding_tile/cracked{
	dir = 8
	},
/mob/living/basic/mining/ancient_demon/ancient_demon_lesser,
/turf/open/indestructible/necropolis,
/area/ruin/unpowered)
"Ch" = (
/obj/item/knife/combat/bone{
	pixel_y = 8
	},
/obj/structure/stone_tile/surrounding,
/obj/structure/stone_tile/center,
/obj/effect/spawner/random/medical/minor_healing,
/turf/closed/mineral/random/high_chance/volcanic,
/area/ruin/unpowered)
"CA" = (
/obj/structure/stone_tile/block,
/obj/structure/stone_tile/cracked{
	dir = 4
	},
/obj/structure/stone_tile{
	dir = 1
	},
/turf/closed/mineral/volcanic/lava_land_surface,
/area/lavaland/surface/outdoors)
"CK" = (
/obj/structure/stone_tile/slab,
/turf/closed/mineral/random/high_chance/volcanic,
/area/lavaland/surface/outdoors)
"Dq" = (
/obj/structure/stone_tile/block,
/obj/structure/stone_tile/block{
	dir = 1
	},
/turf/closed/mineral/random/high_chance/volcanic,
/area/lavaland/surface/outdoors)
"Ds" = (
/obj/structure/stone_tile/slab/cracked,
/turf/open/lava/smooth/lava_land_surface,
/area/lavaland/surface/outdoors)
"DI" = (
/obj/structure/stone_tile/surrounding_tile{
	dir = 1
	},
/obj/structure/stone_tile/surrounding_tile{
	dir = 8
	},
/turf/closed/mineral/volcanic/lava_land_surface,
/area/lavaland/surface/outdoors)
"DL" = (
/obj/structure/stone_tile/slab/burnt,
/mob/living/basic/mining/ancient_demon/ancient_demon_lesser,
/turf/closed/mineral/volcanic/lava_land_surface,
/area/lavaland/surface/outdoors)
"Ef" = (
/obj/structure/stone_tile/slab/burnt,
/obj/item/ceramic/bowl,
/turf/closed/mineral/volcanic/lava_land_surface,
/area/lavaland/surface/outdoors)
"Ej" = (
/obj/structure/stone_tile/surrounding/cracked{
	dir = 1
	},
/obj/structure/stone_tile/surrounding_tile/cracked{
	dir = 5
	},
/obj/effect/decal/cleanable/blood/gibs/up,
/turf/open/indestructible/necropolis,
/area/ruin/unpowered)
"Em" = (
/obj/structure/stone_tile,
/obj/effect/spawner/random/structure/spikes,
/turf/closed/mineral/random/high_chance/volcanic,
/area/lavaland/surface/outdoors)
"Ey" = (
/obj/structure/stone_tile/block/cracked{
	dir = 1
	},
/obj/structure/stone_tile/block,
/obj/item/xenoarch/useless_relic{
	name = "Ancient relic";
	desc = "Sort of relic that can be exported through Cargo."
	},
/turf/closed/mineral/random/high_chance/volcanic,
/area/lavaland/surface/outdoors)
"Fg" = (
/obj/structure/stone_tile/slab,
/obj/item/reagent_containers/syringe/crude{
	pixel_x = 2;
	pixel_y = 15
	},
/turf/closed/mineral/volcanic/lava_land_surface,
/area/lavaland/surface/outdoors)
"FA" = (
/obj/structure/stone_tile/block/cracked{
	dir = 1
	},
/obj/structure/stone_tile/block,
/turf/open/lava/smooth/lava_land_surface,
/area/lavaland/surface/outdoors)
"FC" = (
/obj/structure/stone_tile/surrounding,
/obj/structure/stone_tile/center,
/turf/open/lava/smooth/lava_land_surface,
/area/lavaland/surface/outdoors)
"Ge" = (
/obj/structure/stone_tile/surrounding_tile/burnt{
	dir = 4
	},
/turf/open/lava/smooth/lava_land_surface,
/area/lavaland/surface/outdoors)
"Gp" = (
/obj/structure/stone_tile/surrounding/cracked,
/turf/closed/mineral/random/high_chance/volcanic,
/area/lavaland/surface/outdoors)
"Gr" = (
/obj/structure/stone_tile/surrounding/cracked{
	dir = 8
	},
/obj/effect/spawner/random/exotic/antag_gear_weak,
/obj/item/stack/sheet/runed_metal/five,
/turf/closed/mineral/volcanic/lava_land_surface,
/area/ruin/unpowered)
"GT" = (
/obj/structure/stone_tile/block,
/obj/effect/spawner/random/structure/spikes,
/turf/closed/mineral/volcanic/lava_land_surface,
/area/lavaland/surface/outdoors)
"Hm" = (
/obj/structure/stone_tile/surrounding_tile/cracked{
	dir = 4
	},
/turf/open/lava/smooth/lava_land_surface,
/area/lavaland/surface/outdoors)
"Hu" = (
/obj/structure/stone_tile/block/burnt,
/obj/structure/stone_tile/burnt{
	dir = 4
	},
/obj/structure/stone_tile/cracked{
	dir = 1
	},
/turf/closed/mineral/volcanic/lava_land_surface,
/area/lavaland/surface/outdoors)
"HW" = (
/obj/structure/stone_tile/slab/cracked{
	dir = 4
	},
/turf/open/lava/smooth/lava_land_surface,
/area/lavaland/surface/outdoors)
"Iy" = (
/obj/structure/stone_tile/block,
/obj/structure/stone_tile/cracked{
	dir = 4
	},
/obj/structure/stone_tile{
	dir = 1
	},
/turf/open/lava/smooth/lava_land_surface,
/area/lavaland/surface/outdoors)
"II" = (
/obj/structure/stone_tile/center/burnt,
/obj/structure/stone_tile/surrounding/cracked{
	dir = 1
	},
/turf/closed/mineral/volcanic/lava_land_surface,
/area/lavaland/surface/outdoors)
"IK" = (
/obj/structure/flora/rock/pile/style_random,
/turf/closed/mineral/volcanic/lava_land_surface,
/area/lavaland/surface/outdoors)
"IQ" = (
/obj/structure/stone_tile/surrounding_tile,
/obj/structure/stone_tile/surrounding_tile{
	dir = 4
	},
/turf/closed/mineral/volcanic/lava_land_surface,
/area/lavaland/surface/outdoors)
"Ky" = (
/obj/structure/stone_tile/slab,
/turf/closed/mineral/volcanic/lava_land_surface,
/area/ruin/unpowered)
"KZ" = (
/obj/structure/stone_tile/slab,
/obj/item/reagent_containers/cup/bowl/mushroom_bowl{
	pixel_y = -3
	},
/turf/closed/mineral/random/high_chance/volcanic,
/area/lavaland/surface/outdoors)
"Le" = (
/obj/structure/stone_tile/slab/cracked,
/obj/effect/spawner/random/entertainment/coin,
/turf/closed/mineral/volcanic/lava_land_surface,
/area/lavaland/surface/outdoors)
"LW" = (
/obj/structure/stone_tile/surrounding,
/obj/structure/stone_tile/center,
/obj/item/smelling_salts{
	pixel_y = -9;
	pixel_x = 6
	},
/turf/closed/mineral/random/high_chance/volcanic,
/area/lavaland/surface/outdoors)
"Mm" = (
/obj/item/stack/sheet/iron/twenty,
/obj/structure/stone_tile/surrounding,
/obj/structure/stone_tile/center,
/turf/closed/mineral/volcanic/lava_land_surface,
/area/ruin/unpowered)
"MA" = (
/turf/template_noop,
/area/template_noop)
"MG" = (
/obj/structure/stone_tile/surrounding,
/obj/structure/stone_tile/center,
/obj/item/xenoarch/useless_relic{
	name = "Ancient relic";
	desc = "Sort of relic that can be exported through Cargo."
	},
/turf/closed/mineral/volcanic/lava_land_surface,
/area/ruin/unpowered)
"MN" = (
/obj/structure/stone_tile/surrounding/cracked{
	dir = 8
	},
/obj/structure/stone_tile/center/burnt,
/turf/closed/mineral/random/high_chance/volcanic,
/area/lavaland/surface/outdoors)
"MY" = (
/obj/structure/stone_tile/block{
	dir = 8
	},
/obj/effect/spawner/random/entertainment/coin,
/turf/closed/mineral/random/high_chance/volcanic,
/area/lavaland/surface/outdoors)
"NG" = (
/obj/structure/stone_tile/surrounding_tile/cracked{
	dir = 1
	},
/turf/open/lava/smooth/lava_land_surface,
/area/lavaland/surface/outdoors)
"NI" = (
/turf/open/lava/smooth/lava_land_surface,
/area/lavaland/surface/outdoors)
"Oy" = (
/obj/structure/stone_tile/slab,
/obj/effect/spawner/random/entertainment/coin,
/turf/closed/mineral/random/high_chance/volcanic,
/area/lavaland/surface/outdoors)
"OI" = (
/obj/structure/stone_tile/block{
	dir = 1
	},
/turf/closed/mineral/volcanic/lava_land_surface,
/area/lavaland/surface/outdoors)
"OO" = (
/obj/structure/stone_tile/block/cracked,
/obj/effect/spawner/random/structure/spikes,
/turf/closed/mineral/volcanic/lava_land_surface,
/area/lavaland/surface/outdoors)
"PS" = (
/obj/structure/stone_tile/burnt{
	dir = 1
	},
/turf/open/lava/smooth/lava_land_surface,
/area/lavaland/surface/outdoors)
"QL" = (
/obj/structure/stone_tile/block/cracked,
/obj/structure/stone_tile/block/burnt{
	dir = 1
	},
/obj/item/stack/ore/iron{
	pixel_y = 10;
	pixel_x = 10
	},
/turf/closed/mineral/random/high_chance/volcanic,
/area/lavaland/surface/outdoors)
"Rg" = (
/obj/structure/stone_tile/slab/burnt,
/turf/open/lava/smooth/lava_land_surface,
/area/lavaland/surface/outdoors)
"Rp" = (
/obj/structure/stone_tile{
	dir = 8
	},
/obj/structure/flora/rock/pile/style_random,
/turf/open/misc/asteroid/basalt/lava_land_surface,
/area/lavaland/surface/outdoors)
"Rx" = (
/obj/structure/stone_tile/slab,
/turf/closed/mineral/random/high_chance/volcanic,
/area/ruin/unpowered)
"RH" = (
/obj/structure/wall_torch/mount_only,
/turf/closed/indestructible/riveted/boss,
/area/lavaland/surface/outdoors)
"Sa" = (
/obj/structure/stone_tile/slab,
/obj/item/flashlight/flare/torch{
	pixel_x = 9;
	pixel_y = 7
	},
/mob/living/basic/mining/ancient_demon/ancient_demon_lesser,
/turf/closed/mineral/volcanic/lava_land_surface,
/area/lavaland/surface/outdoors)
"Su" = (
/obj/structure/stone_tile/surrounding/cracked{
	dir = 6
	},
/obj/structure/stone_tile/center/cracked,
/turf/closed/mineral/volcanic/lava_land_surface,
/area/lavaland/surface/outdoors)
"SD" = (
/obj/structure/wall_torch/mount_only,
/turf/closed/indestructible/riveted/boss,
/area/ruin/unpowered)
"TU" = (
/obj/structure/stone_tile/slab/cracked,
/turf/closed/mineral/volcanic/lava_land_surface,
/area/lavaland/surface/outdoors)
"UG" = (
/obj/structure/stone_tile/slab,
/obj/effect/spawner/random/entertainment/coin,
/turf/closed/mineral/volcanic/lava_land_surface,
/area/lavaland/surface/outdoors)
"Vb" = (
/obj/structure/stone_tile/surrounding_tile/cracked,
/turf/open/lava/smooth/lava_land_surface,
/area/lavaland/surface/outdoors)
"VQ" = (
/obj/structure/stone_tile,
/obj/structure/stone_tile{
	dir = 8
	},
/obj/structure/stone_tile{
	dir = 4
	},
/turf/open/lava/smooth/lava_land_surface,
/area/lavaland/surface/outdoors)
"Wg" = (
/obj/structure/stone_tile/slab/cracked{
	dir = 6
	},
/turf/open/lava/smooth/lava_land_surface,
/area/lavaland/surface/outdoors)
"WD" = (
/obj/structure/stone_tile/slab,
/mob/living/basic/mining/ancient_demon/ancient_demon_lesser,
/turf/closed/mineral/random/high_chance/volcanic,
/area/ruin/unpowered)
"WH" = (
/obj/structure/stone_tile/surrounding/burnt,
/obj/structure/stone_tile/center,
/turf/closed/mineral/random/high_chance/volcanic,
/area/lavaland/surface/outdoors)
"WI" = (
/obj/structure/stone_tile/block/cracked,
/obj/structure/stone_tile/block/burnt{
	dir = 1
	},
/turf/closed/mineral/random/high_chance/volcanic,
/area/lavaland/surface/outdoors)
"WT" = (
/obj/structure/stone_tile{
	dir = 4
	},
/turf/closed/mineral/volcanic/lava_land_surface,
/area/lavaland/surface/outdoors)
"Xd" = (
/obj/item/forging/tongs/primitive,
/obj/structure/stone_tile/slab,
/mob/living/basic/mining/ancient_demon/ancient_demon_lesser,
/turf/closed/mineral/random/high_chance/volcanic,
/area/ruin/unpowered)
"Xs" = (
/obj/structure/stone_tile,
/obj/effect/spawner/random/structure/spikes,
/turf/closed/mineral/volcanic/lava_land_surface,
/area/lavaland/surface/outdoors)
"XM" = (
/obj/structure/table/wood,
/obj/item/reagent_containers/cup/beaker/large/ceramic{
	pixel_x = 9;
	pixel_y = 11
	},
/obj/item/reagent_containers/cup/beaker/large/blowing_glass{
	pixel_x = -4;
	pixel_y = 6
	},
/obj/item/reagent_containers/cup/beaker/large/blowing_glass,
/obj/structure/stone_tile/slab,
/obj/structure/stone_tile/surrounding,
/obj/structure/stone_tile/center,
/turf/closed/mineral/random/high_chance/volcanic,
/area/ruin/unpowered)
"Yc" = (
/obj/structure/stone_tile/surrounding,
/obj/structure/stone_tile/center/cracked,
/turf/closed/mineral/volcanic/lava_land_surface,
/area/lavaland/surface/outdoors)
"Yt" = (
/obj/structure/stone_tile/surrounding/cracked{
	dir = 4
	},
/obj/item/clothing/suit/hooded/cultrobes,
/turf/closed/mineral/volcanic/lava_land_surface,
/area/ruin/unpowered)
"Yv" = (
/obj/item/flashlight/flare/torch,
/turf/closed/mineral/random/high_chance/volcanic,
/area/lavaland/surface/outdoors)
"YS" = (
/obj/structure/stone_tile/surrounding/cracked{
	dir = 6
	},
/turf/closed/mineral/random/high_chance/volcanic,
/area/lavaland/surface/outdoors)
"Zh" = (
/obj/structure/stone_tile/surrounding_tile/burnt{
	dir = 8
	},
/turf/open/lava/smooth/lava_land_surface,
/area/lavaland/surface/outdoors)
"Zn" = (
/obj/structure/stone_tile/slab/cracked{
	dir = 5
	},
/obj/structure/stone_tile/slab/cracked{
	dir = 10
	},
/turf/open/lava/smooth/lava_land_surface,
/area/lavaland/surface/outdoors)
"ZD" = (
/obj/structure/stone_tile/surrounding_tile/cracked{
	dir = 4
	},
/obj/structure/stone_tile/surrounding_tile/cracked,
/obj/structure/stone_tile/surrounding_tile/cracked{
	dir = 8
	},
/obj/structure/stone_tile/surrounding_tile/cracked{
	dir = 1
	},
/obj/structure/stone_tile/center/cracked,
/turf/open/lava/smooth/lava_land_surface,
/area/lavaland/surface/outdoors)
"ZI" = (
/obj/structure/stone_tile/block/cracked,
/obj/structure/stone_tile/block/burnt{
	dir = 1
	},
/turf/closed/mineral/volcanic/lava_land_surface,
/area/lavaland/surface/outdoors)
"ZZ" = (
/obj/structure/stone_tile/burnt{
	dir = 4
	},
/obj/structure/stone_tile/block/cracked,
/turf/closed/mineral/volcanic/lava_land_surface,
/area/lavaland/surface/outdoors)

(1,1,1) = {"
MA
WT
cU
pF
MY
ro
MA
MA
MA
MA
MA
MA
MA
MA
MA
WT
xl
MA
xl
ro
MA
MA
MA
MA
"}
(2,1,1) = {"
MA
wa
wa
wa
wa
wa
vN
MA
MA
WT
dW
jD
MA
MA
WT
wa
wa
SD
wa
wa
vN
MA
TU
MA
"}
(3,1,1) = {"
OI
wa
Ej
nm
Yt
wa
dC
MA
MA
Yc
CK
LW
MA
MA
aq
wa
mq
qQ
Mm
wa
GT
lq
Fg
MA
"}
(4,1,1) = {"
ut
wa
Gr
Cf
tv
wa
dC
MA
MA
PS
Vb
NI
NI
NI
tG
wa
XM
Xd
MG
wa
dC
Dq
dZ
MA
"}
(5,1,1) = {"
sQ
wa
wa
oQ
wa
wa
Em
ut
MA
NI
NI
pH
ut
NI
NI
wa
wa
Ky
wa
wa
Em
iW
re
MA
"}
(6,1,1) = {"
MA
sQ
wa
yo
wa
fA
IK
RH
NI
Ge
Wg
WI
ut
RH
NI
sQ
wa
Rx
wa
Em
uS
dt
eO
MA
"}
(7,1,1) = {"
MA
MA
sQ
mG
Xs
ut
NI
NI
Hm
Su
md
MN
Yv
BP
rQ
NI
sQ
mG
Em
us
Ge
HW
DL
MA
"}
(8,1,1) = {"
MA
md
fT
FA
ZZ
Ds
FC
FA
Hu
DL
Gp
Ey
Hu
Ef
yC
NI
NI
NI
YS
qc
eT
IQ
DI
OO
"}
(9,1,1) = {"
UG
md
vo
Ds
Iy
ub
tr
TU
rb
KZ
hv
mG
cD
mG
WH
mG
CA
Zh
NI
PS
cy
wN
bz
wI
"}
(10,1,1) = {"
MA
MA
Sa
cy
Zn
MA
MA
IK
NI
WT
Ap
kJ
pF
us
pF
us
ng
QL
vN
NI
NG
md
sa
MA
"}
(11,1,1) = {"
RH
IK
ng
us
cM
MA
RH
NI
jE
wa
fz
wa
ip
dA
fO
ng
wa
Ky
wa
Rp
NI
Ds
md
MA
"}
(12,1,1) = {"
MA
MA
lQ
Oy
VQ
MA
MA
jE
wa
wa
Rx
wa
wa
BT
WT
wa
wa
Ky
wa
wa
vN
dt
dZ
MA
"}
(13,1,1) = {"
MA
MA
tD
cy
jZ
MA
MA
mw
wa
Ch
WD
vt
wa
NI
dk
wa
tA
iE
fE
wa
dC
FC
II
MA
"}
(14,1,1) = {"
MA
MA
vG
BS
pH
MA
MA
NI
wa
hb
bo
kP
wa
NI
mw
wa
vT
yJ
og
wa
dC
ZI
MA
MA
"}
(15,1,1) = {"
MA
ut
iX
ZD
Rg
MA
MA
sQ
wa
wa
SD
oQ
wa
Xs
NI
wa
wa
SD
wa
wa
Xs
MA
MA
MA
"}
(16,1,1) = {"
MA
MA
BK
TU
lW
NI
MA
MA
ut
Ai
MA
Ai
Xs
MA
MA
sQ
Ai
us
cS
Xs
MA
MA
Le
MA
"}
