//MAP CONVERTED BY dmm2tgm.py THIS HEADER COMMENT PREVENTS RECONVERSION, DO NOT REMOVE
"a" = (
/turf/closed/mineral/volcanic/lava_land_surface,
/area/lavaland/surface/outdoors)
"c" = (
/obj/structure/ore_vein/gold,
/turf/open/misc/asteroid/basalt/lava_land_surface,
/area/lavaland/surface/outdoors)
"d" = (
/mob/living/basic/mining/lobstrosity/lava,
/turf/open/misc/asteroid/basalt/lava_land_surface,
/area/lavaland/surface/outdoors)
"e" = (
/obj/structure/ore_vein,
/turf/open/misc/asteroid/basalt/lava_land_surface,
/area/lavaland/surface/outdoors)
"j" = (
/obj/item/fishing_rod/bone,
/obj/structure/ore_vein/diamond,
/turf/open/misc/asteroid/basalt/lava_land_surface,
/area/lavaland/surface/outdoors)
"l" = (
/turf/template_noop,
/area/template_noop)
"o" = (
/obj/structure/flora/ash/stem_shroom,
/turf/open/misc/asteroid/basalt/lava_land_surface,
/area/lavaland/surface/outdoors)
"x" = (
/obj/structure/flora/ash/seraka,
/turf/closed/mineral/volcanic/lava_land_surface,
/area/lavaland/surface/outdoors)
"B" = (
/obj/item/chair/wood,
/turf/open/misc/asteroid/basalt/lava_land_surface,
/area/lavaland/surface/outdoors)
"C" = (
/obj/structure/flora/ash/cacti,
/turf/open/misc/asteroid/basalt/lava_land_surface,
/area/lavaland/surface/outdoors)
"G" = (
/obj/structure/flora/rock/pile/style_random,
/turf/open/misc/asteroid/basalt/lava_land_surface,
/area/lavaland/surface/outdoors)
"K" = (
/obj/item/fishing_hook/bone,
/obj/structure/ore_vein/plasma,
/turf/open/misc/asteroid/basalt/lava_land_surface,
/area/lavaland/surface/outdoors)
"L" = (
/obj/item/reagent_containers/cup/bucket/wooden,
/obj/structure/ore_vein/iron,
/turf/open/misc/asteroid/basalt/lava_land_surface,
/area/lavaland/surface/outdoors)
"P" = (
/obj/item/fishing_line/sinew,
/obj/structure/ore_vein/silver,
/turf/open/misc/asteroid/basalt/lava_land_surface,
/area/lavaland/surface/outdoors)
"Q" = (
/obj/structure/flora/rock/pile/style_random,
/turf/closed/mineral/volcanic/lava_land_surface,
/area/lavaland/surface/outdoors)
"X" = (
/turf/open/lava/smooth/lava_land_surface,
/area/lavaland/surface/outdoors)
"Y" = (
/obj/structure/ore_vein,
/turf/closed/mineral/volcanic/lava_land_surface,
/area/lavaland/surface/outdoors)

(1,1,1) = {"
l
a
a
a
a
Y
a
a
l
l
l
l
"}
(2,1,1) = {"
l
Q
X
a
d
a
a
a
x
l
l
l
"}
(3,1,1) = {"
a
a
X
X
X
X
G
a
a
a
l
l
"}
(4,1,1) = {"
a
C
e
X
X
X
X
X
d
a
a
l
"}
(5,1,1) = {"
a
a
G
X
X
P
X
X
X
G
a
l
"}
(6,1,1) = {"
a
Y
X
X
e
j
c
X
X
e
a
a
"}
(7,1,1) = {"
a
a
d
X
X
K
L
X
X
d
C
a
"}
(8,1,1) = {"
a
a
X
X
X
X
B
e
X
X
e
Y
"}
(9,1,1) = {"
l
Y
a
X
X
X
X
X
X
X
X
a
"}
(10,1,1) = {"
l
a
a
Q
d
X
X
X
X
X
G
a
"}
(11,1,1) = {"
l
l
a
a
a
o
e
d
X
a
a
a
"}
(12,1,1) = {"
l
l
l
l
a
a
Y
a
a
a
a
l
"}
