//MAP CONVERTED BY dmm2tgm.py THIS HEADER COMMENT PREVENTS RECONVERSION, DO NOT REMOVE
"a" = (
/turf/closed/indestructible/riveted/boss,
/area/lavaland/surface/outdoors)
"d" = (
/obj/structure/stone_tile/burnt,
/obj/structure/stone_tile/surrounding_tile/cracked{
	dir = 9
	},
/obj/structure/stone_tile/surrounding_tile/cracked{
	dir = 5
	},
/turf/open/lava/smooth/lava_land_surface,
/area/lavaland/surface/outdoors)
"m" = (
/obj/structure/stone_tile/block/burnt{
	dir = 1
	},
/obj/structure/stone_tile/surrounding_tile/burnt,
/turf/open/lava/smooth/lava_land_surface,
/area/lavaland/surface/outdoors)
"p" = (
/turf/open/lava/smooth/lava_land_surface,
/area/lavaland/surface/outdoors)
"q" = (
/turf/template_noop,
/area/template_noop)
"y" = (
/obj/structure/stone_tile/slab/cracked{
	dir = 6
	},
/turf/open/lava/smooth/lava_land_surface,
/area/lavaland/surface/outdoors)
"L" = (
/obj/structure/stone_tile/surrounding_tile/burnt{
	dir = 1
	},
/obj/structure/stone_tile/block/cracked,
/turf/open/lava/smooth/lava_land_surface,
/area/lavaland/surface/outdoors)
"S" = (
/obj/structure/stone_tile/slab/burnt,
/turf/closed/mineral/volcanic/lava_land_surface,
/area/lavaland/surface/outdoors)
"V" = (
/obj/structure/stone_tile/block/burnt{
	dir = 4
	},
/turf/open/lava/smooth/lava_land_surface,
/area/lavaland/surface/outdoors)
"Y" = (
/obj/structure/stone_tile/surrounding/cracked,
/obj/structure/stone_tile/center/burnt,
/turf/open/lava/smooth/lava_land_surface,
/area/lavaland/surface/outdoors)
"Z" = (
/obj/structure/stone_tile/surrounding/cracked{
	dir = 8
	},
/obj/structure/ore_vent/random{
	ore_vent_options = list("large" = 0, "medium" = 0, "small" = 15);
	name = "Small ore vent"
	},
/mob/living/basic/mining/ancient_demon/goliath_pup,
/mob/living/basic/mining/ancient_demon/goliath_pup,
/turf/closed/mineral/volcanic/lava_land_surface,
/area/lavaland/surface/outdoors)

(1,1,1) = {"
a
a
q
p
p
q
q
"}
(2,1,1) = {"
a
a
S
Z
p
y
a
"}
(3,1,1) = {"
q
V
m
L
d
Y
a
"}
(4,1,1) = {"
p
p
p
p
p
a
a
"}
