//MAP CONVERTED BY dmm2tgm.py THIS HEADER COMMENT PREVENTS RECONVERSION, DO NOT REMOVE
"aF" = (
/obj/effect/spawner/random/structure/orevein_longregen,
/turf/closed/mineral/volcanic/lava_land_surface,
/area/lavaland/surface/outdoors)
"aL" = (
/obj/structure/stone_tile/slab/cracked{
	dir = 8
	},
/turf/open/lava/smooth/lava_land_surface,
/area/lavaland/surface/outdoors)
"aW" = (
/obj/structure/stone_tile/surrounding_tile/cracked{
	dir = 8
	},
/obj/effect/spawner/random/structure/orevein_longregen,
/turf/closed/mineral/volcanic/lava_land_surface,
/area/lavaland/surface/outdoors)
"dk" = (
/turf/open/lava/smooth/lava_land_surface,
/area/lavaland/surface/outdoors)
"fd" = (
/obj/item/xenoarch/useless_relic{
	name = "Ancient relic";
	desc = "Sort of relic that can be exported through Cargo."
	},
/obj/effect/spawner/random/structure/orevein_longregen,
/turf/closed/mineral/random/high_chance/volcanic,
/area/lavaland/surface/outdoors)
"gO" = (
/obj/structure/stone_tile/burnt,
/obj/effect/spawner/random/structure/spikes,
/turf/closed/mineral/random/high_chance/volcanic,
/area/lavaland/surface/outdoors)
"jb" = (
/obj/structure/stone_tile/slab/cracked,
/obj/effect/spawner/random/entertainment/coin{
	pixel_x = 8;
	pixel_y = 7
	},
/turf/closed/mineral/volcanic/lava_land_surface,
/area/lavaland/surface/outdoors)
"jS" = (
/obj/effect/mapping_helpers/bombable_wall,
/turf/closed/indestructible/riveted/boss/wasteland,
/area/ruin/unpowered)
"lu" = (
/turf/closed/mineral/random/high_chance/volcanic,
/area/ruin/unpowered)
"ly" = (
/obj/effect/mob_spawn/corpse/human/abductor,
/turf/open/floor/plating/abductor2{
	initial_gas_mix = "LAVALAND_ATMOS"
	},
/area/ruin/unpowered)
"nu" = (
/turf/template_noop,
/area/template_noop)
"ox" = (
/obj/structure/stone_tile/block/cracked,
/turf/open/lava/smooth/lava_land_surface,
/area/lavaland/surface/outdoors)
"oL" = (
/obj/effect/spawner/random/structure/orevein_longregen,
/turf/closed/mineral/random/high_chance/volcanic,
/area/lavaland/surface/outdoors)
"oP" = (
/obj/structure/flora/rock/pile/style_random,
/turf/open/misc/asteroid/basalt/lava_land_surface,
/area/lavaland/surface/outdoors)
"qb" = (
/obj/structure/closet/abductor{
	anchored = 1
	},
/obj/item/organ/external/genital/anus,
/obj/item/organ/internal/tongue/abductor,
/obj/item/organ/internal/tongue/abductor,
/turf/open/floor/plating/abductor{
	initial_gas_mix = "LAVALAND_ATMOS"
	},
/area/ruin/unpowered)
"qs" = (
/obj/structure/bed/abductor,
/turf/open/floor/plating/abductor2{
	initial_gas_mix = "LAVALAND_ATMOS"
	},
/area/ruin/unpowered)
"rx" = (
/turf/closed/indestructible/riveted/boss,
/area/lavaland/surface/outdoors)
"rD" = (
/obj/structure/flora/rock/pile/style_random,
/turf/closed/mineral/volcanic/lava_land_surface,
/area/lavaland/surface/outdoors)
"su" = (
/obj/effect/decal/cleanable/xenoblood,
/obj/item/clothing/mask/facehugger/impregnated,
/obj/structure/marker_beacon/indigo,
/obj/item/paper/guides/antag/abductor,
/turf/open/floor/plating/abductor{
	initial_gas_mix = "LAVALAND_ATMOS"
	},
/area/ruin/unpowered)
"sK" = (
/turf/closed/wall/mineral/abductor,
/area/ruin/unpowered)
"sZ" = (
/obj/structure/stone_tile/slab/cracked{
	dir = 1
	},
/turf/open/lava/smooth/lava_land_surface,
/area/lavaland/surface/outdoors)
"ub" = (
/obj/structure/stone_tile/slab/cracked,
/obj/effect/spawner/random/mob/necropolis_mob,
/turf/closed/mineral/volcanic/lava_land_surface,
/area/lavaland/surface/outdoors)
"up" = (
/obj/structure/flora/rock/pile/style_random,
/obj/effect/spawner/random/mob/necropolis_mob,
/turf/closed/mineral/volcanic/lava_land_surface,
/area/lavaland/surface/outdoors)
"wo" = (
/obj/structure/stone_tile/block/burnt{
	dir = 1
	},
/obj/structure/stone_tile/burnt,
/turf/open/lava/smooth/lava_land_surface,
/area/lavaland/surface/outdoors)
"yB" = (
/obj/structure/stone_tile/burnt,
/obj/structure/stone_tile{
	dir = 8
	},
/obj/structure/stone_tile/cracked{
	dir = 4
	},
/turf/closed/mineral/volcanic/lava_land_surface,
/area/lavaland/surface/outdoors)
"zf" = (
/obj/structure/stone_tile/cracked,
/obj/structure/stone_tile/burnt{
	dir = 4
	},
/obj/structure/stone_tile{
	dir = 8
	},
/turf/closed/mineral/volcanic/lava_land_surface,
/area/lavaland/surface/outdoors)
"zQ" = (
/obj/structure/flora/rock/style_random,
/turf/open/misc/asteroid/basalt/lava_land_surface,
/area/lavaland/surface/outdoors)
"Af" = (
/obj/structure/stone_tile/block/cracked,
/obj/effect/spawner/random/structure/spikes,
/turf/closed/mineral/volcanic/lava_land_surface,
/area/lavaland/surface/outdoors)
"BN" = (
/obj/structure/stone_tile/surrounding_tile/cracked{
	dir = 9
	},
/turf/open/lava/smooth/lava_land_surface,
/area/lavaland/surface/outdoors)
"Ct" = (
/obj/structure/marker_beacon/purple,
/obj/structure/table/abductor,
/turf/open/floor/plating/abductor2{
	initial_gas_mix = "LAVALAND_ATMOS"
	},
/area/ruin/unpowered)
"CP" = (
/obj/structure/stone_tile/block/cracked{
	dir = 1
	},
/obj/structure/stone_tile/block/burnt,
/turf/open/lava/smooth/lava_land_surface,
/area/lavaland/surface/outdoors)
"Fx" = (
/obj/structure/stone_tile/block{
	dir = 4
	},
/turf/closed/mineral/volcanic/lava_land_surface,
/area/lavaland/surface/outdoors)
"FR" = (
/obj/structure/table/abductor,
/obj/structure/marker_beacon/purple,
/obj/item/organ/external/tail/lizard,
/obj/item/surgical_drapes{
	pixel_x = -5;
	pixel_y = 5
	},
/turf/open/floor/plating/abductor2{
	initial_gas_mix = "LAVALAND_ATMOS"
	},
/area/ruin/unpowered)
"GO" = (
/turf/closed/indestructible/riveted/boss,
/area/ruin/unpowered)
"HB" = (
/obj/item/organ/external/tail/monkey,
/turf/open/floor/plating/abductor2{
	initial_gas_mix = "LAVALAND_ATMOS"
	},
/area/ruin/unpowered)
"Ig" = (
/obj/structure/stone_tile/block{
	dir = 8
	},
/turf/closed/mineral/volcanic/lava_land_surface,
/area/lavaland/surface/outdoors)
"Ih" = (
/obj/item/bodypart/arm/left/abductor,
/turf/open/floor/plating/abductor{
	initial_gas_mix = "LAVALAND_ATMOS"
	},
/area/ruin/unpowered)
"Ip" = (
/turf/closed/wall/mineral/abductor,
/area/lavaland/surface/outdoors)
"IJ" = (
/obj/structure/closet/abductor,
/turf/open/floor/plating/abductor2{
	initial_gas_mix = "LAVALAND_ATMOS"
	},
/area/ruin/unpowered)
"IZ" = (
/turf/closed/mineral/random/high_chance/volcanic,
/area/lavaland/surface/outdoors)
"JW" = (
/obj/machinery/abductor/experiment{
	team_number = 100
	},
/turf/open/floor/plating/abductor2{
	initial_gas_mix = "LAVALAND_ATMOS"
	},
/area/ruin/unpowered)
"Kq" = (
/obj/item/bodypart/head/abductor,
/turf/open/floor/plating/abductor{
	initial_gas_mix = "LAVALAND_ATMOS"
	},
/area/ruin/unpowered)
"KD" = (
/obj/structure/stone_tile/cracked,
/obj/effect/spawner/random/structure/spikes,
/turf/closed/mineral/volcanic/lava_land_surface,
/area/lavaland/surface/outdoors)
"Ls" = (
/obj/structure/stone_tile/surrounding_tile/cracked{
	dir = 4
	},
/turf/open/lava/smooth/lava_land_surface,
/area/lavaland/surface/outdoors)
"Lz" = (
/obj/structure/stone_tile/burnt{
	dir = 4
	},
/obj/structure/stone_tile/block/cracked,
/turf/closed/mineral/volcanic/lava_land_surface,
/area/lavaland/surface/outdoors)
"Mh" = (
/obj/machinery/abductor/console,
/turf/open/floor/plating/abductor2{
	initial_gas_mix = "LAVALAND_ATMOS"
	},
/area/ruin/unpowered)
"Nj" = (
/obj/item/stack/sheet/mineral/abductor,
/turf/closed/mineral/random/high_chance/volcanic,
/area/ruin/unpowered)
"Oq" = (
/obj/item/xenoarch/useless_relic/magnified{
	name = "Ancient relic";
	desc = "Sort of relic that can be exported through Cargo."
	},
/obj/effect/spawner/random/structure/orevein_longregen,
/turf/closed/mineral/random/high_chance/volcanic,
/area/lavaland/surface/outdoors)
"Ot" = (
/obj/structure/stone_tile/cracked,
/obj/structure/stone_tile/block/cracked{
	dir = 1
	},
/turf/closed/mineral/volcanic/lava_land_surface,
/area/lavaland/surface/outdoors)
"Pk" = (
/mob/living/simple_animal/hostile/megafauna/demonic_frost_miner{
	attack_sound = 'sound/weapons/punch1.ogg';
	name = "Abructor Geared Miner";
	crusher_loot = list(/obj/item/organ/internal/heart/gland/heal,/obj/item/organ/internal/heart/gland/ventcrawling,/obj/item/abductor/silencer,/obj/item/crowbar/abductor,/obj/item/multitool/abductor,/obj/item/screwdriver/abductor,/obj/item/weldingtool/abductor,/obj/item/wirecutters/abductor,/obj/item/wrench/abductor);
	loot = list(/obj/effect/decal/remains/plasma,/obj/item/organ/internal/heart/gland/heal,/obj/item/hemostat/alien,/obj/item/surgicaldrill/alien,/obj/item/cautery/alien,/obj/item/retractor/alien,/obj/item/circular_saw/alien,/obj/item/scalpel/alien);
	speed = 0.25;
	melee_damage_upper = 15;
	unsuitable_atmos_damage = 0;
	death_message = "falls to the ground with juicy slap.";
	gps_name = "Distress Signal";
	weather_immunities = list("lava_immune","ashstorm_immune");
	wound_bonus = 15;
	light_color = "#D000D0";
	attack_verb_continuous = "hits";
	attack_verb_simple = "tamis";
	faction = list("mining,boss");
	obj_damage = 40;
	light_power = 5;
	armour_penetration = 30;
	light_system = 2;
	desc = "...!!!ABDUCTOR ASSAULT IN PROGRESS!!!......!!!ABDUCTOR ASSAULT IN PROGRESS!!!......!!!ABDUCTOR ASSAULT IN PROGRESS!!!......!!!ABDUCTOR ASSAULT IN PROGRESS!!!......!!!ABDUCTOR ASSAULT IN PROGRESS!!!......!!!ABDUCTOR ASSAULT IN PROGRESS!!!..."
	},
/turf/closed/mineral/random/high_chance/volcanic,
/area/ruin/unpowered)
"Pv" = (
/obj/structure/stone_tile/surrounding/cracked,
/turf/open/lava/smooth/lava_land_surface,
/area/lavaland/surface/outdoors)
"PO" = (
/obj/structure/stone_tile/slab/cracked{
	dir = 10
	},
/turf/open/lava/smooth/lava_land_surface,
/area/lavaland/surface/outdoors)
"Qc" = (
/turf/open/floor/plating/abductor2{
	initial_gas_mix = "LAVALAND_ATMOS"
	},
/area/ruin/unpowered)
"SK" = (
/obj/structure/stone_tile/burnt,
/turf/open/lava/smooth/lava_land_surface,
/area/lavaland/surface/outdoors)
"UO" = (
/obj/effect/spawner/random/structure/spikes,
/turf/closed/mineral/random/high_chance/volcanic,
/area/lavaland/surface/outdoors)
"Vr" = (
/obj/machinery/abductor/pad{
	team_number = 100
	},
/turf/open/floor/plating/abductor2{
	initial_gas_mix = "LAVALAND_ATMOS"
	},
/area/ruin/unpowered)
"VQ" = (
/obj/effect/mapping_helpers/bombable_wall,
/turf/closed/indestructible/riveted/boss/wasteland,
/area/lavaland/surface/outdoors)
"Xf" = (
/obj/effect/spawner/random/structure/spikes,
/turf/closed/mineral/volcanic/lava_land_surface,
/area/lavaland/surface/outdoors)
"Xp" = (
/obj/structure/stone_tile/surrounding_tile/cracked{
	dir = 5
	},
/obj/structure/stone_tile/surrounding_tile/cracked,
/turf/closed/mineral/random/high_chance/volcanic,
/area/lavaland/surface/outdoors)
"XS" = (
/obj/structure/stone_tile/block,
/obj/structure/stone_tile/cracked{
	dir = 1
	},
/obj/effect/spawner/random/entertainment/coin{
	pixel_x = -6;
	pixel_y = -4
	},
/obj/effect/spawner/random/entertainment/coin{
	pixel_x = -8;
	pixel_y = 10
	},
/turf/closed/mineral/volcanic/lava_land_surface,
/area/lavaland/surface/outdoors)

(1,1,1) = {"
nu
rx
yB
ub
Ot
VQ
Af
nu
nu
"}
(2,1,1) = {"
nu
rx
rx
rx
zf
Fx
aF
Ig
nu
"}
(3,1,1) = {"
rx
rx
sK
GO
GO
GO
jS
jS
Xf
"}
(4,1,1) = {"
rx
sK
sK
Mh
Nj
Pk
lu
jS
Lz
"}
(5,1,1) = {"
rx
sK
JW
Qc
lu
lu
qs
GO
rx
"}
(6,1,1) = {"
rx
sK
FR
Qc
su
Qc
Ct
sK
rx
"}
(7,1,1) = {"
rx
sK
Vr
Kq
HB
ly
Qc
sK
rx
"}
(8,1,1) = {"
rx
Ip
sK
qb
Ih
IJ
sK
Ip
rx
"}
(9,1,1) = {"
rx
dk
sK
sK
sK
sK
sK
dk
rx
"}
(10,1,1) = {"
VQ
dk
dk
dk
PO
wo
dk
dk
aW
"}
(11,1,1) = {"
sZ
dk
dk
dk
dk
dk
dk
Ls
jb
"}
(12,1,1) = {"
VQ
ox
dk
dk
dk
dk
aL
rx
XS
"}
(13,1,1) = {"
rx
SK
BN
dk
dk
dk
dk
CP
gO
"}
(14,1,1) = {"
Xp
dk
zQ
dk
dk
oP
Pv
VQ
up
"}
(15,1,1) = {"
UO
dk
Oq
dk
fd
UO
aF
KD
nu
"}
(16,1,1) = {"
up
IZ
oL
dk
dk
UO
nu
rx
nu
"}
(17,1,1) = {"
nu
Xf
oL
dk
oL
up
nu
nu
nu
"}
(18,1,1) = {"
nu
nu
rD
dk
Xf
nu
nu
nu
nu
"}
