//MAP CONVERTED BY dmm2tgm.py THIS HEADER COMMENT PREVENTS RECONVERSION, DO NOT REMOVE
"a" = (
/turf/template_noop,
/area/template_noop)
"f" = (
/obj/structure/stone_tile/slab/cracked,
/turf/closed/mineral/random/high_chance/volcanic,
/area/lavaland/surface/outdoors)
"i" = (
/obj/structure/stone_tile/block{
	dir = 1
	},
/turf/closed/mineral/volcanic/lava_land_surface,
/area/lavaland/surface/outdoors)
"q" = (
/turf/closed/indestructible/riveted/boss,
/area/lavaland/surface/outdoors)
"v" = (
/obj/structure/stone_tile/block/cracked,
/obj/effect/spawner/random/structure/spikes,
/turf/closed/mineral/volcanic/lava_land_surface,
/area/lavaland/surface/outdoors)
"x" = (
/obj/effect/spawner/random/structure/spikes,
/turf/closed/mineral/random/high_chance/volcanic,
/area/lavaland/surface/outdoors)
"I" = (
/obj/structure/stone_tile/block,
/obj/effect/spawner/random/structure/spikes,
/turf/closed/mineral/random/high_chance/volcanic,
/area/lavaland/surface/outdoors)
"M" = (
/obj/structure/stone_tile/block{
	dir = 1
	},
/turf/closed/mineral/random/high_chance/volcanic,
/area/lavaland/surface/outdoors)
"Y" = (
/obj/structure/stone_tile/block,
/obj/effect/spawner/random/structure/spikes,
/turf/closed/mineral/volcanic/lava_land_surface,
/area/lavaland/surface/outdoors)
"Z" = (
/obj/structure/stone_tile/block/cracked{
	dir = 1
	},
/turf/closed/mineral/random/high_chance/volcanic,
/area/lavaland/surface/outdoors)

(1,1,1) = {"
Z
q
a
"}
(2,1,1) = {"
M
q
Y
"}
(3,1,1) = {"
x
f
x
"}
(4,1,1) = {"
i
q
I
"}
(5,1,1) = {"
a
q
v
"}
