//MAP CONVERTED BY dmm2tgm.py THIS HEADER COMMENT PREVENTS RECONVERSION, DO NOT REMOVE
"a" = (
/turf/open/lava/smooth/lava_land_surface,
/area/ruin/unpowered)
"b" = (
/turf/closed/indestructible/riveted/boss,
/area/lavaland/surface/outdoors)
"c" = (
/turf/closed/mineral/strong{
	base_icon_state = "smoothrocks";
	icon = 'modular_nova/modules/liquids/icons/turf/smoothrocks.dmi';
	icon_state = "smoothrocks-55"
	},
/area/ruin/unpowered)
"g" = (
/obj/structure/stone_tile/block/cracked,
/obj/effect/spawner/random/structure/spikes,
/turf/closed/mineral/volcanic/lava_land_surface,
/area/lavaland/surface/outdoors)
"i" = (
/turf/closed/indestructible/riveted/boss,
/area/ruin/unpowered)
"k" = (
/obj/structure/flora/rock/pile/style_random,
/mob/living/basic/mining/brimdemon,
/turf/closed/mineral/volcanic/lava_land_surface,
/area/ruin/unpowered)
"m" = (
/obj/structure/flora/rock/pile/style_random,
/turf/closed/mineral/strong{
	base_icon_state = "smoothrocks";
	icon = 'modular_nova/modules/liquids/icons/turf/smoothrocks.dmi';
	icon_state = "smoothrocks-55"
	},
/area/lavaland/surface/outdoors)
"n" = (
/turf/closed/mineral/strong{
	base_icon_state = "smoothrocks";
	icon = 'modular_nova/modules/liquids/icons/turf/smoothrocks.dmi';
	icon_state = "smoothrocks-55"
	},
/area/lavaland/surface/outdoors)
"o" = (
/obj/structure/stone_tile/slab/cracked{
	dir = 4
	},
/turf/closed/mineral/strong{
	base_icon_state = "smoothrocks";
	icon = 'modular_nova/modules/liquids/icons/turf/smoothrocks.dmi';
	icon_state = "smoothrocks-55"
	},
/area/ruin/unpowered)
"q" = (
/obj/effect/spawner/random/structure/spikes,
/turf/closed/mineral/volcanic/lava_land_surface,
/area/lavaland/surface/outdoors)
"r" = (
/turf/open/chasm/lavaland,
/area/ruin/unpowered)
"s" = (
/obj/structure/stone_tile/surrounding/cracked{
	dir = 8
	},
/turf/closed/mineral/strong{
	base_icon_state = "smoothrocks";
	icon = 'modular_nova/modules/liquids/icons/turf/smoothrocks.dmi';
	icon_state = "smoothrocks-55"
	},
/area/ruin/unpowered)
"t" = (
/obj/structure/stone_tile/block/cracked{
	dir = 1
	},
/turf/open/lava/smooth/lava_land_surface,
/area/lavaland/surface/outdoors)
"u" = (
/obj/structure/stone_tile/block/burnt,
/obj/structure/stone_tile/burnt{
	dir = 4
	},
/turf/open/lava/smooth/lava_land_surface,
/area/lavaland/surface/outdoors)
"w" = (
/obj/structure/flora/rock/style_random,
/obj/item/xenoarch/useless_relic/magnified{
	name = "Ancient relic";
	desc = "Sort of relic that can be exported through Cargo."
	},
/turf/closed/mineral/volcanic/lava_land_surface,
/area/ruin/unpowered)
"x" = (
/turf/open/chasm/lavaland,
/area/lavaland/surface/outdoors)
"y" = (
/obj/structure/stone_tile/block/burnt{
	dir = 8
	},
/turf/open/lava/smooth/lava_land_surface,
/area/lavaland/surface/outdoors)
"C" = (
/obj/structure/stone_tile/surrounding_tile/cracked{
	dir = 1
	},
/turf/open/lava/smooth/lava_land_surface,
/area/lavaland/surface/outdoors)
"E" = (
/obj/structure/stone_tile/burnt{
	dir = 4
	},
/obj/structure/stone_tile/cracked{
	dir = 1
	},
/turf/open/lava/smooth/lava_land_surface,
/area/lavaland/surface/outdoors)
"F" = (
/obj/structure/ore_vent/random{
	ore_vent_options = list("large" = 15, "medium" = 0, "small" = 0);
	name = "Large ore vent"
	},
/turf/closed/mineral/volcanic/lava_land_surface,
/area/ruin/unpowered)
"G" = (
/turf/template_noop,
/area/template_noop)
"I" = (
/obj/structure/stone_tile/block/cracked{
	dir = 4
	},
/turf/open/lava/smooth/lava_land_surface,
/area/lavaland/surface/outdoors)
"K" = (
/turf/open/lava/smooth/lava_land_surface,
/area/lavaland/surface/outdoors)
"L" = (
/obj/effect/mapping_helpers/bombable_wall,
/turf/closed/indestructible/riveted/boss/wasteland,
/area/ruin/unpowered)
"N" = (
/obj/structure/stone_tile{
	dir = 1
	},
/obj/structure/stone_tile/cracked,
/obj/structure/stone_tile/burnt{
	dir = 4
	},
/turf/closed/mineral/volcanic/lava_land_surface,
/area/lavaland/surface/outdoors)
"Q" = (
/obj/structure/stone_tile/slab/cracked,
/turf/open/misc/asteroid/basalt/lava_land_surface,
/area/ruin/unpowered)
"R" = (
/obj/structure/stone_tile/surrounding/cracked{
	dir = 4
	},
/mob/living/basic/mining/brimdemon,
/turf/closed/mineral/strong{
	base_icon_state = "smoothrocks";
	icon = 'modular_nova/modules/liquids/icons/turf/smoothrocks.dmi';
	icon_state = "smoothrocks-55"
	},
/area/ruin/unpowered)
"S" = (
/obj/structure/stone_tile/surrounding_tile/burnt{
	dir = 4
	},
/turf/open/lava/smooth/lava_land_surface,
/area/lavaland/surface/outdoors)
"V" = (
/obj/effect/spawner/random/structure/spikes,
/turf/closed/mineral/strong{
	base_icon_state = "smoothrocks";
	icon = 'modular_nova/modules/liquids/icons/turf/smoothrocks.dmi';
	icon_state = "smoothrocks-55"
	},
/area/lavaland/surface/outdoors)
"X" = (
/obj/structure/stone_tile/surrounding/cracked{
	dir = 6
	},
/obj/structure/stone_tile/center/cracked,
/turf/closed/mineral/strong{
	base_icon_state = "smoothrocks";
	icon = 'modular_nova/modules/liquids/icons/turf/smoothrocks.dmi';
	icon_state = "smoothrocks-55"
	},
/area/ruin/unpowered)
"Z" = (
/obj/structure/flora/rock/pile/style_random,
/turf/closed/mineral/volcanic/lava_land_surface,
/area/lavaland/surface/outdoors)

(1,1,1) = {"
G
G
G
b
q
x
Z
G
G
K
G
G
"}
(2,1,1) = {"
G
q
b
b
m
n
K
t
b
u
C
b
"}
(3,1,1) = {"
Z
q
i
i
L
i
L
i
i
i
K
b
"}
(4,1,1) = {"
q
i
i
c
a
i
a
a
a
L
K
Z
"}
(5,1,1) = {"
b
i
X
a
a
R
a
i
a
i
K
q
"}
(6,1,1) = {"
x
L
r
a
w
F
L
i
i
i
K
G
"}
(7,1,1) = {"
x
i
s
a
L
k
a
i
Q
i
K
G
"}
(8,1,1) = {"
G
i
c
a
i
o
a
a
a
i
g
G
"}
(9,1,1) = {"
Z
i
i
a
i
a
a
a
a
i
b
G
"}
(10,1,1) = {"
q
N
i
L
i
i
i
i
L
i
S
y
"}
(11,1,1) = {"
G
G
V
m
n
K
K
K
I
K
E
b
"}
(12,1,1) = {"
G
G
G
G
q
q
Z
q
K
G
G
G
"}
