//MAP CONVERTED BY dmm2tgm.py THIS HEADER COMMENT PREVENTS RECONVERSION, DO NOT REMOVE
"a" = (
/turf/template_noop,
/area/template_noop)
"b" = (
/obj/structure/cannon{
	dir = 4;
	anchored = 0
	},
/obj/effect/turf_decal/siding/wood{
	dir = 1
	},
/turf/open/floor/wood/lavaland,
/area/ruin/unpowered)
"c" = (
/turf/closed/indestructible/riveted/boss,
/area/lavaland/surface/outdoors)
"e" = (
/obj/effect/spawner/random/structure/spikes,
/turf/closed/mineral/volcanic/lava_land_surface,
/area/lavaland/surface/outdoors)
"g" = (
/obj/structure/barricade/wooden,
/turf/open/floor/wood/lavaland,
/area/lavaland/surface/outdoors)
"i" = (
/obj/effect/decal/cleanable/ash{
	pixel_y = -7;
	pixel_x = 4
	},
/obj/structure/table/wood/shuttle_bar,
/obj/structure/fluff{
	density = 1;
	desc = "Ha ha ha, you fool!";
	icon = 'icons/obj/stack_objects.dmi';
	icon_state = "sheet-gold_3";
	name = "fool's gold"
	},
/turf/open/floor/wood/lavaland,
/area/ruin/unpowered)
"j" = (
/obj/structure/rack/wooden,
/obj/item/stack/cannonball/fourteen{
	pixel_x = 0;
	pixel_y = -4
	},
/obj/effect/turf_decal/siding/wood{
	dir = 9
	},
/obj/effect/spawner/random/entertainment/coin{
	pixel_x = 5;
	pixel_y = 6
	},
/turf/open/floor/wood/lavaland,
/area/ruin/unpowered)
"l" = (
/obj/structure/flora/rock/style_random,
/turf/closed/mineral/volcanic/lava_land_surface,
/area/lavaland/surface/outdoors)
"o" = (
/obj/item/chair/wood,
/obj/effect/turf_decal/siding/wood{
	dir = 9
	},
/obj/effect/mapping_helpers/broken_floor,
/turf/open/floor/wood/lavaland,
/area/ruin/unpowered)
"p" = (
/obj/effect/decal/cleanable/ash/large{
	pixel_x = 15;
	pixel_y = -5
	},
/obj/effect/turf_decal/siding/wood,
/obj/structure/barricade/wooden,
/turf/open/floor/wood/lavaland,
/area/lavaland/surface/outdoors)
"q" = (
/obj/item/xenoarch/useless_relic{
	name = "Ancient relic";
	desc = "Sort of relic that can be exported through Cargo."
	},
/obj/structure/flora/rock/pile/style_random,
/turf/closed/mineral/volcanic/lava_land_surface,
/area/lavaland/surface/outdoors)
"r" = (
/obj/structure/barricade/wooden/crude,
/obj/structure/barricade/wooden,
/obj/effect/turf_decal/siding/wood{
	dir = 1
	},
/obj/effect/mapping_helpers/broken_floor,
/obj/item/feather,
/turf/open/floor/wood/lavaland,
/area/ruin/unpowered)
"s" = (
/obj/structure/barricade/wooden,
/obj/effect/turf_decal/siding/wood{
	dir = 1
	},
/obj/effect/decal/cleanable/dirt,
/obj/item/clothing/under/costume/skeleton,
/turf/open/floor/wood/lavaland,
/area/ruin/unpowered)
"u" = (
/obj/effect/mapping_helpers/broken_floor,
/turf/open/floor/wood/lavaland,
/area/ruin/unpowered)
"x" = (
/obj/effect/decal/cleanable/ash/large,
/obj/effect/turf_decal/siding/wood{
	dir = 1
	},
/obj/effect/spawner/random/entertainment/coin{
	pixel_x = -8;
	pixel_y = -8
	},
/turf/open/floor/wood/lavaland,
/area/ruin/unpowered)
"y" = (
/obj/effect/turf_decal/siding/wood,
/obj/effect/decal/cleanable/dirt,
/turf/open/floor/wood/lavaland,
/area/lavaland/surface/outdoors)
"z" = (
/obj/structure/barricade/wooden/crude,
/obj/structure/barricade/wooden,
/obj/effect/turf_decal/siding/wood,
/turf/open/floor/wood/lavaland,
/area/ruin/unpowered)
"A" = (
/obj/effect/decal/cleanable/ants/fire,
/obj/effect/decal/cleanable/ash{
	pixel_x = -10;
	pixel_y = 3
	},
/obj/effect/turf_decal/siding/wood/corner{
	dir = 1
	},
/turf/open/floor/wood/lavaland,
/area/ruin/unpowered)
"C" = (
/turf/closed/wall/mineral/wood/nonmetal,
/area/lavaland/surface/outdoors)
"D" = (
/obj/effect/turf_decal/siding/wood,
/obj/structure/mineral_door/wood{
	color = "#6b6536"
	},
/obj/effect/turf_decal/siding/wood{
	dir = 1
	},
/obj/effect/decal/cleanable/dirt/dust,
/obj/structure/barricade/wooden/crude,
/obj/item/claymore/cutlass,
/turf/open/floor/wood/lavaland,
/area/ruin/unpowered)
"E" = (
/obj/effect/turf_decal/siding/wood/corner{
	dir = 8
	},
/obj/effect/decal/remains/human/smokey,
/obj/effect/spawner/random/entertainment/coin{
	pixel_x = -8;
	pixel_y = 9
	},
/turf/open/floor/wood/lavaland,
/area/ruin/unpowered)
"F" = (
/obj/effect/mapping_helpers/broken_floor,
/obj/effect/spawner/random/mob/necropolis_mob,
/turf/open/floor/wood/lavaland,
/area/lavaland/surface/outdoors)
"G" = (
/obj/item/stack/cannonball/shellball/seven,
/obj/effect/turf_decal/siding/wood{
	dir = 1
	},
/obj/effect/turf_decal/siding/wood,
/obj/effect/turf_decal/siding/wood{
	dir = 8
	},
/obj/effect/decal/cleanable/dirt/dust,
/obj/item/bedsheet/pirate{
	pixel_x = 5;
	pixel_y = 5
	},
/obj/structure/barricade/wooden,
/obj/structure/barricade/wooden/crude,
/turf/open/floor/wood/lavaland,
/area/ruin/unpowered)
"H" = (
/obj/effect/decal/cleanable/ash{
	pixel_y = 7
	},
/turf/open/floor/wood/lavaland,
/area/ruin/unpowered)
"I" = (
/obj/effect/mapping_helpers/broken_floor,
/obj/structure/mineral_door/wood{
	color = "#6b6536"
	},
/obj/structure/barricade/wooden/crude,
/obj/item/xenoarch/useless_relic{
	name = "Ancient relic";
	desc = "Sort of relic that can be exported through Cargo."
	},
/turf/open/floor/wood/lavaland,
/area/ruin/unpowered)
"J" = (
/obj/structure/barricade/wooden,
/obj/structure/barricade/wooden/crude,
/obj/effect/decal/cleanable/ash{
	pixel_x = -15;
	pixel_y = -7
	},
/turf/open/floor/wood/lavaland,
/area/ruin/unpowered)
"K" = (
/obj/structure/barricade/wooden,
/obj/effect/turf_decal/siding/wood{
	dir = 10
	},
/obj/item/xenoarch/useless_relic{
	name = "Ancient relic";
	desc = "Sort of relic that can be exported through Cargo."
	},
/turf/open/floor/wood/lavaland,
/area/ruin/unpowered)
"L" = (
/obj/structure/flora/rock/pile/style_random,
/obj/item/xenoarch/useless_relic/magnified{
	name = "Ancient relic";
	desc = "Sort of relic that can be exported through Cargo."
	},
/turf/closed/mineral/volcanic/lava_land_surface,
/area/lavaland/surface/outdoors)
"M" = (
/obj/structure/flora/rock/pile/style_random,
/obj/effect/spawner/random/structure/spikes,
/turf/closed/mineral/volcanic/lava_land_surface,
/area/lavaland/surface/outdoors)
"O" = (
/obj/effect/decal/remains/human/smokey,
/obj/effect/spawner/random/entertainment/coin{
	pixel_x = -8;
	pixel_y = 4
	},
/obj/effect/spawner/random/entertainment/coin{
	pixel_x = 6;
	pixel_y = 10
	},
/turf/open/floor/wood/lavaland,
/area/ruin/unpowered)
"P" = (
/obj/structure/barricade/wooden,
/obj/effect/turf_decal/siding/wood{
	dir = 10
	},
/obj/effect/spawner/random/clothing/pirate_or_bandana,
/turf/open/floor/wood/lavaland,
/area/ruin/unpowered)
"Q" = (
/obj/structure/barricade/wooden/crude,
/obj/item/ship_in_a_bottle,
/turf/closed/wall/mineral/wood/nonmetal,
/area/ruin/unpowered)
"R" = (
/obj/effect/turf_decal/siding/wood{
	dir = 4
	},
/obj/effect/mapping_helpers/broken_floor,
/obj/effect/decal/cleanable/ash{
	pixel_y = 3;
	pixel_x = 12
	},
/obj/effect/decal/cleanable/glass/titanium,
/obj/item/clothing/under/costume/sailor,
/obj/effect/spawner/random/mob/necropolis_mob,
/turf/open/floor/wood/lavaland,
/area/ruin/unpowered)
"T" = (
/turf/closed/wall/mineral/wood/nonmetal,
/area/ruin/unpowered)
"U" = (
/obj/structure/flora/rock/pile/style_random,
/obj/effect/spawner/random/mob/necropolis_mob,
/turf/closed/mineral/volcanic/lava_land_surface,
/area/lavaland/surface/outdoors)
"V" = (
/obj/structure/barricade/wooden,
/obj/structure/barricade/wooden/crude,
/obj/effect/decal/cleanable/ash{
	pixel_x = 15;
	pixel_y = -7
	},
/obj/effect/turf_decal/siding/wood/corner{
	dir = 8
	},
/obj/effect/turf_decal/siding/wood/corner{
	dir = 1
	},
/obj/effect/decal/cleanable/dirt,
/obj/item/clothing/shoes/pirate/armored,
/turf/open/floor/wood/lavaland,
/area/ruin/unpowered)
"W" = (
/obj/structure/flora/rock/pile/style_random,
/obj/structure/flora/rock/pile/style_random,
/turf/closed/mineral/volcanic/lava_land_surface,
/area/lavaland/surface/outdoors)
"X" = (
/obj/structure/barricade/wooden,
/obj/structure/barricade/wooden/crude,
/obj/effect/decal/cleanable/ash{
	pixel_x = -15;
	pixel_y = -3
	},
/turf/open/floor/wood/lavaland,
/area/ruin/unpowered)
"Z" = (
/obj/effect/decal/remains/human,
/obj/effect/turf_decal/siding/wood,
/obj/effect/decal/cleanable/glass/titanium,
/obj/structure/barricade/wooden,
/obj/structure/barricade/wooden/crude,
/turf/open/floor/wood/lavaland,
/area/ruin/unpowered)

(1,1,1) = {"
a
c
a
C
e
a
a
"}
(2,1,1) = {"
a
c
c
C
c
L
c
"}
(3,1,1) = {"
a
c
T
T
T
c
a
"}
(4,1,1) = {"
e
c
T
G
T
c
e
"}
(5,1,1) = {"
q
T
T
D
T
T
l
"}
(6,1,1) = {"
c
T
j
V
K
T
W
"}
(7,1,1) = {"
e
T
s
X
z
T
c
"}
(8,1,1) = {"
e
Q
b
J
Z
T
C
"}
(9,1,1) = {"
M
o
A
i
E
P
C
"}
(10,1,1) = {"
C
x
O
H
u
y
C
"}
(11,1,1) = {"
C
r
R
I
g
p
C
"}
(12,1,1) = {"
C
U
C
a
a
F
a
"}
