//MAP CONVERTED BY dmm2tgm.py THIS HEADER COMMENT PREVENTS RECONVERSION, DO NOT REMOVE
"a" = (
/turf/closed/mineral/random/high_chance/volcanic,
/area/lavaland/surface/outdoors)
"h" = (
/mob/living/basic/mining/brimdemon,
/mob/living/basic/mining/brimdemon,
/mob/living/basic/mining/brimdemon,
/obj/item/crusher_trophy/brimdemon_fang,
/obj/item/xenoarch/useless_relic/magnified{
	name = "Ancient relic";
	desc = "Sort of relic that can be exported through Cargo."
	},
/turf/closed/mineral/random/high_chance/volcanic,
/area/lavaland/surface/outdoors)
"x" = (
/mob/living/basic/mining/brimdemon,
/turf/closed/mineral/random/high_chance/volcanic,
/area/lavaland/surface/outdoors)

(1,1,1) = {"
x
a
a
"}
(2,1,1) = {"
a
h
x
"}
(3,1,1) = {"
x
a
a
"}
