//MAP CONVERTED BY dmm2tgm.py THIS HEADER COMMENT PREVENTS RECONVERSION, DO NOT REMOVE
"a" = (
/obj/structure/plasticflaps,
/turf/open/floor/plating/lavaland_atmos,
/area/lavaland/surface/outdoors)
"d" = (
/obj/effect/mapping_helpers/broken_floor,
/obj/effect/spawner/random/structure/grille,
/turf/open/floor/plating/lavaland_atmos,
/area/lavaland/surface/outdoors)
"i" = (
/obj/machinery/atmospherics/pipe/smart/simple/supply/hidden/layer2{
	dir = 4
	},
/obj/structure/cable,
/obj/structure/lattice/catwalk/mining,
/obj/machinery/atmospherics/pipe/smart/simple/scrubbers/hidden/layer4{
	dir = 4
	},
/obj/item/ammo_casing/rebar/healium{
	pixel_x = 0;
	pixel_y = -3
	},
/obj/item/clothing/mask/facehugger/dead,
/turf/open/floor/plating/lavaland_atmos,
/area/ruin/unpowered)
"n" = (
/obj/effect/mapping_helpers/broken_floor,
/turf/open/floor/plating/lavaland_atmos,
/area/lavaland/surface/outdoors)
"p" = (
/obj/structure/plasticflaps,
/obj/effect/mapping_helpers/broken_floor,
/turf/open/floor/plating/lavaland_atmos,
/area/lavaland/surface/outdoors)
"w" = (
/obj/machinery/atmospherics/pipe/smart/simple/supply/hidden/layer2{
	dir = 4
	},
/obj/structure/cable,
/obj/structure/lattice/catwalk/mining,
/obj/machinery/atmospherics/pipe/smart/simple/scrubbers/hidden/layer4{
	dir = 4
	},
/obj/effect/spawner/random/structure/closet_empty/crate/with_loot,
/turf/open/floor/plating/lavaland_atmos,
/area/ruin/unpowered)
"A" = (
/obj/machinery/atmospherics/pipe/smart/simple/supply/hidden/layer2{
	dir = 4
	},
/obj/structure/cable,
/obj/structure/lattice/catwalk/mining,
/obj/machinery/atmospherics/pipe/smart/simple/scrubbers/hidden/layer4{
	dir = 4
	},
/obj/effect/decal/cleanable/xenoblood,
/obj/item/mod/module/jetpack,
/turf/open/floor/plating/lavaland_atmos,
/area/ruin/unpowered)
"D" = (
/turf/closed/wall/r_wall,
/area/lavaland/surface/outdoors)
"F" = (
/obj/structure/girder,
/turf/open/floor/plating/lavaland_atmos,
/area/lavaland/surface/outdoors)
"I" = (
/obj/structure/lattice,
/turf/open/misc/asteroid/basalt/lava_land_surface,
/area/lavaland/surface/outdoors)
"L" = (
/turf/template_noop,
/area/template_noop)
"V" = (
/obj/machinery/atmospherics/pipe/smart/simple/supply/hidden/layer2{
	dir = 4
	},
/obj/structure/cable,
/obj/structure/lattice/catwalk/mining,
/obj/structure/marker_beacon/burgundy,
/obj/item/gun/ballistic/rifle/rebarxbow{
	pixel_y = -7
	},
/obj/machinery/atmospherics/pipe/smart/simple/scrubbers/hidden/layer4{
	dir = 4
	},
/obj/item/ammo_casing/rebar,
/mob/living/basic/alien,
/turf/open/floor/plating/lavaland_atmos,
/area/ruin/unpowered)
"X" = (
/obj/effect/spawner/random/structure/grille,
/turf/open/floor/plating/lavaland_atmos,
/area/lavaland/surface/outdoors)

(1,1,1) = {"
L
L
D
I
L
L
"}
(2,1,1) = {"
L
D
D
D
X
L
"}
(3,1,1) = {"
I
D
w
a
d
F
"}
(4,1,1) = {"
I
D
A
D
I
I
"}
(5,1,1) = {"
L
D
V
D
X
n
"}
(6,1,1) = {"
L
D
i
D
X
I
"}
(7,1,1) = {"
D
D
w
p
X
L
"}
(8,1,1) = {"
L
D
D
D
D
L
"}
(9,1,1) = {"
L
L
I
L
F
L
"}
