//MAP CONVERTED BY dmm2tgm.py THIS HEADER COMMENT PREVENTS RECONVERSION, DO NOT REMOVE
"a" = (
/turf/template_noop,
/area/template_noop)
"c" = (
/turf/closed/indestructible/riveted/boss,
/area/lavaland/surface/outdoors)
"d" = (
/obj/structure/flora/rock/pile/style_random,
/turf/closed/mineral/random/high_chance/volcanic,
/area/lavaland/surface/outdoors)
"h" = (
/obj/structure/punji_sticks/spikes,
/obj/structure/stone_tile/block/burnt,
/turf/closed/mineral/random/high_chance/volcanic,
/area/lavaland/surface/outdoors)
"x" = (
/obj/structure/stone_tile/surrounding_tile/cracked{
	dir = 1
	},
/turf/closed/mineral/random/high_chance/volcanic,
/area/lavaland/surface/outdoors)
"y" = (
/obj/structure/stone_tile/slab,
/turf/closed/mineral/volcanic/lava_land_surface,
/area/lavaland/surface/outdoors)
"C" = (
/obj/effect/mapping_helpers/bombable_wall,
/turf/closed/indestructible/riveted/boss/wasteland,
/area/lavaland/surface/outdoors)
"E" = (
/obj/structure/stone_tile/block/cracked{
	dir = 1
	},
/obj/structure/stone_tile/burnt{
	dir = 8
	},
/turf/closed/mineral/volcanic/lava_land_surface,
/area/lavaland/surface/outdoors)
"I" = (
/obj/structure/stone_tile/block,
/mob/living/basic/mining/legion,
/turf/closed/mineral/volcanic/lava_land_surface,
/area/lavaland/surface/outdoors)
"Q" = (
/obj/structure/stone_tile/surrounding/cracked{
	dir = 6
	},
/mob/living/basic/mining/legion,
/turf/closed/mineral/random/high_chance/volcanic,
/area/lavaland/surface/outdoors)
"V" = (
/obj/structure/flora/rock/pile/style_random,
/mob/living/basic/mining/legion,
/turf/closed/mineral/volcanic/lava_land_surface,
/area/lavaland/surface/outdoors)
"W" = (
/obj/structure/stone_tile/slab/cracked,
/turf/closed/mineral/random/high_chance/volcanic,
/area/lavaland/surface/outdoors)

(1,1,1) = {"
c
I
a
a
a
"}
(2,1,1) = {"
c
h
y
c
c
"}
(3,1,1) = {"
C
d
Q
E
c
"}
(4,1,1) = {"
c
c
W
x
c
"}
(5,1,1) = {"
a
a
a
V
C
"}
