//MAP CONVERTED BY dmm2tgm.py THIS HEADER COMMENT PREVENTS RECONVERSION, DO NOT REMOVE
"a" = (
/turf/template_noop,
/area/template_noop)
"c" = (
/obj/effect/spawner/random/structure/orevein_longregen,
/turf/closed/mineral/volcanic/lava_land_surface,
/area/lavaland/surface/outdoors)
"i" = (
/obj/structure/girder,
/obj/effect/spawner/random/structure/grille,
/turf/open/floor/plating/lavaland_atmos,
/area/lavaland/surface/outdoors)
"j" = (
/obj/structure/flora/rock/pile/style_random,
/turf/closed/mineral/volcanic/lava_land_surface,
/area/lavaland/surface/outdoors)
"o" = (
/obj/item/reagent_containers/hash,
/obj/structure/lattice/catwalk/mining,
/obj/machinery/atmospherics/pipe/smart/simple/scrubbers/hidden/layer4{
	dir = 4
	},
/obj/machinery/atmospherics/pipe/smart/simple/supply/hidden/layer2{
	dir = 4
	},
/obj/structure/cable,
/turf/open/floor/plating/lavaland_atmos,
/area/ruin/unpowered)
"q" = (
/obj/effect/spawner/random/structure/spikes,
/turf/closed/mineral/volcanic/lava_land_surface,
/area/lavaland/surface/outdoors)
"v" = (
/obj/structure/lattice,
/turf/open/misc/asteroid/basalt/lava_land_surface,
/area/lavaland/surface/outdoors)
"D" = (
/obj/item/reagent_containers/hash/dabs{
	pixel_x = 5;
	pixel_y = 8
	},
/obj/item/reagent_containers/hashbrick{
	pixel_x = -5
	},
/obj/item/reagent_containers/heroin,
/obj/item/reagent_containers/hash/dabs,
/obj/structure/lattice/catwalk/mining,
/obj/machinery/atmospherics/pipe/smart/simple/scrubbers/hidden/layer4{
	dir = 4
	},
/obj/machinery/atmospherics/pipe/smart/simple/supply/hidden/layer2{
	dir = 4
	},
/obj/structure/cable,
/turf/open/floor/plating/lavaland_atmos,
/area/ruin/unpowered)
"E" = (
/obj/item/reagent_containers/heroinbrick{
	pixel_y = 7
	},
/obj/item/reagent_containers/hash/dabs,
/obj/structure/lattice/catwalk/mining,
/obj/effect/spawner/random/structure/closet_empty/crate/with_loot,
/turf/open/floor/plating/lavaland_atmos,
/area/ruin/unpowered)
"F" = (
/obj/structure/lattice/catwalk/mining,
/obj/item/reagent_containers/heroinbrick{
	pixel_x = 9;
	pixel_y = 12
	},
/obj/item/reagent_containers/heroin{
	pixel_x = 9;
	pixel_y = 4
	},
/turf/open/floor/plating/lavaland_atmos,
/area/ruin/unpowered)
"K" = (
/turf/closed/wall/r_wall,
/area/lavaland/surface/outdoors)
"O" = (
/obj/item/reagent_containers/hash{
	pixel_x = 16;
	pixel_y = 7
	},
/obj/structure/lattice/catwalk/mining,
/obj/machinery/atmospherics/pipe/smart/simple/scrubbers/hidden/layer4{
	dir = 4
	},
/obj/machinery/atmospherics/pipe/smart/simple/supply/hidden/layer2{
	dir = 4
	},
/obj/structure/cable,
/obj/item/reagent_containers/heroinbrick,
/turf/open/floor/plating/lavaland_atmos,
/area/ruin/unpowered)
"Q" = (
/obj/structure/girder,
/obj/machinery/atmospherics/pipe/smart/simple/scrubbers/hidden/layer4{
	dir = 4
	},
/obj/machinery/atmospherics/pipe/smart/simple/supply/hidden/layer2{
	dir = 4
	},
/obj/structure/cable,
/obj/effect/spawner/random/structure/grille,
/turf/open/floor/plating/lavaland_atmos,
/area/lavaland/surface/outdoors)
"V" = (
/obj/structure/lattice,
/obj/effect/spawner/random/structure/grille,
/turf/open/misc/asteroid/basalt/lava_land_surface,
/area/lavaland/surface/outdoors)
"Y" = (
/obj/structure/flora/rock/pile/style_random,
/obj/item/xenoarch/useless_relic{
	name = "Ancient relic";
	desc = "Sort of relic that can be exported through Cargo."
	},
/turf/closed/mineral/volcanic/lava_land_surface,
/area/lavaland/surface/outdoors)

(1,1,1) = {"
a
v
q
a
a
"}
(2,1,1) = {"
a
K
i
v
j
"}
(3,1,1) = {"
K
O
F
i
q
"}
(4,1,1) = {"
K
D
E
K
c
"}
(5,1,1) = {"
K
o
K
K
q
"}
(6,1,1) = {"
q
Q
V
Y
a
"}
(7,1,1) = {"
a
j
K
a
a
"}
