//MAP CONVERTED BY dmm2tgm.py THIS HEADER COMMENT PREVENTS RECONVERSION, DO NOT REMOVE
"a" = (
/obj/structure/flora/rock/pile/style_random,
/turf/closed/mineral/volcanic/lava_land_surface,
/area/lavaland/surface/outdoors)
"b" = (
/obj/effect/spawner/random/structure/spikes,
/turf/closed/mineral/volcanic/lava_land_surface,
/area/lavaland/surface/outdoors)
"c" = (
/mob/living/basic/mining/bileworm,
/turf/open/misc/asteroid/lavaland_atmos,
/area/lavaland/surface/outdoors)
"g" = (
/obj/structure/water_source/puddle,
/turf/open/misc/asteroid/lavaland_atmos,
/area/ruin/unpowered)
"j" = (
/turf/closed/mineral/random/high_chance/volcanic,
/area/lavaland/surface/outdoors)
"k" = (
/obj/structure/stone_tile/slab/cracked,
/turf/closed/mineral/random/high_chance/volcanic,
/area/lavaland/surface/outdoors)
"l" = (
/obj/effect/decal/cleanable/xenoblood,
/turf/open/misc/asteroid/lavaland_atmos,
/area/lavaland/surface/outdoors)
"m" = (
/obj/structure/flora/rock/pile/style_random,
/turf/closed/mineral/random/high_chance/volcanic,
/area/lavaland/surface/outdoors)
"r" = (
/turf/closed/indestructible/riveted/boss,
/area/lavaland/surface/outdoors)
"s" = (
/turf/closed/mineral/volcanic/lava_land_surface,
/area/lavaland/surface/outdoors)
"u" = (
/obj/item/xenoarch/useless_relic/magnified,
/turf/open/misc/asteroid/lavaland_atmos,
/area/lavaland/surface/outdoors)
"w" = (
/obj/effect/spawner/random/structure/spikes,
/turf/closed/mineral/random/high_chance/volcanic,
/area/lavaland/surface/outdoors)
"z" = (
/obj/structure/flora/rock/pile/style_random,
/turf/open/misc/asteroid/lavaland_atmos,
/area/lavaland/surface/outdoors)
"C" = (
/obj/item/xenoarch/useless_relic{
	name = "Ancient relic";
	desc = "Sort of relic that can be exported through Cargo."
	},
/turf/closed/mineral/volcanic/lava_land_surface,
/area/lavaland/surface/outdoors)
"F" = (
/obj/structure/stone_tile/slab/cracked,
/turf/closed/mineral/volcanic/lava_land_surface,
/area/lavaland/surface/outdoors)
"G" = (
/obj/structure/stone_tile/slab,
/turf/closed/mineral/volcanic/lava_land_surface,
/area/lavaland/surface/outdoors)
"H" = (
/obj/structure/flora/ash/cacti,
/turf/open/misc/asteroid/lavaland_atmos,
/area/lavaland/surface/outdoors)
"J" = (
/mob/living/basic/mining/bileworm/vileworm,
/turf/open/misc/asteroid/lavaland_atmos,
/area/lavaland/surface/outdoors)
"L" = (
/turf/open/misc/asteroid/lavaland_atmos,
/area/lavaland/surface/outdoors)
"M" = (
/obj/effect/mapping_helpers/bombable_wall,
/turf/closed/indestructible/riveted/boss/wasteland,
/area/lavaland/surface/outdoors)
"P" = (
/obj/effect/decal/cleanable/xenoblood{
	icon_state = "xltrails_1";
	dir = 8
	},
/turf/open/misc/asteroid/lavaland_atmos,
/area/lavaland/surface/outdoors)
"Y" = (
/turf/template_noop,
/area/template_noop)

(1,1,1) = {"
Y
a
r
Y
s
r
r
s
Y
M
Y
Y
"}
(2,1,1) = {"
Y
b
r
r
G
r
r
G
r
r
a
Y
"}
(3,1,1) = {"
r
r
r
j
s
z
L
w
a
r
r
r
"}
(4,1,1) = {"
b
M
a
C
H
c
g
u
s
b
r
Y
"}
(5,1,1) = {"
b
F
s
L
L
J
P
L
H
j
F
a
"}
(6,1,1) = {"
r
r
j
z
J
L
c
z
s
a
w
r
"}
(7,1,1) = {"
r
s
j
c
g
u
L
j
s
Y
r
r
"}
(8,1,1) = {"
Y
G
j
H
L
z
s
b
Y
Y
r
Y
"}
(9,1,1) = {"
Y
r
s
s
l
j
b
Y
Y
Y
r
Y
"}
(10,1,1) = {"
r
r
r
s
j
s
Y
Y
Y
r
r
r
"}
(11,1,1) = {"
b
m
r
M
G
r
r
k
r
r
Y
Y
"}
(12,1,1) = {"
Y
b
r
b
b
r
r
Y
Y
r
Y
Y
"}
