//MAP CONVERTED BY dmm2tgm.py THIS HEADER COMMENT PREVENTS RECONVERSION, DO NOT REMOVE
"aa" = (
/obj/structure/stone_tile{
	dir = 8
	},
/obj/structure/stone_tile/cracked{
	dir = 4
	},
/turf/open/lava/smooth/lava_land_surface,
/area/lavaland/surface/outdoors)
"au" = (
/obj/structure/stone_tile/slab/cracked{
	dir = 6
	},
/turf/closed/mineral/random/high_chance/volcanic,
/area/ruin/unpowered)
"aQ" = (
/obj/structure/stone_tile/slab/cracked{
	dir = 6
	},
/obj/item/coin/silver,
/turf/closed/mineral/random/high_chance/volcanic,
/area/lavaland/surface/outdoors)
"cH" = (
/obj/structure/punji_sticks/spikes,
/turf/template_noop,
/area/template_noop)
"cK" = (
/obj/structure/stone_tile,
/obj/structure/stone_tile{
	dir = 1
	},
/obj/structure/stone_tile{
	dir = 4
	},
/turf/closed/mineral/strange_rock/volcanic,
/area/lavaland/surface/outdoors)
"dl" = (
/obj/structure/punji_sticks/spikes,
/turf/closed/mineral/strange_rock/volcanic,
/area/lavaland/surface/outdoors)
"dm" = (
/obj/structure/stone_tile/surrounding/cracked{
	pixel_x = 1;
	pixel_y = -1
	},
/obj/structure/stone_tile/center/burnt,
/turf/open/lava/smooth/lava_land_surface,
/area/lavaland/surface/outdoors)
"dH" = (
/obj/structure/stone_tile{
	dir = 8
	},
/obj/structure/stone_tile{
	dir = 4
	},
/obj/structure/stone_tile/burnt,
/turf/closed/mineral/volcanic/lava_land_surface,
/area/lavaland/surface/outdoors)
"eE" = (
/mob/living/basic/mining/brimdemon,
/obj/item/clothing/head/ash_headdress/winged,
/mob/living/basic/mining/brimdemon,
/mob/living/basic/mining/brimdemon,
/turf/closed/mineral/random/high_chance/volcanic,
/area/lavaland/surface/outdoors)
"fG" = (
/turf/open/misc/asteroid/basalt/lava_land_surface,
/area/lavaland/surface/outdoors)
"fW" = (
/obj/structure/stone_tile{
	dir = 8
	},
/obj/structure/stone_tile{
	dir = 4
	},
/turf/closed/mineral/volcanic/lava_land_surface,
/area/lavaland/surface/outdoors)
"hd" = (
/obj/structure/stone_tile/slab/cracked{
	dir = 4
	},
/obj/structure/stone_tile/slab/cracked{
	dir = 8
	},
/turf/open/misc/asteroid/basalt/lava_land_surface,
/area/lavaland/surface/outdoors)
"ib" = (
/obj/structure/flora/rock/pile/style_random,
/turf/closed/mineral/random/high_chance/volcanic,
/area/lavaland/surface/outdoors)
"id" = (
/obj/structure/stone_tile/slab/cracked{
	dir = 4
	},
/obj/structure/stone_tile/slab/cracked{
	dir = 8
	},
/turf/open/lava/smooth/lava_land_surface,
/area/lavaland/surface/outdoors)
"ij" = (
/obj/structure/stone_tile/slab/cracked{
	dir = 4
	},
/obj/structure/stone_tile/slab/cracked{
	dir = 8
	},
/turf/open/misc/asteroid/basalt/lava_land_surface,
/area/ruin/unpowered)
"iN" = (
/obj/structure/stone_tile,
/obj/structure/stone_tile{
	dir = 8
	},
/obj/structure/stone_tile{
	dir = 1
	},
/obj/structure/stone_tile{
	dir = 4
	},
/turf/open/misc/asteroid/basalt/lava_land_surface,
/area/lavaland/surface/outdoors)
"je" = (
/turf/template_noop,
/area/template_noop)
"me" = (
/obj/item/stack/sheet/mineral/metal_hydrogen,
/obj/structure/stone_tile/slab,
/turf/closed/mineral/random/high_chance/volcanic,
/area/ruin/unpowered)
"mz" = (
/mob/living/basic/faithless{
	faction = list("mining","boss","hell");
	name = "Ancient Demon";
	desc = "A demonic creature that moves relatively fast, but doesn't do a lot of damage.";
	attack_sound = 'sound/effects/wounds/crackandbleed.ogg';
	attack_verb_simple = "tears";
	butcher_results = list(/obj/item/food/grown/mushroom/glowshroom/shadowshroom = 1,/obj/item/food/meat/slab/human/mutant/shadow = 1,/obj/item/organ/internal/eyes/shadow = 1,/obj/item/organ/external/tail/lizard = 1);
	icon = 'modular_nova/master_files/icons/mob/newmobs32x64.dmi';
	icon_dead = "demondead";
	icon_living = "engorgedemon";
	icon_state = "engorgedemon";
	melee_attack_cooldown = 5;
	speed = -0.1;
	damage_coeff = list("brute" = 1, "burn" = 1, "toxin" = 1, "stamina" = 0.5, "oxygen" = 1);
	melee_damage_lower = 3;
	melee_damage_upper = 7;
	health = 640;
	bare_wound_bonus = 5;
	wound_bonus = -1;
	obj_damage = 40;
	attack_vis_effect = "slash";
	attack_verb_continuous = "maniacally tears";
	maxHealth = 240
	},
/turf/closed/mineral/random/high_chance/volcanic,
/area/ruin/unpowered)
"ng" = (
/turf/open/lava/smooth/lava_land_surface,
/area/lavaland/surface/outdoors)
"nG" = (
/obj/structure/stone_tile/slab,
/turf/closed/mineral/random/high_chance/volcanic,
/area/lavaland/surface/outdoors)
"nL" = (
/obj/structure/stone_tile/slab/cracked{
	dir = 4
	},
/obj/structure/stone_tile/slab/cracked{
	dir = 1
	},
/turf/closed/mineral/random/high_chance/volcanic,
/area/lavaland/surface/outdoors)
"pg" = (
/obj/structure/stone_tile/slab/cracked{
	dir = 5
	},
/obj/structure/stone_tile/slab/cracked{
	dir = 8
	},
/turf/open/lava/smooth/lava_land_surface,
/area/lavaland/surface/outdoors)
"qy" = (
/obj/structure/stone_tile/surrounding_tile{
	dir = 1
	},
/obj/structure/stone_tile/surrounding_tile{
	dir = 8
	},
/turf/open/lava/smooth/lava_land_surface,
/area/lavaland/surface/outdoors)
"qA" = (
/obj/structure/stone_tile/slab,
/mob/living/basic/mining/goliath,
/turf/closed/mineral/random/high_chance/volcanic,
/area/lavaland/surface/outdoors)
"rs" = (
/obj/structure/stone_tile/slab/cracked{
	dir = 6
	},
/turf/open/lava/smooth/lava_land_surface,
/area/lavaland/surface/outdoors)
"rK" = (
/obj/structure/stone_tile,
/obj/structure/stone_tile{
	dir = 8
	},
/obj/structure/stone_tile{
	dir = 1
	},
/obj/structure/stone_tile{
	dir = 4
	},
/turf/closed/mineral/volcanic/lava_land_surface,
/area/lavaland/surface/outdoors)
"sq" = (
/turf/closed/mineral/strange_rock/volcanic,
/area/lavaland/surface/outdoors)
"sv" = (
/obj/structure/stone_tile,
/obj/structure/stone_tile{
	dir = 1
	},
/turf/closed/mineral/random/high_chance/volcanic,
/area/lavaland/surface/outdoors)
"sQ" = (
/obj/structure/stone_tile/slab,
/mob/living/basic/mining/brimdemon,
/turf/open/misc/asteroid/basalt/lava_land_surface,
/area/ruin/unpowered)
"sR" = (
/turf/closed/mineral/random/high_chance/volcanic,
/area/lavaland/surface/outdoors)
"sV" = (
/obj/structure/stone_tile/slab/cracked{
	dir = 4
	},
/obj/structure/stone_tile/slab/cracked{
	dir = 1
	},
/turf/open/misc/asteroid/basalt/lava_land_surface,
/area/lavaland/surface/outdoors)
"tX" = (
/obj/structure/stone_tile,
/obj/structure/stone_tile{
	dir = 8
	},
/obj/structure/stone_tile{
	dir = 4
	},
/turf/closed/mineral/random/high_chance/volcanic,
/area/lavaland/surface/outdoors)
"ua" = (
/obj/structure/stone_tile{
	dir = 8
	},
/obj/structure/stone_tile{
	dir = 1
	},
/obj/structure/stone_tile/burnt,
/turf/open/misc/asteroid/basalt/lava_land_surface,
/area/lavaland/surface/outdoors)
"ue" = (
/obj/structure/stone_tile/block,
/obj/structure/stone_tile/block/cracked{
	dir = 1
	},
/turf/open/misc/asteroid/basalt/lava_land_surface,
/area/lavaland/surface/outdoors)
"uo" = (
/obj/structure/stone_tile/slab/cracked{
	dir = 4
	},
/obj/structure/stone_tile/slab/cracked{
	dir = 1
	},
/turf/closed/mineral/volcanic/lava_land_surface,
/area/lavaland/surface/outdoors)
"uV" = (
/obj/structure/stone_tile/block/burnt,
/obj/structure/stone_tile/block/cracked{
	dir = 1
	},
/turf/open/lava/smooth/lava_land_surface,
/area/lavaland/surface/outdoors)
"vd" = (
/obj/structure/stone_tile/slab,
/turf/closed/mineral/volcanic/lava_land_surface,
/area/lavaland/surface/outdoors)
"vs" = (
/obj/structure/stone_tile/slab/cracked{
	dir = 4
	},
/turf/open/lava/smooth/lava_land_surface,
/area/lavaland/surface/outdoors)
"vy" = (
/obj/structure/stone_tile/slab,
/turf/closed/mineral/random/high_chance/volcanic,
/area/ruin/unpowered)
"wb" = (
/obj/structure/stone_tile{
	dir = 1
	},
/obj/structure/stone_tile/burnt,
/turf/closed/mineral/volcanic/lava_land_surface,
/area/lavaland/surface/outdoors)
"wn" = (
/obj/item/circular_saw/ashwalker,
/obj/structure/stone_tile/slab,
/turf/closed/mineral/volcanic/lava_land_surface,
/area/lavaland/surface/outdoors)
"wQ" = (
/obj/structure/stone_tile/slab,
/obj/item/coin/silver,
/turf/open/misc/asteroid/basalt/lava_land_surface,
/area/ruin/unpowered)
"xy" = (
/obj/structure/stone_tile/slab,
/obj/item/coin/silver,
/turf/closed/mineral/random/high_chance/volcanic,
/area/lavaland/surface/outdoors)
"yN" = (
/obj/item/clothing/shoes/jackboots/ashwalker,
/obj/structure/stone_tile/slab,
/turf/open/misc/asteroid/basalt/lava_land_surface,
/area/ruin/unpowered)
"zN" = (
/obj/structure/punji_sticks/spikes,
/turf/closed/mineral/random/high_chance/volcanic,
/area/ruin/unpowered)
"Ac" = (
/obj/structure/stone_tile/slab/cracked{
	dir = 4
	},
/obj/structure/stone_tile/slab/cracked{
	dir = 1
	},
/turf/open/lava/smooth/lava_land_surface,
/area/lavaland/surface/outdoors)
"Ai" = (
/obj/structure/stone_tile/block{
	dir = 1
	},
/turf/open/misc/asteroid/basalt/lava_land_surface,
/area/lavaland/surface/outdoors)
"At" = (
/obj/structure/stone_tile/block/cracked,
/turf/open/lava/smooth/lava_land_surface,
/area/lavaland/surface/outdoors)
"Bn" = (
/obj/structure/stone_tile/slab/cracked{
	dir = 4
	},
/obj/structure/stone_tile/slab/cracked{
	dir = 8
	},
/turf/closed/mineral/volcanic/lava_land_surface,
/area/lavaland/surface/outdoors)
"BQ" = (
/obj/structure/punji_sticks/spikes,
/obj/item/coin/silver,
/turf/closed/mineral/volcanic/lava_land_surface,
/area/lavaland/surface/outdoors)
"BX" = (
/obj/item/reagent_containers/cup/bowl/wood_bowl,
/obj/structure/stone_tile/slab,
/turf/closed/mineral/random/high_chance/volcanic,
/area/lavaland/surface/outdoors)
"CI" = (
/obj/structure/stone_tile/block/cracked{
	dir = 4
	},
/turf/open/misc/asteroid/basalt/lava_land_surface,
/area/lavaland/surface/outdoors)
"Dz" = (
/obj/item/ammo_casing/rebar,
/turf/closed/mineral/volcanic/lava_land_surface,
/area/lavaland/surface/outdoors)
"DS" = (
/turf/closed/mineral/random/high_chance/volcanic,
/area/ruin/unpowered)
"DX" = (
/obj/structure/stone_tile/surrounding_tile,
/obj/structure/stone_tile/surrounding_tile{
	dir = 4
	},
/turf/open/lava/smooth/lava_land_surface,
/area/lavaland/surface/outdoors)
"EF" = (
/obj/structure/stone_tile/surrounding,
/obj/structure/stone_tile/center/cracked,
/turf/open/misc/asteroid/basalt/lava_land_surface,
/area/lavaland/surface/outdoors)
"Fg" = (
/obj/structure/stone_tile/slab/burnt,
/turf/open/lava/smooth/lava_land_surface,
/area/lavaland/surface/outdoors)
"Hc" = (
/obj/structure/stone_tile{
	dir = 1
	},
/obj/structure/stone_tile{
	dir = 4
	},
/obj/structure/stone_tile/burnt,
/turf/closed/mineral/volcanic/lava_land_surface,
/area/lavaland/surface/outdoors)
"HD" = (
/obj/structure/flora/rock/pile/style_random,
/mob/living/basic/mining/brimdemon,
/turf/open/misc/asteroid/basalt/lava_land_surface,
/area/lavaland/surface/outdoors)
"HJ" = (
/obj/structure/stone_tile{
	dir = 1
	},
/obj/structure/stone_tile{
	dir = 4
	},
/obj/structure/stone_tile/burnt,
/turf/open/misc/asteroid/basalt/lava_land_surface,
/area/lavaland/surface/outdoors)
"HT" = (
/turf/closed/indestructible/riveted/boss,
/area/lavaland/surface/outdoors)
"Iz" = (
/obj/structure/stone_tile,
/obj/structure/stone_tile{
	dir = 8
	},
/turf/closed/mineral/random/high_chance/volcanic,
/area/lavaland/surface/outdoors)
"Jk" = (
/obj/structure/stone_tile/slab/cracked{
	dir = 6
	},
/turf/open/misc/asteroid/basalt/lava_land_surface,
/area/lavaland/surface/outdoors)
"Kk" = (
/obj/structure/stone_tile/surrounding,
/obj/structure/stone_tile/center/cracked,
/mob/living/basic/mining/goliath,
/turf/closed/mineral/random/high_chance/volcanic,
/area/lavaland/surface/outdoors)
"Ku" = (
/obj/structure/stone_tile{
	dir = 1
	},
/obj/structure/stone_tile{
	dir = 4
	},
/obj/structure/stone_tile/burnt,
/turf/open/lava/smooth/lava_land_surface,
/area/lavaland/surface/outdoors)
"Lh" = (
/obj/item/forging/hammer/primitive,
/obj/structure/stone_tile/slab,
/turf/closed/mineral/volcanic/lava_land_surface,
/area/lavaland/surface/outdoors)
"LH" = (
/obj/item/reagent_containers/cup/bowl/wood_bowl,
/obj/structure/stone_tile/slab,
/turf/open/misc/asteroid/basalt/lava_land_surface,
/area/ruin/unpowered)
"Mr" = (
/obj/structure/stone_tile,
/obj/structure/stone_tile{
	dir = 1
	},
/turf/closed/mineral/volcanic/lava_land_surface,
/area/lavaland/surface/outdoors)
"Mt" = (
/obj/structure/stone_tile{
	dir = 8
	},
/obj/structure/punji_sticks/spikes,
/turf/closed/mineral/volcanic/lava_land_surface,
/area/lavaland/surface/outdoors)
"Nv" = (
/obj/structure/stone_tile/slab/cracked{
	dir = 6
	},
/obj/item/clothing/suit/ash_plates/decorated,
/mob/living/basic/mining/legion,
/turf/closed/mineral/volcanic/lava_land_surface,
/area/lavaland/surface/outdoors)
"Oj" = (
/obj/structure/punji_sticks/spikes,
/turf/closed/mineral/random/high_chance/volcanic,
/area/lavaland/surface/outdoors)
"On" = (
/obj/structure/stone_tile/slab/cracked{
	dir = 6
	},
/turf/closed/mineral/volcanic/lava_land_surface,
/area/lavaland/surface/outdoors)
"OK" = (
/obj/structure/stone_tile/slab/cracked{
	dir = 4
	},
/obj/structure/stone_tile/slab/cracked{
	dir = 8
	},
/turf/closed/mineral/random/high_chance/volcanic,
/area/lavaland/surface/outdoors)
"Po" = (
/obj/structure/stone_tile/slab,
/turf/open/misc/asteroid/basalt/lava_land_surface,
/area/lavaland/surface/outdoors)
"Pq" = (
/obj/structure/stone_tile,
/turf/closed/mineral/random/high_chance/volcanic,
/area/lavaland/surface/outdoors)
"PN" = (
/obj/structure/punji_sticks/spikes,
/turf/closed/mineral/volcanic/lava_land_surface,
/area/lavaland/surface/outdoors)
"Rb" = (
/obj/structure/stone_tile/slab/cracked{
	dir = 6
	},
/turf/closed/mineral/random/high_chance/volcanic,
/area/lavaland/surface/outdoors)
"Rq" = (
/obj/structure/stone_tile/block{
	dir = 1
	},
/obj/structure/stone_tile/block/cracked,
/turf/open/lava/smooth/lava_land_surface,
/area/lavaland/surface/outdoors)
"Rt" = (
/obj/structure/stone_tile/block/burnt,
/obj/structure/punji_sticks/spikes,
/turf/open/misc/asteroid/basalt/lava_land_surface,
/area/lavaland/surface/outdoors)
"Rz" = (
/obj/structure/flora/rock/pile/style_random,
/turf/closed/mineral/volcanic/lava_land_surface,
/area/lavaland/surface/outdoors)
"RF" = (
/obj/structure/stone_tile/surrounding,
/obj/structure/stone_tile/center,
/turf/closed/mineral/volcanic/lava_land_surface,
/area/lavaland/surface/outdoors)
"RU" = (
/obj/item/crowbar/ashwalker,
/obj/structure/stone_tile/slab,
/turf/open/misc/asteroid/basalt/lava_land_surface,
/area/lavaland/surface/outdoors)
"SB" = (
/obj/structure/stone_tile/slab,
/turf/open/misc/asteroid/basalt/lava_land_surface,
/area/ruin/unpowered)
"SU" = (
/obj/structure/stone_tile/slab/cracked{
	dir = 4
	},
/turf/closed/mineral/random/high_chance/volcanic,
/area/lavaland/surface/outdoors)
"Tz" = (
/turf/closed/mineral/volcanic/lava_land_surface,
/area/ruin/unpowered)
"TO" = (
/obj/item/clothing/suit/cloak/ashencloak,
/obj/structure/stone_tile/slab,
/turf/closed/mineral/random/high_chance/volcanic,
/area/ruin/unpowered)
"TU" = (
/obj/effect/mapping_helpers/bombable_wall,
/turf/closed/indestructible/riveted/boss/wasteland,
/area/lavaland/surface/outdoors)
"Ub" = (
/obj/structure/stone_tile/slab/cracked{
	dir = 6
	},
/turf/closed/mineral/strange_rock/volcanic,
/area/lavaland/surface/outdoors)
"Ue" = (
/obj/structure/stone_tile,
/obj/structure/stone_tile{
	dir = 8
	},
/obj/structure/stone_tile{
	dir = 1
	},
/turf/closed/mineral/volcanic/lava_land_surface,
/area/lavaland/surface/outdoors)
"Uk" = (
/obj/item/kitchen/spoon,
/obj/structure/stone_tile/slab,
/turf/closed/mineral/random/high_chance/volcanic,
/area/lavaland/surface/outdoors)
"UX" = (
/obj/structure/stone_tile/block/burnt,
/turf/open/lava/smooth/lava_land_surface,
/area/lavaland/surface/outdoors)
"Vt" = (
/obj/structure/stone_tile/slab,
/turf/open/lava/smooth/lava_land_surface,
/area/lavaland/surface/outdoors)
"Vv" = (
/obj/structure/stone_tile/surrounding_tile{
	dir = 4
	},
/obj/structure/stone_tile/surrounding_tile,
/mob/living/basic/mining/brimdemon,
/turf/open/misc/asteroid/basalt/lava_land_surface,
/area/lavaland/surface/outdoors)
"Vz" = (
/obj/structure/stone_tile/surrounding_tile{
	dir = 1
	},
/turf/open/lava/smooth/lava_land_surface,
/area/lavaland/surface/outdoors)
"VJ" = (
/obj/structure/stone_tile{
	dir = 8
	},
/obj/structure/stone_tile{
	dir = 1
	},
/obj/structure/stone_tile/burnt,
/obj/structure/stone_tile/cracked{
	dir = 4
	},
/turf/open/misc/asteroid/basalt/lava_land_surface,
/area/lavaland/surface/outdoors)
"WP" = (
/obj/structure/stone_tile/block{
	dir = 4
	},
/obj/structure/stone_tile/block{
	dir = 8
	},
/turf/closed/mineral/volcanic/lava_land_surface,
/area/lavaland/surface/outdoors)
"Xb" = (
/turf/closed/mineral/volcanic/lava_land_surface,
/area/lavaland/surface/outdoors)
"Xe" = (
/obj/structure/stone_tile{
	dir = 8
	},
/obj/structure/stone_tile{
	dir = 1
	},
/obj/structure/stone_tile/burnt,
/obj/structure/stone_tile/cracked{
	dir = 4
	},
/mob/living/basic/mining/lobstrosity/lava,
/turf/open/misc/asteroid/basalt/lava_land_surface,
/area/lavaland/surface/outdoors)
"Yd" = (
/turf/closed/indestructible/riveted/boss,
/area/ruin/unpowered)
"YJ" = (
/obj/structure/stone_tile/block{
	dir = 4
	},
/turf/closed/mineral/volcanic/lava_land_surface,
/area/lavaland/surface/outdoors)
"Zh" = (
/obj/item/forging/tongs/primitive,
/obj/structure/stone_tile/slab,
/turf/closed/mineral/random/high_chance/volcanic,
/area/ruin/unpowered)
"Zp" = (
/obj/structure/stone_tile{
	dir = 8
	},
/obj/structure/stone_tile{
	dir = 1
	},
/obj/structure/stone_tile{
	dir = 4
	},
/turf/closed/mineral/volcanic/lava_land_surface,
/area/lavaland/surface/outdoors)
"Zw" = (
/obj/structure/stone_tile/slab,
/mob/living/basic/mining/brimdemon,
/obj/item/clothing/gloves/military/ashwalk,
/turf/closed/mineral/volcanic/lava_land_surface,
/area/lavaland/surface/outdoors)

(1,1,1) = {"
je
Xb
sR
sR
PN
Rz
je
je
je
Xb
sR
je
je
Xb
ib
PN
Xb
je
Xb
Dz
ib
Xb
Xb
je
"}
(2,1,1) = {"
Xb
Zp
HT
HT
HT
TU
Xb
TU
HT
HT
fW
HT
HT
HT
HT
HT
HT
HT
HT
TU
HT
HT
dH
Xb
"}
(3,1,1) = {"
Oj
HT
HT
Rb
nG
uo
Xb
Bn
vd
HT
HT
HT
nL
vd
RU
HT
vd
vd
nG
qA
SU
HT
HT
sR
"}
(4,1,1) = {"
Xb
HT
nG
nG
BQ
nG
vd
je
vd
vd
HT
nG
nG
vd
rs
Vt
At
vd
aQ
nG
nG
nG
HT
Xb
"}
(5,1,1) = {"
je
HT
nG
nG
Zw
Rb
je
je
nG
vd
HT
Rb
vd
Fg
ng
ng
ng
Fg
PN
BX
cH
Rb
HT
Xb
"}
(6,1,1) = {"
je
HT
HT
SU
vd
wn
je
je
je
HT
HT
HT
vd
ng
ng
ng
Ac
Po
nG
nG
nG
HT
HT
je
"}
(7,1,1) = {"
je
Hc
HT
TU
HT
HT
je
Jk
HT
HT
rK
HT
ng
ng
HT
HT
HT
HT
vd
OK
HT
HT
ua
je
"}
(8,1,1) = {"
je
Xb
Xb
Xb
Xb
Xb
vd
Po
Xb
sq
HD
ng
ng
je
ng
ng
ng
je
dl
nG
sR
je
je
je
"}
(9,1,1) = {"
je
Po
Mt
OK
WP
nG
RF
vd
Ue
Fg
Rq
DX
qy
uV
pg
Ku
Vt
dm
Po
WP
vd
VJ
Po
ue
"}
(10,1,1) = {"
Ai
Jk
HJ
vd
YJ
nG
Kk
vd
Xe
Po
UX
Vz
Vv
Rq
Fg
aa
Po
EF
Po
CI
vd
Pq
vd
Rt
"}
(11,1,1) = {"
je
je
je
Xb
Xb
Xb
Rb
vd
Xb
Xb
je
ng
ng
ng
ng
je
HD
ng
rs
Po
je
Xb
PN
je
"}
(12,1,1) = {"
Xb
Zp
HT
HT
HT
HT
vd
Po
HT
HT
iN
HT
HT
ng
HT
HT
HT
ng
ng
vs
HT
HT
tX
je
"}
(13,1,1) = {"
PN
HT
HT
OK
nG
nG
On
Po
Po
HT
HT
HT
ng
ng
ng
je
ng
ng
ng
ng
ng
HT
HT
je
"}
(14,1,1) = {"
Xb
HT
nG
nG
Uk
dl
vd
fG
Fg
ng
ng
ng
ng
je
ng
ng
ng
Fg
At
ng
ng
ng
HT
je
"}
(15,1,1) = {"
Rz
HT
nG
nG
PN
vd
Po
Vt
id
ng
HT
At
Vt
Po
Fg
At
Vt
vd
vd
vd
ng
id
HT
je
"}
(16,1,1) = {"
je
HT
SU
vd
Nv
Po
sV
ng
ng
ng
HT
nG
Ub
je
Po
Po
HT
vd
xy
Rb
nG
nG
HT
je
"}
(17,1,1) = {"
je
HT
vd
vd
Vt
Fg
Vt
ng
Vt
rs
HT
vd
vd
vd
vd
Po
HT
nG
nG
nG
nG
nG
HT
je
"}
(18,1,1) = {"
je
HT
HT
rs
ng
ng
HT
ng
HT
HT
HT
HT
je
vd
HT
HT
HT
HT
HT
HT
HT
HT
HT
Xb
"}
(19,1,1) = {"
je
HT
Po
ng
ng
ng
ng
ng
yN
ij
HT
je
je
vd
nG
On
HT
vy
vy
Zh
vy
me
HT
Oj
"}
(20,1,1) = {"
PN
HT
At
ng
Ac
ng
ng
rs
SB
sQ
HT
je
nG
eE
Oj
vd
PN
je
Tz
vy
zN
vy
HT
Xb
"}
(21,1,1) = {"
sR
HT
Fg
ng
Vt
At
Fg
SB
LH
SB
HT
Rb
nG
Oj
nG
nG
PN
je
DS
mz
vy
au
HT
Oj
"}
(22,1,1) = {"
Xb
HT
HT
rs
Po
HT
hd
wQ
SB
HT
HT
HT
nG
nG
On
Lh
HT
je
Tz
Tz
TO
Yd
HT
Iz
"}
(23,1,1) = {"
Xb
cK
HT
HT
HT
HT
HT
TU
HT
HT
wb
HT
HT
HT
Xb
PN
Xb
PN
TU
HT
HT
HT
Ue
Xb
"}
(24,1,1) = {"
je
Xb
PN
Xb
je
je
je
je
Xb
Oj
sR
Oj
Xb
je
je
Mr
PN
sv
PN
Mr
Oj
Mr
Xb
je
"}
