//MAP CONVERTED BY dmm2tgm.py THIS HEADER COMMENT PREVENTS RECONVERSION, DO NOT REMOVE
"a" = (
/obj/structure/stone_tile/slab,
/obj/item/stack/sheet/bone,
/turf/open/misc/asteroid/basalt/lava_land_surface,
/area/ruin/unpowered)
"b" = (
/obj/effect/mapping_helpers/bombable_wall,
/turf/closed/indestructible/riveted/boss/wasteland,
/area/lavaland/surface/outdoors)
"c" = (
/obj/structure/wall_torch/mount_only,
/turf/closed/indestructible/riveted/boss,
/area/ruin/unpowered)
"d" = (
/obj/structure/stone_tile/surrounding_tile/cracked{
	dir = 1
	},
/turf/closed/mineral/volcanic/lava_land_surface,
/area/lavaland/surface/outdoors)
"e" = (
/obj/structure/stone_tile/slab,
/obj/effect/decal/cleanable/blood/old{
	pixel_x = -5;
	pixel_y = 15
	},
/turf/closed/mineral/volcanic/lava_land_surface,
/area/lavaland/surface/outdoors)
"f" = (
/obj/structure/stone_tile/slab,
/obj/structure/bed/maint,
/turf/closed/mineral/random/high_chance/volcanic,
/area/ruin/unpowered)
"g" = (
/turf/closed/indestructible/riveted/boss,
/area/ruin/unpowered)
"h" = (
/obj/structure/stone_tile/slab,
/obj/effect/decal/cleanable/blood/old{
	icon_state = "floor4-old"
	},
/turf/open/misc/asteroid/basalt/lava_land_surface,
/area/ruin/unpowered)
"i" = (
/obj/structure/stone_tile/slab/cracked{
	dir = 5
	},
/obj/structure/stone_tile/slab/cracked{
	dir = 8
	},
/turf/closed/mineral/random/high_chance/volcanic,
/area/lavaland/surface/outdoors)
"j" = (
/obj/structure/stone_tile/slab,
/obj/item/knife/combat/bone,
/turf/closed/mineral/random/high_chance/volcanic,
/area/lavaland/surface/outdoors)
"k" = (
/obj/structure/stone_tile/center/cracked,
/obj/structure/stone_tile/surrounding/cracked{
	dir = 6
	},
/turf/open/misc/asteroid/basalt/lava_land_surface,
/area/ruin/unpowered)
"l" = (
/obj/structure/rack/shelf{
	icon = 'modular_nova/modules/mapping/icons/unique/furniture.dmi';
	icon_state = "empty_shelf_1"
	},
/obj/item/claymore/bone,
/obj/item/claymore/bone{
	pixel_y = 6
	},
/obj/structure/stone_tile/slab,
/turf/open/misc/asteroid/basalt/lava_land_surface,
/area/ruin/unpowered)
"m" = (
/obj/structure/rack/shelf{
	icon = 'modular_nova/modules/mapping/icons/unique/furniture.dmi';
	icon_state = "empty_shelf_1"
	},
/obj/item/spear/bonespear,
/obj/item/spear/bonespear{
	pixel_y = 5
	},
/obj/structure/stone_tile/surrounding_tile{
	dir = 1
	},
/obj/structure/stone_tile/surrounding_tile{
	dir = 8
	},
/obj/structure/stone_tile/slab,
/turf/open/misc/asteroid/basalt/lava_land_surface,
/area/ruin/unpowered)
"n" = (
/turf/closed/indestructible/riveted/boss,
/area/lavaland/surface/outdoors)
"o" = (
/obj/structure/stone_tile/slab/cracked,
/turf/open/lava/smooth/lava_land_surface,
/area/ruin/unpowered)
"p" = (
/obj/item/ammo_casing/arrow/bone,
/obj/structure/stone_tile/block/cracked{
	dir = 1
	},
/obj/structure/stone_tile/cracked,
/obj/structure/stone_tile{
	dir = 8
	},
/turf/closed/mineral/volcanic/lava_land_surface,
/area/lavaland/surface/outdoors)
"q" = (
/obj/item/stack/sheet/bone,
/obj/structure/stone_tile/block/cracked,
/obj/structure/stone_tile/cracked{
	dir = 4
	},
/turf/closed/mineral/volcanic/lava_land_surface,
/area/lavaland/surface/outdoors)
"r" = (
/obj/structure/stone_tile/surrounding_tile{
	dir = 8
	},
/obj/structure/stone_tile/center/burnt,
/obj/structure/stone_tile/surrounding_tile/cracked{
	dir = 1
	},
/turf/open/lava/smooth/lava_land_surface,
/area/ruin/unpowered)
"s" = (
/obj/structure/rack/shelf{
	icon = 'modular_nova/modules/mapping/icons/unique/furniture.dmi';
	icon_state = "empty_shelf_1"
	},
/obj/item/gun/ballistic/bow/longbow,
/obj/structure/stone_tile/slab,
/turf/open/misc/asteroid/basalt/lava_land_surface,
/area/ruin/unpowered)
"t" = (
/turf/template_noop,
/area/template_noop)
"u" = (
/obj/structure/bed/maint,
/obj/structure/stone_tile/slab/cracked{
	dir = 1
	},
/obj/structure/stone_tile/surrounding/cracked{
	dir = 4
	},
/turf/closed/mineral/random/high_chance/volcanic,
/area/lavaland/surface/outdoors)
"v" = (
/obj/structure/stone_tile/surrounding/cracked{
	dir = 1
	},
/turf/open/lava/smooth/lava_land_surface,
/area/ruin/unpowered)
"w" = (
/obj/structure/stone_tile/surrounding/cracked,
/obj/structure/stone_tile/center/burnt,
/turf/open/lava/smooth/lava_land_surface,
/area/ruin/unpowered)
"x" = (
/obj/structure/stone_tile/slab,
/obj/item/storage/bag/quiver,
/mob/living/basic/mining/legion,
/turf/open/misc/asteroid/basalt/lava_land_surface,
/area/ruin/unpowered)
"y" = (
/obj/structure/stone_tile/slab,
/mob/living/basic/mining/legion,
/turf/open/misc/asteroid/basalt/lava_land_surface,
/area/ruin/unpowered)
"z" = (
/obj/structure/stone_tile/burnt{
	dir = 8
	},
/obj/structure/stone_tile/cracked,
/obj/structure/stone_tile/burnt{
	dir = 1
	},
/turf/open/lava/smooth/lava_land_surface,
/area/ruin/unpowered)
"A" = (
/obj/effect/mapping_helpers/bombable_wall,
/turf/closed/indestructible/riveted/boss/wasteland,
/area/ruin/unpowered)
"B" = (
/obj/structure/stone_tile/slab/cracked{
	dir = 5
	},
/turf/closed/mineral/random/high_chance/volcanic,
/area/lavaland/surface/outdoors)
"C" = (
/obj/structure/stone_tile/slab,
/turf/closed/mineral/volcanic/lava_land_surface,
/area/lavaland/surface/outdoors)
"D" = (
/obj/structure/stone_tile/slab/cracked,
/turf/closed/mineral/random/high_chance/volcanic,
/area/lavaland/surface/outdoors)
"E" = (
/obj/item/fireaxe/boneaxe,
/obj/structure/stone_tile/surrounding/cracked{
	dir = 6
	},
/obj/structure/stone_tile/center/cracked,
/turf/closed/mineral/random/high_chance/volcanic,
/area/ruin/unpowered)
"F" = (
/obj/structure/stone_tile/surrounding,
/obj/structure/stone_tile/center,
/turf/closed/mineral/random/high_chance/volcanic,
/area/ruin/unpowered)
"G" = (
/obj/structure/stone_tile/slab,
/obj/structure/bed/maint,
/obj/item/xenoarch/useless_relic{
	name = "Ancient relic";
	desc = "Sort of relic that can be exported through Cargo."
	},
/turf/closed/mineral/random/high_chance/volcanic,
/area/ruin/unpowered)
"H" = (
/obj/structure/bed/maint,
/obj/structure/stone_tile/slab,
/mob/living/basic/mining/legion,
/obj/effect/decal/cleanable/blood/old{
	icon_state = "floor4-old";
	pixel_y = 10;
	pixel_x = 5
	},
/turf/open/misc/asteroid/basalt/lava_land_surface,
/area/ruin/unpowered)
"I" = (
/obj/structure/stone_tile/block/cracked{
	dir = 1
	},
/obj/structure/stone_tile/block/burnt,
/turf/open/lava/smooth/lava_land_surface,
/area/ruin/unpowered)
"J" = (
/obj/structure/stone_tile/surrounding_tile/burnt{
	dir = 1
	},
/obj/item/xenoarch/useless_relic{
	name = "Ancient relic";
	desc = "Sort of relic that can be exported through Cargo."
	},
/turf/closed/mineral/volcanic/lava_land_surface,
/area/lavaland/surface/outdoors)
"K" = (
/obj/structure/stone_tile/surrounding_tile{
	dir = 1
	},
/obj/structure/stone_tile/center/burnt,
/obj/structure/stone_tile/surrounding_tile/cracked{
	dir = 8
	},
/turf/open/lava/smooth/lava_land_surface,
/area/ruin/unpowered)
"L" = (
/obj/structure/stone_tile/slab,
/mob/living/basic/mining/legion,
/obj/effect/decal/cleanable/dirt/dust,
/turf/open/misc/asteroid/basalt/lava_land_surface,
/area/ruin/unpowered)
"M" = (
/obj/structure/stone_tile/slab,
/mob/living/basic/mining/legion,
/obj/effect/decal/remains/human,
/turf/open/misc/asteroid/basalt/lava_land_surface,
/area/ruin/unpowered)
"N" = (
/obj/structure/stone_tile/surrounding/cracked{
	dir = 1
	},
/obj/structure/stone_tile/center/burnt,
/turf/open/lava/smooth/lava_land_surface,
/area/ruin/unpowered)
"O" = (
/obj/structure/stone_tile/slab,
/obj/item/ammo_casing/arrow/bone,
/turf/closed/mineral/volcanic/lava_land_surface,
/area/ruin/unpowered)
"P" = (
/obj/structure/stone_tile/surrounding_tile{
	dir = 4
	},
/obj/structure/stone_tile/surrounding_tile,
/obj/structure/stone_tile/center/cracked,
/turf/open/lava/smooth/lava_land_surface,
/area/ruin/unpowered)
"Q" = (
/obj/structure/stone_tile/slab,
/turf/closed/mineral/random/high_chance/volcanic,
/area/ruin/unpowered)
"R" = (
/obj/structure/stone_tile/slab,
/obj/effect/decal/cleanable/dirt/dust,
/turf/open/misc/asteroid/basalt/lava_land_surface,
/area/ruin/unpowered)
"S" = (
/obj/structure/stone_tile/slab/cracked,
/obj/effect/decal/remains/human/smokey,
/turf/open/misc/asteroid/basalt/lava_land_surface,
/area/ruin/unpowered)
"T" = (
/obj/structure/stone_tile/slab/burnt,
/turf/open/lava/smooth/lava_land_surface,
/area/ruin/unpowered)
"U" = (
/obj/structure/stone_tile/slab/cracked{
	dir = 6
	},
/turf/open/lava/smooth/lava_land_surface,
/area/ruin/unpowered)
"V" = (
/obj/structure/stone_tile/surrounding_tile{
	dir = 4
	},
/obj/structure/stone_tile/surrounding_tile/burnt,
/turf/open/lava/smooth/lava_land_surface,
/area/ruin/unpowered)
"W" = (
/obj/structure/stone_tile/slab/cracked{
	dir = 5
	},
/obj/structure/stone_tile/slab/cracked{
	dir = 10
	},
/turf/open/lava/smooth/lava_land_surface,
/area/ruin/unpowered)
"X" = (
/obj/structure/stone_tile/slab,
/obj/item/ammo_casing/arrow/bone,
/turf/closed/mineral/random/high_chance/volcanic,
/area/lavaland/surface/outdoors)
"Y" = (
/obj/structure/stone_tile/slab,
/obj/effect/decal/cleanable/blood/old,
/obj/effect/decal/remains/human/smokey,
/turf/open/misc/asteroid/basalt/lava_land_surface,
/area/ruin/unpowered)
"Z" = (
/obj/structure/bed/maint,
/obj/structure/stone_tile/slab,
/obj/effect/decal/cleanable/dirt/dust,
/turf/open/misc/asteroid/basalt/lava_land_surface,
/area/ruin/unpowered)

(1,1,1) = {"
t
t
q
i
C
p
t
t
"}
(2,1,1) = {"
t
t
b
C
e
n
t
t
"}
(3,1,1) = {"
t
n
g
E
F
c
n
t
"}
(4,1,1) = {"
n
g
g
Q
O
g
g
n
"}
(5,1,1) = {"
n
g
G
Q
S
H
g
b
"}
(6,1,1) = {"
t
g
f
R
I
Z
g
t
"}
(7,1,1) = {"
t
g
c
v
w
g
g
t
"}
(8,1,1) = {"
t
g
l
T
Y
s
g
t
"}
(9,1,1) = {"
n
g
U
V
r
x
g
n
"}
(10,1,1) = {"
b
g
L
K
P
W
g
n
"}
(11,1,1) = {"
t
g
m
y
o
z
A
t
"}
(12,1,1) = {"
t
t
A
k
N
c
g
t
"}
(13,1,1) = {"
t
t
u
h
a
M
g
t
"}
(14,1,1) = {"
t
t
D
X
R
Z
g
n
"}
(15,1,1) = {"
t
t
d
B
j
g
g
n
"}
(16,1,1) = {"
t
t
t
J
n
n
b
t
"}
