//MAP CONVERTED BY dmm2tgm.py THIS HEADER COMMENT PREVENTS RECONVERSION, DO NOT REMOVE
"a" = (
/obj/effect/mapping_helpers/bombable_wall,
/turf/closed/indestructible/riveted/boss/wasteland,
/area/lavaland/surface/outdoors)
"c" = (
/obj/structure/stone_tile/slab/cracked{
	dir = 6
	},
/turf/closed/mineral/volcanic/lava_land_surface,
/area/lavaland/surface/outdoors)
"d" = (
/obj/structure/stone_tile/slab/cracked{
	dir = 5
	},
/obj/item/forging/complete/chain{
	pixel_x = -5;
	pixel_y = -7
	},
/turf/closed/mineral/volcanic/lava_land_surface,
/area/lavaland/surface/outdoors)
"f" = (
/obj/structure/stone_tile{
	dir = 8
	},
/obj/structure/stone_tile/burnt,
/obj/structure/stone_tile/cracked{
	dir = 4
	},
/turf/closed/mineral/volcanic/lava_land_surface,
/area/lavaland/surface/outdoors)
"g" = (
/obj/structure/stone_tile/surrounding_tile{
	dir = 1
	},
/obj/item/xenoarch/useless_relic{
	name = "Ancient relic";
	desc = "Sort of relic that can be exported through Cargo."
	},
/turf/closed/mineral/volcanic/lava_land_surface,
/area/lavaland/surface/outdoors)
"h" = (
/turf/closed/indestructible/riveted/boss,
/area/lavaland/surface/outdoors)
"k" = (
/obj/structure/stone_tile/block{
	dir = 1
	},
/obj/item/xenoarch/useless_relic{
	name = "Ancient relic";
	desc = "Sort of relic that can be exported through Cargo."
	},
/turf/closed/mineral/volcanic/lava_land_surface,
/area/lavaland/surface/outdoors)
"n" = (
/obj/structure/stone_tile/slab/cracked,
/turf/closed/mineral/volcanic/lava_land_surface,
/area/lavaland/surface/outdoors)
"q" = (
/obj/structure/stone_tile/surrounding/cracked,
/turf/closed/mineral/volcanic/lava_land_surface,
/area/lavaland/surface/outdoors)
"y" = (
/obj/structure/stone_tile/block/cracked{
	dir = 4
	},
/turf/closed/mineral/volcanic/lava_land_surface,
/area/lavaland/surface/outdoors)
"z" = (
/obj/item/forging/complete/chain{
	pixel_x = -9;
	pixel_y = 7
	},
/obj/structure/flora/rock/pile/style_random,
/turf/closed/mineral/volcanic/lava_land_surface,
/area/lavaland/surface/outdoors)
"A" = (
/obj/structure/stone_tile/slab,
/turf/closed/mineral/volcanic/lava_land_surface,
/area/lavaland/surface/outdoors)
"D" = (
/obj/structure/stone_tile/block{
	dir = 8
	},
/obj/structure/stone_tile/block/cracked{
	dir = 4
	},
/obj/item/xenoarch/useless_relic{
	name = "Ancient relic";
	desc = "Sort of relic that can be exported through Cargo."
	},
/turf/closed/mineral/volcanic/lava_land_surface,
/area/lavaland/surface/outdoors)
"F" = (
/obj/structure/stone_tile/slab/burnt,
/turf/closed/mineral/volcanic/lava_land_surface,
/area/lavaland/surface/outdoors)
"G" = (
/obj/structure/stone_tile/block{
	dir = 8
	},
/obj/item/forging/complete/chain{
	pixel_x = 3;
	pixel_y = 7
	},
/obj/item/xenoarch/useless_relic{
	name = "Ancient relic";
	desc = "Sort of relic that can be exported through Cargo."
	},
/turf/closed/mineral/volcanic/lava_land_surface,
/area/lavaland/surface/outdoors)
"H" = (
/obj/structure/fluff/big_chain{
	pixel_y = 7
	},
/turf/closed/indestructible/riveted/boss,
/area/lavaland/surface/outdoors)
"I" = (
/obj/structure/stone_tile/slab/cracked{
	dir = 8
	},
/turf/closed/mineral/volcanic/lava_land_surface,
/area/lavaland/surface/outdoors)
"J" = (
/turf/template_noop,
/area/template_noop)
"L" = (
/obj/structure/stone_tile{
	dir = 1
	},
/obj/structure/stone_tile{
	dir = 4
	},
/obj/structure/stone_tile/burnt,
/turf/closed/mineral/volcanic/lava_land_surface,
/area/lavaland/surface/outdoors)
"N" = (
/obj/structure/stone_tile/block{
	dir = 8
	},
/turf/closed/mineral/volcanic/lava_land_surface,
/area/lavaland/surface/outdoors)
"O" = (
/obj/structure/stone_tile/slab/cracked{
	dir = 6
	},
/obj/item/forging/complete/chain{
	pixel_x = -5;
	pixel_y = -7
	},
/turf/closed/mineral/volcanic/lava_land_surface,
/area/lavaland/surface/outdoors)
"Q" = (
/obj/structure/stone_tile/block/burnt{
	dir = 1
	},
/obj/structure/stone_tile/block,
/obj/item/forging/complete/chain{
	pixel_x = -9;
	pixel_y = 7
	},
/turf/closed/mineral/volcanic/lava_land_surface,
/area/lavaland/surface/outdoors)
"R" = (
/obj/structure/stone_tile/slab/burnt,
/obj/item/forging/complete/chain{
	pixel_x = 7;
	pixel_y = 2
	},
/obj/item/xenoarch/useless_relic{
	name = "Ancient relic";
	desc = "Sort of relic that can be exported through Cargo."
	},
/turf/closed/mineral/volcanic/lava_land_surface,
/area/lavaland/surface/outdoors)
"T" = (
/obj/structure/stone_tile/block/cracked{
	dir = 8
	},
/turf/closed/mineral/volcanic/lava_land_surface,
/area/lavaland/surface/outdoors)
"U" = (
/obj/item/forging/complete/chain{
	pixel_x = 7;
	pixel_y = 2
	},
/turf/closed/mineral/volcanic/lava_land_surface,
/area/lavaland/surface/outdoors)
"W" = (
/obj/structure/stone_tile/burnt,
/obj/structure/stone_tile/burnt{
	dir = 1
	},
/obj/structure/stone_tile/cracked{
	dir = 4
	},
/turf/closed/mineral/volcanic/lava_land_surface,
/area/lavaland/surface/outdoors)
"X" = (
/obj/structure/stone_tile/slab/burnt,
/obj/item/forging/complete/chain{
	pixel_x = 3;
	pixel_y = 7
	},
/turf/closed/mineral/volcanic/lava_land_surface,
/area/lavaland/surface/outdoors)

(1,1,1) = {"
J
c
J
"}
(2,1,1) = {"
k
H
J
"}
(3,1,1) = {"
J
A
J
"}
(4,1,1) = {"
q
H
n
"}
(5,1,1) = {"
J
G
N
"}
(6,1,1) = {"
L
a
J
"}
(7,1,1) = {"
O
U
z
"}
(8,1,1) = {"
y
H
D
"}
(9,1,1) = {"
J
I
F
"}
(10,1,1) = {"
g
H
W
"}
(11,1,1) = {"
T
Q
d
"}
(12,1,1) = {"
X
a
J
"}
(13,1,1) = {"
f
R
n
"}
(14,1,1) = {"
a
h
a
"}
(15,1,1) = {"
h
h
a
"}
(16,1,1) = {"
a
a
h
"}
