//MAP CONVERTED BY dmm2tgm.py THIS HEADER COMMENT PREVENTS RECONVERSION, DO NOT REMOVE
"a" = (
/obj/structure/stone_tile/block/burnt{
	dir = 8
	},
/turf/closed/mineral/volcanic/lava_land_surface,
/area/ruin/unpowered)
"c" = (
/obj/structure/stone_tile/block{
	dir = 1
	},
/obj/structure/stone_tile/block/cracked,
/turf/closed/mineral/volcanic/lava_land_surface,
/area/ruin/unpowered)
"d" = (
/obj/structure/stone_tile/block/cracked,
/turf/closed/mineral/volcanic/lava_land_surface,
/area/lavaland/surface/outdoors)
"e" = (
/obj/structure/stone_tile/block{
	dir = 8
	},
/turf/closed/mineral/volcanic/lava_land_surface,
/area/ruin/unpowered)
"j" = (
/obj/structure/stone_tile/center/burnt,
/obj/structure/stone_tile/surrounding_tile{
	dir = 8
	},
/turf/closed/mineral/volcanic/lava_land_surface,
/area/ruin/unpowered)
"l" = (
/obj/structure/stone_tile/block/burnt{
	dir = 4
	},
/turf/closed/mineral/volcanic/lava_land_surface,
/area/lavaland/surface/outdoors)
"n" = (
/obj/structure/stone_tile/surrounding/burnt,
/obj/structure/stone_tile/center/burnt,
/obj/item/ceramic/cup,
/turf/open/misc/asteroid/basalt/lava_land_surface,
/area/ruin/unpowered)
"o" = (
/obj/structure/stone_tile/surrounding/cracked{
	dir = 6
	},
/obj/effect/spawner/random/food_or_drink/booze,
/turf/closed/mineral/volcanic/lava_land_surface,
/area/ruin/unpowered)
"q" = (
/obj/structure/stone_tile/block{
	dir = 8
	},
/turf/closed/mineral/volcanic/lava_land_surface,
/area/lavaland/surface/outdoors)
"r" = (
/obj/structure/stone_tile/block/burnt{
	dir = 1
	},
/turf/closed/mineral/volcanic/lava_land_surface,
/area/lavaland/surface/outdoors)
"s" = (
/obj/structure/stone_tile/surrounding,
/obj/structure/stone_tile/center,
/turf/closed/mineral/volcanic/lava_land_surface,
/area/ruin/unpowered)
"u" = (
/obj/structure/stone_tile/burnt{
	dir = 1
	},
/turf/closed/mineral/volcanic/lava_land_surface,
/area/lavaland/surface/outdoors)
"v" = (
/obj/structure/stone_tile/block/cracked{
	dir = 1
	},
/turf/closed/mineral/volcanic/lava_land_surface,
/area/lavaland/surface/outdoors)
"w" = (
/turf/template_noop,
/area/template_noop)
"x" = (
/obj/item/ceramic/bowl,
/turf/open/misc/asteroid/basalt/lava_land_surface,
/area/ruin/unpowered)
"y" = (
/obj/structure/stone_tile/block/cracked{
	dir = 8
	},
/turf/closed/mineral/volcanic/lava_land_surface,
/area/lavaland/surface/outdoors)
"z" = (
/obj/structure/stone_tile/burnt{
	dir = 4
	},
/turf/closed/mineral/volcanic/lava_land_surface,
/area/lavaland/surface/outdoors)
"D" = (
/obj/structure/stone_tile/block,
/obj/structure/stone_tile/block/cracked{
	dir = 1
	},
/turf/closed/mineral/volcanic/lava_land_surface,
/area/ruin/unpowered)
"E" = (
/obj/structure/stone_tile/surrounding_tile{
	dir = 4
	},
/obj/structure/stone_tile/surrounding_tile,
/turf/closed/mineral/volcanic/lava_land_surface,
/area/lavaland/surface/outdoors)
"F" = (
/obj/structure/stone_tile/surrounding,
/obj/structure/stone_tile/center/cracked,
/obj/item/reagent_containers/cup/glass/bottle/wine,
/turf/open/misc/asteroid/basalt/lava_land_surface,
/area/ruin/unpowered)
"J" = (
/obj/structure/stone_tile/burnt,
/turf/closed/mineral/volcanic/lava_land_surface,
/area/lavaland/surface/outdoors)
"N" = (
/obj/structure/stone_tile/burnt{
	dir = 8
	},
/turf/closed/mineral/volcanic/lava_land_surface,
/area/lavaland/surface/outdoors)
"P" = (
/obj/structure/stone_tile/block{
	dir = 1
	},
/obj/structure/stone_tile/block,
/turf/closed/mineral/volcanic/lava_land_surface,
/area/ruin/unpowered)
"S" = (
/obj/structure/stone_tile/center/burnt,
/obj/structure/stone_tile/surrounding_tile{
	dir = 4
	},
/turf/closed/mineral/volcanic/lava_land_surface,
/area/lavaland/surface/outdoors)
"T" = (
/obj/structure/punji_sticks/spikes,
/turf/closed/mineral/volcanic/lava_land_surface,
/area/lavaland/surface/outdoors)
"U" = (
/turf/closed/indestructible/riveted/boss,
/area/lavaland/surface/outdoors)
"V" = (
/obj/structure/stone_tile/block/burnt,
/turf/closed/mineral/volcanic/lava_land_surface,
/area/lavaland/surface/outdoors)
"Z" = (
/obj/structure/stone_tile/block{
	dir = 8
	},
/obj/structure/stone_tile/block/cracked{
	dir = 4
	},
/mob/living/basic/faithless{
	faction = list("mining","boss","hell");
	name = "Ancient Demon";
	desc = "A demonic creature that moves relatively fast, but doesn't do a lot of damage.";
	attack_sound = 'sound/effects/wounds/crackandbleed.ogg';
	attack_verb_simple = "tears";
	butcher_results = list(/obj/item/food/grown/mushroom/glowshroom/shadowshroom = 1,/obj/item/food/meat/slab/human/mutant/shadow = 1,/obj/item/organ/internal/eyes/shadow = 1,/obj/item/organ/external/tail/lizard = 1);
	icon = 'modular_nova/master_files/icons/mob/newmobs32x64.dmi';
	icon_dead = "demondead";
	icon_living = "engorgedemon";
	icon_state = "engorgedemon";
	melee_attack_cooldown = 5;
	speed = -0.1;
	damage_coeff = list("brute" = 1, "burn" = 1, "toxin" = 1, "stamina" = 0.5, "oxygen" = 1);
	melee_damage_lower = 3;
	melee_damage_upper = 7;
	health = 640;
	bare_wound_bonus = 5;
	wound_bonus = -1;
	obj_damage = 40;
	attack_vis_effect = "slash";
	attack_verb_continuous = "maniacally tears";
	maxHealth = 240
	},
/obj/effect/gibspawner,
/turf/open/misc/asteroid/basalt/lava_land_surface,
/area/ruin/unpowered)

(1,1,1) = {"
w
w
w
w
y
z
w
"}
(2,1,1) = {"
v
U
U
q
U
U
N
"}
(3,1,1) = {"
u
U
F
Z
n
D
w
"}
(4,1,1) = {"
w
E
c
x
a
j
w
"}
(5,1,1) = {"
r
U
o
e
s
P
V
"}
(6,1,1) = {"
z
U
U
S
U
U
d
"}
(7,1,1) = {"
w
T
w
l
w
J
w
"}
