//MAP CONVERTED BY dmm2tgm.py THIS HEADER COMMENT PREVENTS RECONVERSION, DO NOT REMOVE
"ak" = (
/obj/structure/rack/shelf{
	icon = 'modular_nova/modules/mapping/icons/unique/furniture.dmi';
	icon_state = "empty_shelf_1"
	},
/obj/item/reagent_containers/cup/glass/bottle/moonshine,
/obj/structure/stone_tile/slab,
/turf/open/misc/asteroid/basalt/lava_land_surface,
/area/ruin/unpowered)
"az" = (
/obj/structure/stone_tile/block{
	dir = 1
	},
/obj/structure/stone_tile/block/burnt,
/turf/open/misc/asteroid/basalt/lava_land_surface,
/area/lavaland/surface/outdoors)
"aB" = (
/turf/closed/indestructible/riveted/boss,
/area/lavaland/surface/outdoors)
"aH" = (
/obj/structure/stone_tile/slab/cracked{
	dir = 6
	},
/turf/open/lava/smooth/lava_land_surface,
/area/lavaland/surface/outdoors)
"aK" = (
/obj/structure/stone_tile/slab/cracked{
	dir = 4
	},
/turf/closed/mineral/volcanic/lava_land_surface,
/area/lavaland/surface/outdoors)
"aL" = (
/obj/structure/stone_tile/surrounding,
/turf/closed/mineral/volcanic/lava_land_surface,
/area/lavaland/surface/outdoors)
"bg" = (
/obj/structure/stone_tile/slab/cracked{
	dir = 5
	},
/turf/open/lava/smooth/lava_land_surface,
/area/lavaland/surface/outdoors)
"bj" = (
/obj/structure/stone_tile{
	dir = 8
	},
/obj/structure/stone_tile{
	dir = 1
	},
/obj/structure/stone_tile/burnt,
/turf/open/lava/smooth/lava_land_surface,
/area/lavaland/surface/outdoors)
"bv" = (
/obj/structure/stone_tile/surrounding_tile{
	dir = 4
	},
/obj/structure/stone_tile/surrounding_tile,
/turf/open/misc/asteroid/basalt/lava_land_surface,
/area/lavaland/surface/outdoors)
"cB" = (
/obj/structure/fermenting_barrel/gunpowder,
/obj/structure/stone_tile/slab,
/turf/closed/mineral/volcanic/lava_land_surface,
/area/ruin/unpowered)
"cG" = (
/obj/structure/stone_tile{
	dir = 8
	},
/obj/structure/stone_tile{
	dir = 4
	},
/turf/closed/mineral/volcanic/lava_land_surface,
/area/lavaland/surface/outdoors)
"cT" = (
/obj/structure/stone_tile/slab/cracked{
	dir = 6
	},
/turf/open/misc/asteroid/basalt/lava_land_surface,
/area/ruin/unpowered)
"dA" = (
/obj/structure/rack/shelf{
	icon = 'modular_nova/modules/mapping/icons/unique/furniture.dmi';
	icon_state = "empty_shelf_1"
	},
/obj/item/stack/sheet/mineral/coal/ten,
/obj/structure/stone_tile/slab,
/turf/closed/mineral/random/high_chance/volcanic,
/area/ruin/unpowered)
"dH" = (
/obj/structure/stone_tile{
	dir = 8
	},
/obj/structure/stone_tile{
	dir = 1
	},
/obj/structure/stone_tile/cracked{
	dir = 4
	},
/turf/open/misc/asteroid/basalt/lava_land_surface,
/area/lavaland/surface/outdoors)
"ek" = (
/obj/structure/stone_tile/block{
	dir = 8
	},
/turf/closed/mineral/volcanic/lava_land_surface,
/area/lavaland/surface/outdoors)
"eF" = (
/obj/structure/stone_tile/block,
/obj/structure/stone_tile/block/cracked{
	dir = 1
	},
/turf/open/lava/smooth/lava_land_surface,
/area/lavaland/surface/outdoors)
"eI" = (
/obj/structure/rack/shelf{
	icon = 'modular_nova/modules/mapping/icons/unique/furniture.dmi';
	icon_state = "empty_shelf_1"
	},
/obj/item/reagent_containers/cup/glass/bottle/lizardwine,
/obj/structure/stone_tile/slab,
/turf/open/misc/asteroid/basalt/lava_land_surface,
/area/ruin/unpowered)
"eK" = (
/obj/structure/stone_tile/surrounding_tile/burnt{
	dir = 1
	},
/turf/open/lava/smooth/lava_land_surface,
/area/lavaland/surface/outdoors)
"eQ" = (
/obj/structure/stone_tile,
/obj/structure/stone_tile{
	dir = 1
	},
/obj/structure/stone_tile/cracked{
	dir = 4
	},
/mob/living/basic/mining/brimdemon,
/turf/open/misc/asteroid/basalt/lava_land_surface,
/area/lavaland/surface/outdoors)
"eV" = (
/obj/effect/mapping_helpers/bombable_wall,
/turf/closed/indestructible/riveted/boss/wasteland,
/area/lavaland/surface/outdoors)
"eY" = (
/obj/structure/stone_tile/surrounding/cracked,
/turf/open/lava/smooth/lava_land_surface,
/area/lavaland/surface/outdoors)
"fv" = (
/obj/item/reagent_containers/cup/glass/bottle/small{
	pixel_x = 3;
	pixel_y = 5
	},
/obj/structure/stone_tile/slab,
/turf/open/misc/asteroid/basalt/lava_land_surface,
/area/lavaland/surface/outdoors)
"fU" = (
/obj/structure/table/wood,
/obj/item/reagent_containers/cup/primitive_centrifuge{
	pixel_x = -14;
	pixel_y = -1
	},
/obj/item/reagent_containers/cup/beaker/large/ceramic{
	pixel_x = 7;
	pixel_y = -5
	},
/obj/structure/stone_tile/slab,
/turf/closed/mineral/volcanic/lava_land_surface,
/area/ruin/unpowered)
"fZ" = (
/obj/structure/rack/shelf{
	icon = 'modular_nova/modules/mapping/icons/unique/furniture.dmi';
	icon_state = "empty_shelf_1"
	},
/obj/item/coin/silver,
/obj/structure/stone_tile/slab,
/turf/open/misc/asteroid/basalt/lava_land_surface,
/area/lavaland/surface/outdoors)
"gk" = (
/obj/structure/stone_tile,
/obj/structure/stone_tile{
	dir = 8
	},
/obj/structure/stone_tile/cracked{
	dir = 4
	},
/turf/open/misc/asteroid/basalt/lava_land_surface,
/area/lavaland/surface/outdoors)
"gS" = (
/obj/structure/stone_tile/slab/cracked,
/turf/open/lava/smooth/lava_land_surface,
/area/lavaland/surface/outdoors)
"gZ" = (
/obj/structure/punji_sticks/spikes,
/turf/closed/mineral/random/high_chance/volcanic,
/area/lavaland/surface/outdoors)
"ht" = (
/turf/closed/mineral/strange_rock/volcanic,
/area/lavaland/surface/outdoors)
"hy" = (
/mob/living/basic/mining/goliath,
/turf/closed/mineral/random/high_chance/volcanic,
/area/lavaland/surface/outdoors)
"hG" = (
/turf/closed/mineral/volcanic/lava_land_surface,
/area/lavaland/surface/outdoors)
"ie" = (
/turf/open/misc/asteroid/basalt/lava_land_surface,
/area/lavaland/surface/outdoors)
"ir" = (
/obj/structure/stone_tile/slab/cracked{
	dir = 6
	},
/turf/closed/mineral/random/high_chance/volcanic,
/area/ruin/unpowered)
"iw" = (
/obj/structure/stone_tile/block,
/obj/structure/stone_tile/block/cracked{
	dir = 1
	},
/turf/open/misc/asteroid/basalt/lava_land_surface,
/area/lavaland/surface/outdoors)
"iW" = (
/obj/structure/stone_tile/slab/cracked{
	dir = 4
	},
/obj/structure/stone_tile/slab/cracked{
	dir = 1
	},
/turf/closed/mineral/volcanic/lava_land_surface,
/area/ruin/unpowered)
"jc" = (
/obj/structure/rack/shelf{
	icon = 'modular_nova/modules/mapping/icons/unique/furniture.dmi';
	icon_state = "empty_shelf_1"
	},
/obj/structure/stone_tile/slab,
/turf/closed/mineral/volcanic/lava_land_surface,
/area/ruin/unpowered)
"jC" = (
/obj/structure/stone_tile/slab/cracked,
/turf/open/misc/asteroid/basalt/lava_land_surface,
/area/lavaland/surface/outdoors)
"kc" = (
/obj/structure/stone_tile/block/cracked{
	dir = 1
	},
/turf/open/lava/smooth/lava_land_surface,
/area/lavaland/surface/outdoors)
"kQ" = (
/obj/structure/stone_tile/slab/cracked{
	dir = 4
	},
/turf/open/lava/smooth/lava_land_surface,
/area/lavaland/surface/outdoors)
"kX" = (
/obj/structure/stone_tile,
/obj/structure/stone_tile{
	dir = 8
	},
/turf/closed/mineral/volcanic/lava_land_surface,
/area/lavaland/surface/outdoors)
"ln" = (
/obj/structure/table/wood,
/obj/structure/stone_tile/slab,
/obj/structure/stone_tile/slab,
/turf/open/misc/asteroid/basalt/lava_land_surface,
/area/ruin/unpowered)
"lo" = (
/obj/structure/stone_tile/slab,
/obj/item/reagent_containers/cup/bowl/wood_bowl,
/turf/closed/mineral/volcanic/lava_land_surface,
/area/lavaland/surface/outdoors)
"lD" = (
/obj/structure/stone_tile/slab/burnt,
/turf/open/lava/smooth/lava_land_surface,
/area/lavaland/surface/outdoors)
"lS" = (
/obj/structure/stone_tile,
/obj/structure/stone_tile{
	dir = 1
	},
/obj/structure/stone_tile/cracked{
	dir = 4
	},
/turf/open/misc/asteroid/basalt/lava_land_surface,
/area/lavaland/surface/outdoors)
"mo" = (
/obj/structure/stone_tile,
/obj/structure/stone_tile{
	dir = 1
	},
/obj/structure/stone_tile/burnt{
	dir = 4
	},
/turf/open/lava/smooth/lava_land_surface,
/area/lavaland/surface/outdoors)
"mV" = (
/obj/structure/stone_tile/surrounding_tile{
	dir = 8
	},
/obj/structure/stone_tile/surrounding_tile{
	dir = 1
	},
/turf/open/misc/asteroid/basalt/lava_land_surface,
/area/lavaland/surface/outdoors)
"nn" = (
/obj/structure/stone_tile/block/burnt,
/turf/open/lava/smooth/lava_land_surface,
/area/lavaland/surface/outdoors)
"nB" = (
/obj/structure/stone_tile/surrounding_tile{
	dir = 8
	},
/obj/structure/stone_tile/surrounding_tile/cracked{
	dir = 1
	},
/turf/open/lava/smooth/lava_land_surface,
/area/lavaland/surface/outdoors)
"nD" = (
/obj/structure/stone_tile/slab,
/turf/open/lava/smooth/lava_land_surface,
/area/lavaland/surface/outdoors)
"om" = (
/obj/structure/stone_tile/burnt,
/mob/living/basic/mining/brimdemon,
/turf/open/misc/asteroid/basalt/lava_land_surface,
/area/lavaland/surface/outdoors)
"qb" = (
/obj/structure/stone_tile/block{
	dir = 8
	},
/obj/structure/stone_tile/block/cracked{
	dir = 4
	},
/turf/open/lava/smooth/lava_land_surface,
/area/lavaland/surface/outdoors)
"qk" = (
/obj/structure/stone_tile/slab/cracked{
	dir = 8
	},
/obj/structure/stone_tile/slab/cracked{
	dir = 4
	},
/turf/open/lava/smooth/lava_land_surface,
/area/lavaland/surface/outdoors)
"qB" = (
/obj/structure/stone_tile/slab,
/turf/open/misc/asteroid/basalt/lava_land_surface,
/area/ruin/unpowered)
"qJ" = (
/obj/structure/stone_tile/slab/cracked{
	dir = 4
	},
/turf/closed/mineral/random/high_chance/volcanic,
/area/ruin/unpowered)
"rc" = (
/obj/structure/stone_tile,
/obj/structure/stone_tile{
	dir = 8
	},
/obj/structure/stone_tile{
	dir = 1
	},
/turf/closed/mineral/volcanic/lava_land_surface,
/area/lavaland/surface/outdoors)
"rM" = (
/obj/structure/punji_sticks/spikes,
/turf/closed/mineral/volcanic/lava_land_surface,
/area/lavaland/surface/outdoors)
"rX" = (
/obj/structure/stone_tile/slab/cracked{
	dir = 6
	},
/obj/item/coin/silver,
/turf/open/misc/asteroid/basalt/lava_land_surface,
/area/lavaland/surface/outdoors)
"sd" = (
/obj/structure/table/wood,
/obj/structure/chem_separator,
/obj/structure/stone_tile/slab,
/turf/open/misc/asteroid/basalt/lava_land_surface,
/area/lavaland/surface/outdoors)
"st" = (
/obj/structure/stone_tile/block,
/obj/structure/punji_sticks/spikes,
/turf/closed/mineral/volcanic/lava_land_surface,
/area/lavaland/surface/outdoors)
"sx" = (
/obj/structure/stone_tile/surrounding,
/obj/structure/stone_tile/center/cracked,
/turf/open/misc/asteroid/basalt/lava_land_surface,
/area/lavaland/surface/outdoors)
"sz" = (
/obj/structure/stone_tile/surrounding_tile/cracked{
	dir = 4
	},
/obj/structure/stone_tile/surrounding_tile/burnt,
/obj/structure/stone_tile/center/cracked,
/turf/open/lava/smooth/lava_land_surface,
/area/lavaland/surface/outdoors)
"sH" = (
/obj/structure/rack/shelf{
	icon = 'modular_nova/modules/mapping/icons/unique/furniture.dmi';
	icon_state = "empty_shelf_1"
	},
/obj/item/stack/sheet/mineral/coal/ten,
/obj/structure/stone_tile/slab,
/turf/open/misc/asteroid/basalt/lava_land_surface,
/area/ruin/unpowered)
"tn" = (
/obj/structure/stone_tile/surrounding_tile/burnt{
	dir = 1
	},
/obj/structure/stone_tile/surrounding_tile/burnt{
	dir = 8
	},
/turf/open/lava/smooth/lava_land_surface,
/area/lavaland/surface/outdoors)
"tt" = (
/obj/structure/stone_tile/slab/burnt,
/obj/structure/stone_tile/block/burnt{
	dir = 8
	},
/turf/open/lava/smooth/lava_land_surface,
/area/lavaland/surface/outdoors)
"tw" = (
/turf/closed/mineral/volcanic/lava_land_surface,
/area/ruin/unpowered)
"ty" = (
/obj/structure/stone_tile/block{
	dir = 8
	},
/turf/closed/mineral/random/high_chance/volcanic,
/area/lavaland/surface/outdoors)
"tB" = (
/obj/structure/stone_tile/slab/cracked{
	dir = 4
	},
/obj/structure/stone_tile/slab/cracked{
	dir = 8
	},
/turf/closed/mineral/volcanic/lava_land_surface,
/area/ruin/unpowered)
"tI" = (
/obj/structure/stone_tile/slab/cracked{
	dir = 4
	},
/obj/structure/stone_tile/slab/cracked{
	dir = 1
	},
/obj/structure/stone_tile/slab/cracked{
	dir = 8
	},
/turf/open/misc/asteroid/basalt/lava_land_surface,
/area/lavaland/surface/outdoors)
"uH" = (
/turf/closed/mineral/random/high_chance/volcanic,
/area/lavaland/surface/outdoors)
"vx" = (
/obj/structure/stone_tile/slab/cracked{
	dir = 6
	},
/turf/open/misc/asteroid/basalt/lava_land_surface,
/area/lavaland/surface/outdoors)
"vR" = (
/obj/structure/stone_tile/burnt,
/obj/structure/stone_tile/burnt{
	dir = 1
	},
/obj/structure/stone_tile/cracked{
	dir = 4
	},
/turf/open/lava/smooth/lava_land_surface,
/area/lavaland/surface/outdoors)
"vZ" = (
/turf/closed/indestructible/riveted/boss,
/area/ruin/unpowered)
"we" = (
/obj/structure/table/wood,
/obj/structure/stone_tile/slab,
/turf/open/misc/asteroid/basalt/lava_land_surface,
/area/ruin/unpowered)
"wp" = (
/obj/structure/stone_tile,
/obj/structure/stone_tile{
	dir = 8
	},
/obj/structure/stone_tile{
	dir = 4
	},
/turf/closed/mineral/random/high_chance/volcanic,
/area/lavaland/surface/outdoors)
"xa" = (
/obj/structure/stone_tile/slab,
/obj/structure/stone_tile/slab,
/turf/closed/mineral/volcanic/lava_land_surface,
/area/ruin/unpowered)
"xd" = (
/obj/structure/table/wood,
/obj/structure/stone_tile/slab,
/turf/open/misc/asteroid/basalt/lava_land_surface,
/area/lavaland/surface/outdoors)
"xg" = (
/obj/structure/stone_tile/block{
	dir = 1
	},
/obj/structure/stone_tile/block/cracked,
/mob/living/basic/mining/lobstrosity/lava,
/turf/open/misc/asteroid/basalt/lava_land_surface,
/area/lavaland/surface/outdoors)
"zl" = (
/obj/structure/stone_tile/surrounding,
/obj/structure/stone_tile/center/cracked,
/turf/open/lava/smooth/lava_land_surface,
/area/lavaland/surface/outdoors)
"zv" = (
/obj/structure/stone_tile/block{
	dir = 8
	},
/turf/open/misc/asteroid/basalt/lava_land_surface,
/area/lavaland/surface/outdoors)
"zx" = (
/obj/item/coin/silver,
/obj/structure/stone_tile/slab,
/turf/closed/mineral/random/high_chance/volcanic,
/area/ruin/unpowered)
"zy" = (
/obj/structure/stone_tile/slab/cracked{
	dir = 6
	},
/turf/closed/mineral/volcanic/lava_land_surface,
/area/ruin/unpowered)
"zN" = (
/obj/structure/stone_tile/surrounding_tile/burnt{
	dir = 8
	},
/turf/open/lava/smooth/lava_land_surface,
/area/lavaland/surface/outdoors)
"zQ" = (
/obj/structure/stone_tile/block{
	dir = 8
	},
/obj/structure/stone_tile/block{
	dir = 4
	},
/turf/open/lava/smooth/lava_land_surface,
/area/lavaland/surface/outdoors)
"zV" = (
/obj/structure/rack/shelf{
	icon = 'modular_nova/modules/mapping/icons/unique/furniture.dmi';
	icon_state = "empty_shelf_1"
	},
/obj/structure/stone_tile/slab,
/turf/open/misc/asteroid/basalt/lava_land_surface,
/area/lavaland/surface/outdoors)
"Am" = (
/obj/structure/flora/rock/pile/style_random,
/turf/closed/mineral/random/high_chance/volcanic,
/area/lavaland/surface/outdoors)
"AJ" = (
/obj/structure/flora/rock/pile/style_random,
/turf/closed/mineral/strange_rock/volcanic,
/area/lavaland/surface/outdoors)
"Bi" = (
/obj/structure/rack/shelf{
	icon = 'modular_nova/modules/mapping/icons/unique/furniture.dmi';
	icon_state = "empty_shelf_1"
	},
/obj/item/reagent_containers/cup/glass/bottle/small{
	pixel_x = 3;
	pixel_y = 5
	},
/obj/structure/stone_tile/slab,
/turf/open/misc/asteroid/basalt/lava_land_surface,
/area/ruin/unpowered)
"Bk" = (
/obj/structure/stone_tile/slab,
/turf/closed/mineral/random/high_chance/volcanic,
/area/lavaland/surface/outdoors)
"Bn" = (
/obj/structure/rack/shelf{
	icon = 'modular_nova/modules/mapping/icons/unique/furniture.dmi';
	icon_state = "empty_shelf_1"
	},
/obj/structure/stone_tile/slab,
/turf/open/misc/asteroid/basalt/lava_land_surface,
/area/ruin/unpowered)
"BQ" = (
/obj/structure/stone_tile/surrounding,
/turf/open/lava/smooth/lava_land_surface,
/area/lavaland/surface/outdoors)
"BY" = (
/obj/structure/table/wood,
/obj/item/stack/sheet/cloth/ten,
/obj/structure/stone_tile/slab,
/turf/open/misc/asteroid/basalt/lava_land_surface,
/area/ruin/unpowered)
"BZ" = (
/obj/structure/stone_tile{
	dir = 8
	},
/obj/structure/stone_tile{
	dir = 1
	},
/obj/structure/stone_tile{
	dir = 4
	},
/mob/living/basic/mining/lobstrosity/lava,
/turf/open/misc/asteroid/basalt/lava_land_surface,
/area/lavaland/surface/outdoors)
"Cx" = (
/obj/structure/punji_sticks/spikes,
/turf/closed/mineral/strange_rock/volcanic,
/area/lavaland/surface/outdoors)
"CX" = (
/obj/structure/stone_tile/slab,
/turf/closed/mineral/volcanic/lava_land_surface,
/area/ruin/unpowered)
"DM" = (
/obj/structure/stone_tile/slab/cracked{
	dir = 4
	},
/obj/structure/stone_tile/slab/cracked{
	dir = 8
	},
/turf/open/misc/asteroid/basalt/lava_land_surface,
/area/lavaland/surface/outdoors)
"Ed" = (
/obj/structure/stone_tile/surrounding_tile{
	dir = 8
	},
/turf/open/misc/asteroid/basalt/lava_land_surface,
/area/lavaland/surface/outdoors)
"Et" = (
/obj/structure/stone_tile/slab/cracked{
	dir = 6
	},
/turf/closed/mineral/random/high_chance/volcanic,
/area/lavaland/surface/outdoors)
"EA" = (
/obj/structure/fermenting_barrel,
/obj/structure/stone_tile/slab,
/turf/open/misc/asteroid/basalt/lava_land_surface,
/area/ruin/unpowered)
"FA" = (
/obj/structure/stone_tile/slab,
/turf/closed/mineral/random/high_chance/volcanic,
/area/ruin/unpowered)
"FM" = (
/obj/structure/stone_tile/surrounding/cracked{
	dir = 6
	},
/turf/open/lava/smooth/lava_land_surface,
/area/lavaland/surface/outdoors)
"Gt" = (
/obj/structure/rack/shelf{
	icon = 'modular_nova/modules/mapping/icons/unique/furniture.dmi';
	icon_state = "empty_shelf_1"
	},
/obj/item/reagent_containers/cup/glass/bottle/beer,
/obj/structure/stone_tile/slab,
/turf/open/misc/asteroid/basalt/lava_land_surface,
/area/ruin/unpowered)
"Hq" = (
/obj/structure/stone_tile/surrounding_tile{
	dir = 1
	},
/obj/structure/stone_tile/surrounding_tile{
	dir = 8
	},
/turf/closed/mineral/volcanic/lava_land_surface,
/area/lavaland/surface/outdoors)
"HB" = (
/obj/structure/stone_tile/surrounding/cracked{
	dir = 8
	},
/mob/living/basic/mining/lobstrosity/lava,
/turf/open/misc/asteroid/basalt/lava_land_surface,
/area/lavaland/surface/outdoors)
"HR" = (
/obj/item/reagent_containers/cup/glass/bottle/ale,
/obj/structure/stone_tile/slab,
/turf/closed/mineral/volcanic/lava_land_surface,
/area/ruin/unpowered)
"HY" = (
/obj/structure/fermenting_barrel/gunpowder,
/obj/structure/stone_tile/slab,
/turf/open/misc/asteroid/basalt/lava_land_surface,
/area/ruin/unpowered)
"Ih" = (
/obj/structure/stone_tile{
	dir = 8
	},
/obj/structure/stone_tile{
	dir = 1
	},
/obj/structure/stone_tile/cracked{
	dir = 4
	},
/turf/open/lava/smooth/lava_land_surface,
/area/lavaland/surface/outdoors)
"Ir" = (
/obj/structure/stone_tile/surrounding_tile{
	dir = 4
	},
/turf/closed/mineral/random/high_chance/volcanic,
/area/lavaland/surface/outdoors)
"ID" = (
/turf/open/lava/smooth/lava_land_surface,
/area/lavaland/surface/outdoors)
"IG" = (
/obj/structure/stone_tile/surrounding_tile,
/turf/open/lava/smooth/lava_land_surface,
/area/lavaland/surface/outdoors)
"KB" = (
/obj/structure/stone_tile/block/burnt{
	dir = 4
	},
/turf/open/lava/smooth/lava_land_surface,
/area/lavaland/surface/outdoors)
"KG" = (
/obj/structure/flora/rock/pile/style_random,
/turf/closed/mineral/volcanic/lava_land_surface,
/area/lavaland/surface/outdoors)
"KQ" = (
/obj/structure/stone_tile/surrounding/cracked{
	dir = 1
	},
/turf/open/lava/smooth/lava_land_surface,
/area/lavaland/surface/outdoors)
"KX" = (
/obj/structure/flora/rock/pile/style_random,
/turf/open/misc/asteroid/basalt/lava_land_surface,
/area/lavaland/surface/outdoors)
"Lh" = (
/obj/structure/stone_tile/slab/burnt,
/turf/open/misc/asteroid/basalt/lava_land_surface,
/area/lavaland/surface/outdoors)
"LO" = (
/obj/structure/stone_tile{
	dir = 8
	},
/obj/structure/stone_tile{
	dir = 1
	},
/obj/structure/stone_tile{
	dir = 4
	},
/turf/closed/mineral/random/high_chance/volcanic,
/area/lavaland/surface/outdoors)
"Ms" = (
/obj/structure/stone_tile/surrounding_tile/cracked,
/obj/structure/stone_tile/surrounding_tile/burnt{
	dir = 4
	},
/turf/open/lava/smooth/lava_land_surface,
/area/lavaland/surface/outdoors)
"MH" = (
/obj/structure/table/wood,
/obj/item/reagent_containers/cup/beaker/large/ceramic{
	pixel_x = 7;
	pixel_y = -5
	},
/obj/structure/stone_tile/slab,
/turf/open/misc/asteroid/basalt/lava_land_surface,
/area/ruin/unpowered)
"MJ" = (
/obj/structure/stone_tile/block{
	dir = 1
	},
/obj/structure/stone_tile/block,
/turf/closed/mineral/random/high_chance/volcanic,
/area/lavaland/surface/outdoors)
"MZ" = (
/obj/structure/stone_tile{
	dir = 8
	},
/obj/structure/stone_tile,
/obj/structure/stone_tile{
	dir = 1
	},
/turf/closed/mineral/volcanic/lava_land_surface,
/area/lavaland/surface/outdoors)
"NL" = (
/obj/structure/stone_tile{
	dir = 8
	},
/obj/structure/punji_sticks/spikes,
/turf/open/misc/asteroid/basalt/lava_land_surface,
/area/lavaland/surface/outdoors)
"Ou" = (
/obj/item/coin/eldritch,
/obj/structure/stone_tile/slab/cracked{
	dir = 4
	},
/obj/structure/stone_tile/slab/cracked{
	dir = 1
	},
/turf/open/misc/asteroid/basalt/lava_land_surface,
/area/lavaland/surface/outdoors)
"OK" = (
/turf/closed/mineral/random/high_chance/volcanic,
/area/ruin/unpowered)
"Qh" = (
/obj/structure/stone_tile/surrounding,
/obj/structure/stone_tile/center,
/turf/closed/mineral/volcanic/lava_land_surface,
/area/lavaland/surface/outdoors)
"Qu" = (
/obj/structure/stone_tile/slab,
/mob/living/basic/faithless{
	faction = list("mining","boss","hell");
	name = "Ancient Demon";
	desc = "A demonic creature that moves relatively fast, but doesn't do a lot of damage.";
	attack_sound = 'sound/effects/wounds/crackandbleed.ogg';
	attack_verb_simple = "tears";
	butcher_results = list(/obj/item/food/grown/mushroom/glowshroom/shadowshroom = 1,/obj/item/food/meat/slab/human/mutant/shadow = 1,/obj/item/organ/internal/eyes/shadow = 1,/obj/item/organ/external/tail/lizard = 1);
	icon = 'modular_nova/master_files/icons/mob/newmobs32x64.dmi';
	icon_dead = "demondead";
	icon_living = "engorgedemon";
	icon_state = "engorgedemon";
	melee_attack_cooldown = 5;
	speed = -0.1;
	damage_coeff = list("brute" = 1, "burn" = 1, "toxin" = 1, "stamina" = 0.5, "oxygen" = 1);
	melee_damage_lower = 3;
	melee_damage_upper = 7;
	health = 640;
	bare_wound_bonus = 5;
	wound_bonus = -1;
	obj_damage = 40;
	attack_vis_effect = "slash";
	attack_verb_continuous = "maniacally tears";
	maxHealth = 240
	},
/turf/open/misc/asteroid/basalt/lava_land_surface,
/area/ruin/unpowered)
"Qz" = (
/obj/structure/stone_tile,
/obj/structure/stone_tile/burnt{
	dir = 8
	},
/obj/structure/stone_tile/burnt{
	dir = 1
	},
/turf/open/lava/smooth/lava_land_surface,
/area/lavaland/surface/outdoors)
"QG" = (
/obj/structure/stone_tile/surrounding/burnt,
/obj/structure/stone_tile/center/burnt,
/turf/open/lava/smooth/lava_land_surface,
/area/lavaland/surface/outdoors)
"Rb" = (
/obj/structure/stone_tile,
/obj/structure/stone_tile{
	dir = 8
	},
/obj/structure/stone_tile{
	dir = 4
	},
/turf/closed/mineral/volcanic/lava_land_surface,
/area/lavaland/surface/outdoors)
"RI" = (
/obj/item/coin/silver/doubloon,
/obj/structure/stone_tile/slab,
/turf/open/misc/asteroid/basalt/lava_land_surface,
/area/lavaland/surface/outdoors)
"Sb" = (
/turf/template_noop,
/area/template_noop)
"SR" = (
/obj/structure/stone_tile,
/obj/structure/stone_tile/burnt{
	dir = 4
	},
/obj/structure/stone_tile/cracked{
	dir = 8
	},
/turf/open/lava/smooth/lava_land_surface,
/area/lavaland/surface/outdoors)
"SU" = (
/obj/structure/stone_tile/surrounding_tile,
/obj/structure/stone_tile/surrounding_tile{
	dir = 4
	},
/turf/open/misc/asteroid/basalt/lava_land_surface,
/area/lavaland/surface/outdoors)
"Tb" = (
/obj/structure/stone_tile,
/obj/structure/stone_tile{
	dir = 8
	},
/mob/living/basic/mining/brimdemon,
/turf/open/misc/asteroid/basalt/lava_land_surface,
/area/lavaland/surface/outdoors)
"TI" = (
/obj/structure/stone_tile{
	dir = 8
	},
/obj/structure/stone_tile{
	dir = 4
	},
/turf/closed/mineral/random/high_chance/volcanic,
/area/lavaland/surface/outdoors)
"TV" = (
/obj/structure/stone_tile{
	dir = 1
	},
/obj/structure/stone_tile{
	dir = 4
	},
/turf/closed/mineral/volcanic/lava_land_surface,
/area/lavaland/surface/outdoors)
"UE" = (
/obj/effect/mapping_helpers/bombable_wall,
/turf/closed/indestructible/riveted/boss/wasteland,
/area/ruin/unpowered)
"Vz" = (
/obj/structure/stone_tile,
/obj/structure/stone_tile{
	dir = 8
	},
/obj/structure/stone_tile{
	dir = 1
	},
/turf/closed/mineral/random/high_chance/volcanic,
/area/lavaland/surface/outdoors)
"VZ" = (
/obj/structure/stone_tile/surrounding_tile/cracked{
	dir = 1
	},
/turf/open/lava/smooth/lava_land_surface,
/area/lavaland/surface/outdoors)
"WH" = (
/obj/structure/stone_tile/block,
/obj/structure/stone_tile/block/burnt{
	dir = 1
	},
/turf/open/lava/smooth/lava_land_surface,
/area/lavaland/surface/outdoors)
"WZ" = (
/obj/structure/stone_tile/block{
	dir = 8
	},
/turf/open/lava/smooth/lava_land_surface,
/area/lavaland/surface/outdoors)
"Xn" = (
/obj/structure/stone_tile/slab,
/turf/closed/mineral/volcanic/lava_land_surface,
/area/lavaland/surface/outdoors)
"Yk" = (
/obj/structure/stone_tile,
/obj/structure/stone_tile{
	dir = 1
	},
/obj/structure/stone_tile{
	dir = 4
	},
/turf/closed/mineral/volcanic/lava_land_surface,
/area/lavaland/surface/outdoors)
"YS" = (
/obj/structure/stone_tile/slab,
/turf/open/misc/asteroid/basalt/lava_land_surface,
/area/lavaland/surface/outdoors)
"YV" = (
/obj/structure/stone_tile/slab/cracked{
	dir = 5
	},
/obj/structure/stone_tile/slab/cracked{
	dir = 10
	},
/turf/open/lava/smooth/lava_land_surface,
/area/lavaland/surface/outdoors)
"Zb" = (
/obj/structure/stone_tile/block/cracked,
/obj/structure/stone_tile/block/burnt{
	dir = 1
	},
/turf/open/lava/smooth/lava_land_surface,
/area/lavaland/surface/outdoors)
"ZJ" = (
/obj/structure/stone_tile/block{
	dir = 8
	},
/obj/structure/stone_tile/block/burnt{
	dir = 4
	},
/turf/open/lava/smooth/lava_land_surface,
/area/lavaland/surface/outdoors)

(1,1,1) = {"
Sb
rM
TI
ek
NL
zv
cG
ty
cG
zv
cG
hG
ht
lo
vx
ID
ID
ID
Sb
Sb
uH
hG
Sb
Sb
"}
(2,1,1) = {"
gZ
LO
aB
aB
aB
ID
ID
aB
aB
aB
aB
wp
uH
sx
BQ
ID
Ih
aB
aB
eV
uH
aB
Rb
hG
"}
(3,1,1) = {"
TV
aB
aB
Sb
ID
ID
ID
ID
Sb
Sb
aB
aB
Tb
nD
kQ
ID
aB
vZ
cB
HY
HY
vZ
aB
uH
"}
(4,1,1) = {"
Sb
aB
Sb
ID
ID
ID
ID
ID
ID
ID
Sb
aB
ID
ID
ZJ
Sb
aB
tw
CX
cT
Qu
FA
aB
gZ
"}
(5,1,1) = {"
Sb
aB
ID
ID
aH
YS
ie
lD
nD
ID
ID
aB
ID
tt
YS
gZ
uH
OK
BY
qB
FA
OK
aB
hG
"}
(6,1,1) = {"
Sb
ID
ID
lD
YS
fv
YS
sd
vx
lD
ID
ID
ID
BZ
kX
hG
rM
qB
we
tB
FA
ir
aB
hG
"}
(7,1,1) = {"
Sb
aB
vZ
vZ
vZ
vZ
vZ
vZ
Sb
qB
vZ
ID
ID
tI
YS
rM
aB
cT
CX
CX
FA
FA
aB
KG
"}
(8,1,1) = {"
Sb
aB
qB
ak
Bn
Bn
Sb
we
Sb
qB
qB
aB
ID
kc
az
ID
aB
vZ
vZ
vZ
zy
vZ
eV
Sb
"}
(9,1,1) = {"
Sb
aB
qB
cT
qB
Sb
Sb
fU
MH
ln
qB
aB
Sb
gS
nD
rM
aB
EA
qB
CX
FA
FA
rM
Sb
"}
(10,1,1) = {"
rM
aB
qB
Bn
eI
jc
iW
FA
CX
qB
qB
aB
uH
Qh
zl
hG
aB
qB
zy
FA
FA
FA
rM
Sb
"}
(11,1,1) = {"
gZ
aB
qB
qB
HR
zx
FA
FA
qJ
xa
cT
aB
uH
rM
lD
hG
aB
vZ
sH
dA
dA
UE
eV
Sb
"}
(12,1,1) = {"
gZ
aB
vZ
Gt
Bn
CX
ir
CX
Bi
Bn
vZ
aB
hG
bj
SR
ID
Sb
aB
aB
eV
aB
aB
kX
rM
"}
(13,1,1) = {"
ht
Yk
aB
aB
aB
aB
Bk
rM
aB
aB
aB
MZ
Ir
YS
gS
Ed
aB
aB
zV
zV
fZ
aB
aB
uH
"}
(14,1,1) = {"
rM
uH
hy
uH
rM
hG
Xn
YS
Sb
rM
uH
Ir
aL
zQ
WZ
HB
aB
Sb
RI
Sb
YS
Ou
aB
uH
"}
(15,1,1) = {"
SU
Hq
MJ
Xn
gk
YV
KB
gS
sx
YS
eQ
gS
Zb
sz
nB
WH
ID
ID
xd
rX
YS
YS
aB
hG
"}
(16,1,1) = {"
mV
bv
st
jC
Qz
ID
ID
ID
QG
lD
mo
lD
eF
tn
Ms
nn
ID
ID
xd
nD
nD
nD
eV
Sb
"}
(17,1,1) = {"
Sb
Sb
Sb
ID
ID
ID
ID
ID
ID
ID
ID
eK
KQ
KB
qb
FM
ID
ID
nD
ID
ID
aH
aB
Sb
"}
(18,1,1) = {"
Sb
dH
aB
ID
ID
ID
ID
ID
ID
ID
ID
ID
VZ
qk
lD
IG
ID
ID
ID
ID
nD
aB
aB
Sb
"}
(19,1,1) = {"
Sb
aB
aB
lD
ID
ID
ID
ID
ID
KX
ID
ID
ID
eK
vR
ID
ID
ID
ID
KX
YS
vx
aB
hG
"}
(20,1,1) = {"
rM
aB
Bk
aK
KX
ID
ID
ID
ID
ID
ID
ID
ID
ID
bg
ID
ID
ID
ID
vx
YS
Bk
aB
Am
"}
(21,1,1) = {"
uH
eV
Bk
Et
ID
ID
ID
ID
ID
ID
YS
ID
ID
eY
QG
ID
ID
ID
Sb
Sb
Bk
Bk
aB
gZ
"}
(22,1,1) = {"
hG
aB
aB
Bk
hG
ID
ID
ID
ID
vx
aB
aB
Sb
Lh
gS
zN
ID
aB
zV
zV
zV
aB
aB
rM
"}
(23,1,1) = {"
rM
Yk
aB
aB
ID
ID
ID
ID
aB
aB
aB
Vz
Sb
xg
iw
om
lS
aB
aB
aB
aB
aB
rc
rM
"}
(24,1,1) = {"
Sb
hG
hG
KX
ID
ID
ID
Sb
Sb
Sb
Sb
AJ
Sb
DM
Sb
Sb
Sb
rM
KG
Sb
Sb
Cx
rM
Sb
"}
