//MAP CONVERTED BY dmm2tgm.py THIS HEADER COMMENT PREVENTS RECONVERSION, DO NOT REMOVE
"a" = (
/turf/closed/mineral/volcanic/lava_land_surface,
/area/lavaland/surface/outdoors)
"d" = (
/mob/living/basic/mining/lobstrosity/lava,
/turf/open/misc/asteroid/basalt/lava_land_surface,
/area/lavaland/surface/outdoors)
"e" = (
/obj/structure/ore_vein,
/turf/open/misc/asteroid/basalt/lava_land_surface,
/area/lavaland/surface/outdoors)
"j" = (
/obj/item/fishing_rod/bone,
/obj/structure/ore_vein/diamond,
/mob/living/basic/mining/lobstrosity/lava{
	name = "Big Armored Daddy Chomper";
	desc = "Damn... That's a big one.";
	current_size = 2;
	speed = -0.5;
	health = 900;
	melee_damage_lower = 30;
	melee_damage_upper = 60;
	obj_damage = 60;
	damage_coeff = list("brute" = 1, "burn" = 1, "toxin" = 1, "stamina" = 1, "oxygen" = 1);
	maxHealth = 900;
	butcher_results = null;
	guaranteed_butcher_results = list(/obj/item/food/meat/slab/rawcrab = 16, /obj/item/stack/sheet/bone = 4, /obj/item/organ/internal/monster_core/rush_gland = 1,/obj/item/crusher_trophy/lobster_claw=1);
	base_pixel_y = -32
	},
/turf/open/misc/asteroid/basalt/lava_land_surface,
/area/lavaland/surface/outdoors)
"k" = (
/obj/structure/ore_vein/gold,
/turf/open/misc/asteroid/basalt/lava_land_surface,
/area/lavaland/surface/outdoors)
"l" = (
/turf/template_noop,
/area/template_noop)
"o" = (
/obj/structure/flora/ash/stem_shroom,
/turf/open/misc/asteroid/basalt/lava_land_surface,
/area/lavaland/surface/outdoors)
"q" = (
/mob/living/basic/mining/lobstrosity/lava,
/turf/closed/mineral/volcanic/lava_land_surface,
/area/lavaland/surface/outdoors)
"v" = (
/turf/open/misc/asteroid/basalt/lava_land_surface,
/area/lavaland/surface/outdoors)
"x" = (
/obj/structure/flora/ash/seraka,
/turf/closed/mineral/volcanic/lava_land_surface,
/area/lavaland/surface/outdoors)
"y" = (
/obj/structure/flora/rock/pile/style_random,
/mob/living/basic/mining/lobstrosity/lava,
/turf/closed/mineral/volcanic/lava_land_surface,
/area/lavaland/surface/outdoors)
"B" = (
/obj/item/chair/wood,
/turf/open/misc/asteroid/basalt/lava_land_surface,
/area/lavaland/surface/outdoors)
"C" = (
/obj/structure/flora/ash/cacti,
/turf/open/misc/asteroid/basalt/lava_land_surface,
/area/lavaland/surface/outdoors)
"G" = (
/obj/structure/flora/rock/pile/style_random,
/turf/open/misc/asteroid/basalt/lava_land_surface,
/area/lavaland/surface/outdoors)
"K" = (
/obj/structure/ore_vein/plasma,
/obj/item/fishing_hook/rescue,
/turf/open/misc/asteroid/basalt/lava_land_surface,
/area/lavaland/surface/outdoors)
"L" = (
/obj/item/reagent_containers/cup/bucket/wooden,
/obj/structure/ore_vein/iron,
/turf/open/misc/asteroid/basalt/lava_land_surface,
/area/lavaland/surface/outdoors)
"N" = (
/obj/structure/ore_vein,
/obj/item/xenoarch/useless_relic/magnified{
	name = "Ancient relic";
	desc = "Sort of relic that can be exported through Cargo."
	},
/turf/open/misc/asteroid/basalt/lava_land_surface,
/area/lavaland/surface/outdoors)
"P" = (
/obj/item/fishing_line/sinew,
/obj/structure/ore_vein/silver,
/turf/open/misc/asteroid/basalt/lava_land_surface,
/area/lavaland/surface/outdoors)
"Q" = (
/obj/structure/flora/rock/pile/style_random,
/turf/closed/mineral/volcanic/lava_land_surface,
/area/lavaland/surface/outdoors)
"U" = (
/obj/structure/ore_vein,
/turf/closed/mineral/volcanic/lava_land_surface,
/area/lavaland/surface/outdoors)
"X" = (
/turf/open/lava/smooth/lava_land_surface,
/area/lavaland/surface/outdoors)

(1,1,1) = {"
l
a
a
a
a
U
a
a
l
l
l
l
"}
(2,1,1) = {"
l
Q
X
a
d
a
a
a
x
l
l
l
"}
(3,1,1) = {"
a
a
X
X
X
X
G
a
a
q
l
l
"}
(4,1,1) = {"
a
C
e
X
X
X
X
X
v
a
a
l
"}
(5,1,1) = {"
a
a
G
X
X
P
X
X
X
G
a
l
"}
(6,1,1) = {"
a
U
X
X
N
j
k
X
X
e
a
a
"}
(7,1,1) = {"
a
a
d
X
X
K
L
X
X
d
C
a
"}
(8,1,1) = {"
a
a
X
X
X
X
B
N
X
X
e
U
"}
(9,1,1) = {"
l
U
a
X
X
X
X
X
X
X
X
a
"}
(10,1,1) = {"
l
a
a
y
v
X
X
X
X
X
G
a
"}
(11,1,1) = {"
l
l
a
a
a
o
e
d
X
a
a
a
"}
(12,1,1) = {"
l
l
l
l
a
a
U
a
a
a
a
l
"}
