//MAP CONVERTED BY dmm2tgm.py THIS HEADER COMMENT PREVENTS RECONVERSION, DO NOT REMOVE
"a" = (
/turf/template_noop,
/area/template_noop)
"c" = (
/mob/living/basic/mining/legion/dwarf,
/turf/closed/mineral/volcanic/lava_land_surface,
/area/lavaland/surface/outdoors)
"g" = (
/obj/structure/flora/rock/pile/style_random,
/obj/item/xenoarch/useless_relic{
	name = "Ancient relic";
	desc = "Sort of relic that can be exported through Cargo."
	},
/turf/closed/mineral/volcanic/lava_land_surface,
/area/lavaland/surface/outdoors)
"p" = (
/obj/effect/spawner/random/structure/orevein_longregen,
/turf/closed/mineral/strong{
	base_icon_state = "smoothrocks";
	icon = 'modular_nova/modules/liquids/icons/turf/smoothrocks.dmi';
	icon_state = "smoothrocks-55"
	},
/area/lavaland/surface/outdoors)
"q" = (
/obj/structure/flora/rock/style_random,
/turf/closed/mineral/volcanic/lava_land_surface,
/area/lavaland/surface/outdoors)
"r" = (
/turf/open/lava/smooth/lava_land_surface,
/area/lavaland/surface/outdoors)
"y" = (
/turf/open/chasm/lavaland,
/area/lavaland/surface/outdoors)
"E" = (
/obj/structure/flora/rock/pile/style_random,
/turf/closed/mineral/volcanic/lava_land_surface,
/area/lavaland/surface/outdoors)
"L" = (
/turf/closed/mineral/volcanic/lava_land_surface,
/area/lavaland/surface/outdoors)
"V" = (
/turf/closed/mineral/strong{
	base_icon_state = "smoothrocks";
	icon = 'modular_nova/modules/liquids/icons/turf/smoothrocks.dmi';
	icon_state = "smoothrocks-55"
	},
/area/lavaland/surface/outdoors)
"Y" = (
/obj/effect/spawner/random/structure/orevein_longregen,
/turf/closed/mineral/volcanic/lava_land_surface,
/area/lavaland/surface/outdoors)
"Z" = (
/obj/structure/ore_vent/random{
	ore_vent_options = list("large" = 0, "medium" = 15, "small" = 0);
	name = "Medium ore vent"
	},
/turf/closed/mineral/volcanic/lava_land_surface,
/area/lavaland/surface/outdoors)

(1,1,1) = {"
a
y
r
r
r
a
"}
(2,1,1) = {"
V
y
r
r
a
a
"}
(3,1,1) = {"
V
r
r
r
V
p
"}
(4,1,1) = {"
p
Y
E
r
r
r
"}
(5,1,1) = {"
V
q
c
Z
r
r
"}
(6,1,1) = {"
V
V
L
g
L
r
"}
(7,1,1) = {"
a
V
p
r
y
r
"}
(8,1,1) = {"
a
y
r
r
r
r
"}
(9,1,1) = {"
a
y
a
a
r
r
"}
