//MAP CONVERTED BY dmm2tgm.py THIS HEADER COMMENT PREVENTS RECONVERSION, DO NOT REMOVE
"a" = (
/turf/template_noop,
/area/template_noop)
"e" = (
/obj/structure/flora/rock/pile/style_random,
/turf/closed/mineral/strong{
	base_icon_state = "smoothrocks";
	icon = 'modular_nova/modules/liquids/icons/turf/smoothrocks.dmi';
	icon_state = "smoothrocks-55"
	},
/area/lavaland/surface/outdoors)
"r" = (
/obj/item/xenoarch/useless_relic/magnified{
	name = "Ancient relic";
	desc = "Sort of relic that can be exported through Cargo."
	},
/obj/effect/spawner/random/structure/orevein_longregen,
/turf/closed/mineral/random/high_chance/volcanic,
/area/lavaland/surface/outdoors)
"w" = (
/obj/effect/spawner/random/mob/necropolis_mob,
/turf/closed/mineral/random/high_chance/volcanic,
/area/lavaland/surface/outdoors)
"z" = (
/turf/closed/indestructible/riveted/boss,
/area/lavaland/surface/outdoors)
"S" = (
/turf/closed/mineral/random/high_chance/volcanic,
/area/lavaland/surface/outdoors)
"T" = (
/obj/structure/flora/rock/pile/style_random,
/turf/closed/mineral/random/high_chance/volcanic,
/area/lavaland/surface/outdoors)
"U" = (
/turf/closed/mineral/strong{
	base_icon_state = "smoothrocks";
	icon = 'modular_nova/modules/liquids/icons/turf/smoothrocks.dmi';
	icon_state = "smoothrocks-55"
	},
/area/lavaland/surface/outdoors)
"V" = (
/obj/effect/spawner/random/mob/necropolis_mob,
/obj/effect/spawner/random/structure/orevein_longregen,
/turf/closed/mineral/random/high_chance/volcanic,
/area/lavaland/surface/outdoors)
"X" = (
/obj/effect/spawner/random/structure/orevein_longregen,
/turf/closed/mineral/random/high_chance/volcanic,
/area/lavaland/surface/outdoors)

(1,1,1) = {"
a
a
a
a
a
a
a
a
a
a
a
z
z
z
z
a
"}
(2,1,1) = {"
a
a
a
a
a
a
a
z
a
a
U
U
S
S
z
z
"}
(3,1,1) = {"
a
a
a
a
a
a
a
z
a
U
U
S
T
X
S
z
"}
(4,1,1) = {"
z
a
z
z
z
a
a
z
a
e
X
S
V
X
X
z
"}
(5,1,1) = {"
z
U
U
X
z
z
a
z
z
z
X
X
X
r
X
z
"}
(6,1,1) = {"
z
U
S
X
T
z
a
a
a
U
S
X
S
X
X
z
"}
(7,1,1) = {"
z
S
X
X
S
z
U
a
a
U
U
S
X
X
X
z
"}
(8,1,1) = {"
z
S
w
X
X
X
U
a
a
z
z
z
X
w
S
z
"}
(9,1,1) = {"
z
S
X
X
S
X
U
a
a
a
a
z
S
X
T
U
"}
(10,1,1) = {"
z
X
T
S
w
X
z
z
z
a
a
z
S
X
X
U
"}
(11,1,1) = {"
z
S
X
r
X
T
z
a
a
a
a
z
U
S
S
U
"}
(12,1,1) = {"
z
S
X
S
X
X
z
a
a
a
a
a
U
S
U
U
"}
(13,1,1) = {"
z
U
X
X
S
S
z
a
a
a
a
a
z
z
z
a
"}
(14,1,1) = {"
z
U
S
X
T
U
U
a
a
a
a
a
a
a
a
a
"}
(15,1,1) = {"
a
U
U
S
U
U
a
a
a
a
a
a
a
a
a
a
"}
(16,1,1) = {"
a
a
z
z
z
z
z
z
z
a
a
a
a
a
a
a
"}
