//MAP CONVERTED BY dmm2tgm.py THIS HEADER COMMENT PREVENTS RECONVERSION, DO NOT REMOVE
"a" = (
/obj/structure/stone_tile/slab,
/obj/item/forging/incomplete/katana,
/obj/item/xenoarch/useless_relic{
	name = "Ancient relic";
	desc = "Sort of relic that can be exported through Cargo."
	},
/obj/effect/spawner/random/mob/necropolis_mob,
/turf/open/misc/asteroid/basalt/lava_land_surface,
/area/lavaland/surface/outdoors)
"c" = (
/obj/structure/stone_tile{
	dir = 8
	},
/obj/effect/spawner/random/structure/spikes,
/turf/closed/mineral/volcanic/lava_land_surface,
/area/lavaland/surface/outdoors)
"g" = (
/obj/structure/stone_tile{
	dir = 1
	},
/obj/structure/stone_tile{
	dir = 4
	},
/turf/closed/mineral/volcanic/lava_land_surface,
/area/lavaland/surface/outdoors)
"l" = (
/obj/structure/stone_tile/surrounding_tile{
	dir = 8
	},
/obj/structure/stone_tile/center/burnt,
/turf/open/lava/smooth/lava_land_surface,
/area/lavaland/surface/outdoors)
"m" = (
/turf/open/lava/smooth/lava_land_surface,
/area/lavaland/surface/outdoors)
"o" = (
/obj/structure/stone_tile/surrounding_tile{
	dir = 4
	},
/obj/structure/stone_tile/surrounding_tile,
/turf/open/lava/smooth/lava_land_surface,
/area/lavaland/surface/outdoors)
"p" = (
/obj/structure/stone_tile,
/obj/structure/stone_tile{
	dir = 8
	},
/obj/structure/stone_tile{
	dir = 1
	},
/turf/open/lava/smooth/lava_land_surface,
/area/lavaland/surface/outdoors)
"q" = (
/turf/template_noop,
/area/template_noop)
"s" = (
/obj/structure/stone_tile/slab/cracked{
	dir = 4
	},
/obj/item/forging/incomplete/arrowhead,
/obj/item/xenoarch/useless_relic{
	name = "Ancient relic";
	desc = "Sort of relic that can be exported through Cargo."
	},
/turf/open/misc/asteroid/basalt/lava_land_surface,
/area/lavaland/surface/outdoors)
"v" = (
/obj/structure/stone_tile/slab,
/turf/open/lava/smooth/lava_land_surface,
/area/lavaland/surface/outdoors)
"w" = (
/obj/item/xenoarch/useless_relic{
	name = "Ancient relic";
	desc = "Sort of relic that can be exported through Cargo."
	},
/obj/effect/spawner/random/structure/spikes,
/turf/open/misc/asteroid/basalt/lava_land_surface,
/area/lavaland/surface/outdoors)
"x" = (
/obj/structure/stone_tile,
/obj/structure/stone_tile{
	dir = 8
	},
/obj/structure/stone_tile{
	dir = 1
	},
/obj/structure/stone_tile{
	dir = 4
	},
/obj/effect/spawner/random/mob/necropolis_mob,
/turf/closed/mineral/volcanic/lava_land_surface,
/area/lavaland/surface/outdoors)
"y" = (
/obj/structure/stone_tile/surrounding/cracked,
/turf/closed/mineral/volcanic/lava_land_surface,
/area/lavaland/surface/outdoors)
"z" = (
/obj/structure/stone_tile/surrounding_tile{
	dir = 8
	},
/turf/open/lava/smooth/lava_land_surface,
/area/lavaland/surface/outdoors)
"A" = (
/obj/structure/stone_tile/block/burnt,
/turf/open/lava/smooth/lava_land_surface,
/area/lavaland/surface/outdoors)
"B" = (
/obj/structure/stone_tile/block{
	dir = 4
	},
/obj/structure/stone_tile/block{
	dir = 8
	},
/turf/open/lava/smooth/lava_land_surface,
/area/lavaland/surface/outdoors)
"E" = (
/obj/structure/stone_tile/surrounding_tile{
	dir = 4
	},
/obj/structure/stone_tile/center/burnt,
/turf/open/lava/smooth/lava_land_surface,
/area/lavaland/surface/outdoors)
"F" = (
/obj/structure/stone_tile/slab/cracked{
	dir = 6
	},
/turf/open/lava/smooth/lava_land_surface,
/area/lavaland/surface/outdoors)
"H" = (
/obj/structure/stone_tile/surrounding/burnt,
/obj/structure/stone_tile/center/burnt,
/turf/open/lava/smooth/lava_land_surface,
/area/lavaland/surface/outdoors)
"I" = (
/obj/structure/stone_tile,
/obj/structure/stone_tile{
	dir = 8
	},
/obj/item/forging/incomplete/arrowhead,
/turf/closed/mineral/volcanic/lava_land_surface,
/area/lavaland/surface/outdoors)
"L" = (
/obj/structure/stone_tile/slab/cracked{
	dir = 6
	},
/turf/closed/mineral/volcanic/lava_land_surface,
/area/lavaland/surface/outdoors)
"N" = (
/obj/effect/mapping_helpers/bombable_wall,
/turf/closed/indestructible/riveted/boss/wasteland,
/area/lavaland/surface/outdoors)
"O" = (
/obj/structure/flora/rock/pile/style_random,
/turf/closed/mineral/volcanic/lava_land_surface,
/area/lavaland/surface/outdoors)
"T" = (
/obj/structure/stone_tile/block{
	dir = 1
	},
/obj/structure/stone_tile/block/cracked,
/turf/open/lava/smooth/lava_land_surface,
/area/lavaland/surface/outdoors)
"U" = (
/obj/structure/stone_tile/block{
	dir = 1
	},
/obj/structure/stone_tile/block,
/obj/item/forging/incomplete/arrowhead,
/obj/item/xenoarch/useless_relic{
	name = "Ancient relic";
	desc = "Sort of relic that can be exported through Cargo."
	},
/obj/effect/spawner/random/mob/necropolis_mob,
/turf/open/misc/asteroid/basalt/lava_land_surface,
/area/lavaland/surface/outdoors)
"V" = (
/obj/structure/stone_tile/surrounding_tile{
	dir = 4
	},
/obj/structure/stone_tile/surrounding_tile,
/obj/item/forging/incomplete/arrowhead,
/obj/item/xenoarch/useless_relic{
	name = "Ancient relic";
	desc = "Sort of relic that can be exported through Cargo."
	},
/turf/open/misc/asteroid/basalt/lava_land_surface,
/area/lavaland/surface/outdoors)
"Z" = (
/turf/closed/indestructible/riveted/boss,
/area/lavaland/surface/outdoors)

(1,1,1) = {"
q
N
I
N
x
Z
g
q
"}
(2,1,1) = {"
q
p
V
v
s
z
q
q
"}
(3,1,1) = {"
g
o
Z
B
Z
H
N
y
"}
(4,1,1) = {"
O
Z
T
N
l
Z
F
c
"}
(5,1,1) = {"
q
a
A
w
E
U
m
q
"}
(6,1,1) = {"
q
q
N
q
Z
L
N
q
"}
