//MAP CONVERTED BY dmm2tgm.py THIS HEADER COMMENT PREVENTS RECONVERSION, DO NOT REMOVE
"ak" = (
/obj/structure/stone_tile{
	dir = 1
	},
/obj/structure/stone_tile{
	dir = 4
	},
/obj/structure/stone_tile,
/turf/open/misc/asteroid/basalt/lava_land_surface,
/area/lavaland/surface/outdoors)
"aq" = (
/obj/item/xenoarch/useless_relic{
	name = "Ancient relic";
	desc = "Sort of relic that can be exported through Cargo."
	},
/turf/closed/mineral/volcanic/lava_land_surface,
/area/lavaland/surface/outdoors)
"br" = (
/obj/structure/stone_tile/slab,
/obj/item/shield/buckler{
	pixel_x = -7;
	pixel_y = -4
	},
/turf/closed/mineral/volcanic/lava_land_surface,
/area/lavaland/surface/outdoors)
"bO" = (
/obj/structure/stone_tile{
	dir = 8
	},
/obj/structure/stone_tile,
/obj/structure/stone_tile{
	dir = 1
	},
/turf/open/misc/asteroid/basalt/lava_land_surface,
/area/lavaland/surface/outdoors)
"bU" = (
/obj/structure/stone_tile/slab,
/mob/living/basic/mining/ancient_demon,
/turf/closed/mineral/volcanic/lava_land_surface,
/area/lavaland/surface/outdoors)
"bV" = (
/obj/structure/stone_tile,
/obj/structure/stone_tile{
	dir = 8
	},
/obj/structure/stone_tile{
	dir = 1
	},
/turf/open/misc/asteroid/basalt/lava_land_surface,
/area/lavaland/surface/outdoors)
"cp" = (
/obj/structure/stone_tile/slab/cracked{
	dir = 4
	},
/obj/structure/stone_tile/slab/cracked{
	dir = 8
	},
/turf/closed/mineral/volcanic/lava_land_surface,
/area/lavaland/surface/outdoors)
"cP" = (
/obj/effect/spawner/random/structure/spikes,
/turf/closed/mineral/volcanic/lava_land_surface,
/area/lavaland/surface/outdoors)
"cR" = (
/obj/structure/stone_tile,
/obj/structure/stone_tile{
	dir = 1
	},
/turf/open/misc/asteroid/basalt/lava_land_surface,
/area/lavaland/surface/outdoors)
"dB" = (
/obj/structure/stone_tile/slab/cracked{
	dir = 6
	},
/turf/open/lava/smooth/lava_land_surface,
/area/lavaland/surface/outdoors)
"dP" = (
/obj/structure/stone_tile/slab,
/turf/closed/mineral/strange_rock/volcanic,
/area/lavaland/surface/outdoors)
"fi" = (
/turf/closed/indestructible/riveted/boss,
/area/ruin/unpowered)
"fn" = (
/obj/effect/mapping_helpers/bombable_wall,
/turf/closed/indestructible/riveted/boss/wasteland,
/area/lavaland/surface/outdoors)
"fA" = (
/obj/structure/stone_tile/surrounding/burnt,
/obj/structure/stone_tile/center/burnt,
/turf/open/lava/smooth/lava_land_surface,
/area/lavaland/surface/outdoors)
"fB" = (
/obj/structure/stone_tile/slab/burnt,
/turf/open/lava/smooth/lava_land_surface,
/area/lavaland/surface/outdoors)
"fJ" = (
/turf/closed/mineral/random/high_chance/volcanic,
/area/lavaland/surface/outdoors)
"gq" = (
/obj/structure/stone_tile/slab/cracked{
	dir = 4
	},
/obj/structure/stone_tile/slab/cracked{
	dir = 1
	},
/turf/closed/mineral/random/high_chance/volcanic,
/area/lavaland/surface/outdoors)
"hm" = (
/obj/effect/spawner/random/structure/orevein_longregen,
/turf/open/misc/asteroid/basalt/lava_land_surface,
/area/lavaland/surface/outdoors)
"hq" = (
/obj/item/clothing/gloves/bracer,
/obj/structure/stone_tile/slab,
/mob/living/basic/mining/lobstrosity/lava,
/mob/living/basic/mining/lobstrosity/lava,
/mob/living/basic/mining/lobstrosity/lava,
/turf/closed/mineral/volcanic/lava_land_surface,
/area/lavaland/surface/outdoors)
"kb" = (
/obj/structure/stone_tile/slab/cracked{
	dir = 4
	},
/turf/open/lava/smooth/lava_land_surface,
/area/lavaland/surface/outdoors)
"kI" = (
/obj/structure/stone_tile/slab,
/obj/item/coin/silver{
	pixel_x = 6;
	pixel_y = 4
	},
/turf/closed/mineral/random/high_chance/volcanic,
/area/lavaland/surface/outdoors)
"kZ" = (
/obj/structure/stone_tile/slab,
/obj/item/xenoarch/useless_relic{
	name = "Ancient relic";
	desc = "Sort of relic that can be exported through Cargo."
	},
/turf/closed/mineral/random/high_chance/volcanic,
/area/lavaland/surface/outdoors)
"mz" = (
/obj/structure/stone_tile{
	dir = 8
	},
/obj/structure/stone_tile{
	dir = 4
	},
/turf/closed/mineral/volcanic/lava_land_surface,
/area/lavaland/surface/outdoors)
"mB" = (
/obj/structure/stone_tile/slab,
/obj/effect/spawner/random/entertainment/coin{
	pixel_x = 4;
	pixel_y = -7
	},
/turf/closed/mineral/random/high_chance/volcanic,
/area/ruin/unpowered)
"mN" = (
/obj/structure/stone_tile/slab/cracked{
	dir = 6
	},
/turf/closed/mineral/random/high_chance/volcanic,
/area/lavaland/surface/outdoors)
"mV" = (
/obj/structure/stone_tile/block{
	dir = 8
	},
/obj/structure/stone_tile/block/cracked{
	dir = 4
	},
/turf/closed/mineral/volcanic/lava_land_surface,
/area/lavaland/surface/outdoors)
"oJ" = (
/obj/structure/stone_tile/slab/cracked{
	dir = 4
	},
/obj/structure/stone_tile/slab/cracked{
	dir = 1
	},
/turf/closed/mineral/random/high_chance/volcanic,
/area/ruin/unpowered)
"pE" = (
/obj/structure/stone_tile/slab,
/obj/effect/spawner/random/entertainment/coin{
	pixel_x = 4;
	pixel_y = -5
	},
/turf/closed/mineral/random/high_chance/volcanic,
/area/ruin/unpowered)
"pM" = (
/obj/structure/stone_tile/surrounding/cracked,
/turf/closed/mineral/volcanic/lava_land_surface,
/area/lavaland/surface/outdoors)
"qj" = (
/obj/structure/stone_tile/surrounding_tile{
	dir = 8
	},
/obj/structure/stone_tile/surrounding_tile{
	dir = 1
	},
/obj/structure/stone_tile/center/cracked,
/turf/closed/mineral/random/high_chance/volcanic,
/area/lavaland/surface/outdoors)
"qk" = (
/obj/structure/stone_tile/block{
	dir = 4
	},
/obj/structure/stone_tile/block/burnt{
	dir = 8
	},
/turf/open/misc/asteroid/basalt/lava_land_surface,
/area/lavaland/surface/outdoors)
"qt" = (
/obj/structure/stone_tile/slab/cracked,
/turf/closed/mineral/volcanic/lava_land_surface,
/area/lavaland/surface/outdoors)
"qy" = (
/obj/structure/flora/rock/pile/style_random,
/turf/open/misc/asteroid/basalt/lava_land_surface,
/area/lavaland/surface/outdoors)
"qV" = (
/turf/open/lava/smooth/lava_land_surface,
/area/lavaland/surface/outdoors)
"rx" = (
/obj/structure/stone_tile/slab/cracked{
	dir = 4
	},
/obj/structure/stone_tile/slab/cracked{
	dir = 1
	},
/turf/open/lava/smooth/lava_land_surface,
/area/lavaland/surface/outdoors)
"ry" = (
/obj/structure/stone_tile/slab/cracked{
	dir = 1
	},
/turf/closed/indestructible/riveted/boss,
/area/ruin/unpowered)
"rE" = (
/obj/structure/stone_tile/block/cracked{
	dir = 1
	},
/turf/open/misc/asteroid/basalt/lava_land_surface,
/area/lavaland/surface/outdoors)
"rX" = (
/obj/structure/stone_tile/block{
	dir = 1
	},
/obj/structure/stone_tile/block/cracked,
/turf/closed/mineral/volcanic/lava_land_surface,
/area/lavaland/surface/outdoors)
"sd" = (
/obj/structure/stone_tile/surrounding/cracked{
	dir = 1
	},
/turf/open/lava/smooth/lava_land_surface,
/area/lavaland/surface/outdoors)
"sm" = (
/obj/structure/stone_tile/slab/cracked{
	dir = 4
	},
/obj/structure/stone_tile/slab/cracked{
	dir = 1
	},
/obj/effect/spawner/random/mob/necropolis_mob,
/turf/open/misc/asteroid/basalt/lava_land_surface,
/area/lavaland/surface/outdoors)
"sn" = (
/obj/structure/stone_tile/block/cracked,
/obj/effect/spawner/random/structure/spikes,
/turf/open/misc/asteroid/basalt/lava_land_surface,
/area/lavaland/surface/outdoors)
"sS" = (
/obj/structure/stone_tile/slab,
/turf/closed/mineral/volcanic/lava_land_surface,
/area/lavaland/surface/outdoors)
"tc" = (
/obj/effect/spawner/random/structure/spikes,
/turf/closed/mineral/random/high_chance/volcanic,
/area/lavaland/surface/outdoors)
"tz" = (
/obj/structure/stone_tile/slab,
/turf/closed/mineral/random/high_chance/volcanic,
/area/lavaland/surface/outdoors)
"tC" = (
/obj/structure/stone_tile/slab,
/obj/item/reagent_containers/cup/bucket/wooden{
	pixel_x = 10;
	pixel_y = 4
	},
/turf/closed/mineral/random/high_chance/volcanic,
/area/lavaland/surface/outdoors)
"tH" = (
/obj/structure/stone_tile/slab/cracked,
/obj/item/xenoarch/useless_relic{
	name = "Ancient relic";
	desc = "Sort of relic that can be exported through Cargo."
	},
/turf/closed/mineral/volcanic/lava_land_surface,
/area/lavaland/surface/outdoors)
"tN" = (
/obj/structure/stone_tile/slab,
/obj/item/xenoarch/useless_relic/magnified{
	name = "Ancient relic";
	desc = "Sort of relic that can be exported through Cargo."
	},
/turf/closed/mineral/random/high_chance/volcanic,
/area/ruin/unpowered)
"uh" = (
/obj/structure/stone_tile{
	dir = 8
	},
/obj/structure/stone_tile{
	dir = 1
	},
/obj/structure/stone_tile{
	dir = 4
	},
/turf/open/misc/asteroid/basalt/lava_land_surface,
/area/lavaland/surface/outdoors)
"uY" = (
/obj/structure/stone_tile/slab,
/obj/effect/spawner/random/mob/necropolis_mob,
/turf/closed/mineral/volcanic/lava_land_surface,
/area/lavaland/surface/outdoors)
"wI" = (
/obj/structure/stone_tile/slab,
/obj/item/xenoarch/useless_relic/magnified{
	name = "Ancient relic";
	desc = "Sort of relic that can be exported through Cargo."
	},
/turf/closed/mineral/random/high_chance/volcanic,
/area/lavaland/surface/outdoors)
"wU" = (
/obj/structure/stone_tile/slab,
/obj/structure/stone_tile/block/cracked,
/turf/open/lava/smooth/lava_land_surface,
/area/lavaland/surface/outdoors)
"xb" = (
/obj/structure/stone_tile/slab/cracked{
	dir = 4
	},
/obj/structure/stone_tile/slab/cracked{
	dir = 8
	},
/obj/item/xenoarch/useless_relic/magnified{
	name = "Ancient relic";
	desc = "Sort of relic that can be exported through Cargo."
	},
/turf/open/misc/asteroid/basalt/lava_land_surface,
/area/lavaland/surface/outdoors)
"xF" = (
/obj/structure/stone_tile/slab,
/turf/closed/mineral/volcanic/lava_land_surface,
/area/ruin/unpowered)
"xQ" = (
/obj/structure/stone_tile/surrounding_tile{
	dir = 1
	},
/obj/structure/stone_tile/surrounding_tile{
	dir = 8
	},
/obj/structure/stone_tile/center/cracked,
/turf/closed/mineral/random/high_chance/volcanic,
/area/lavaland/surface/outdoors)
"yQ" = (
/obj/effect/spawner/random/structure/orevein_longregen,
/turf/closed/mineral/random/high_chance/volcanic,
/area/lavaland/surface/outdoors)
"zy" = (
/obj/structure/stone_tile/slab,
/obj/effect/spawner/random/entertainment/coin{
	pixel_x = 8;
	pixel_y = 7
	},
/turf/closed/mineral/volcanic/lava_land_surface,
/area/lavaland/surface/outdoors)
"zW" = (
/obj/structure/flora/rock/pile/style_random,
/turf/closed/mineral/volcanic/lava_land_surface,
/area/lavaland/surface/outdoors)
"AK" = (
/obj/structure/stone_tile/slab/cracked{
	dir = 6
	},
/mob/living/basic/mining/lobstrosity/lava,
/mob/living/basic/mining/lobstrosity/lava,
/turf/open/misc/asteroid/basalt/lava_land_surface,
/area/lavaland/surface/outdoors)
"AX" = (
/obj/structure/stone_tile/slab/cracked{
	dir = 6
	},
/turf/closed/mineral/volcanic/lava_land_surface,
/area/lavaland/surface/outdoors)
"Be" = (
/obj/structure/stone_tile{
	dir = 8
	},
/obj/structure/stone_tile{
	dir = 1
	},
/obj/structure/stone_tile{
	dir = 4
	},
/obj/structure/stone_tile/cracked,
/turf/open/misc/asteroid/basalt/lava_land_surface,
/area/lavaland/surface/outdoors)
"BF" = (
/obj/structure/trap/fire{
	name = "Anctient runic spikes";
	desc = "A strange carving of some symbols. What's that for?";
	alpha = 180;
	icon = 'icons/obj/service/hydroponics/equipment.dmi';
	icon_state = "woodspike";
	light_color = "#FF1111";
	color = "#FF1111";
	max_integrity = 30
	},
/turf/closed/mineral/random/high_chance/volcanic,
/area/lavaland/surface/outdoors)
"BI" = (
/obj/structure/stone_tile/surrounding/cracked{
	dir = 6
	},
/obj/structure/stone_tile/center/cracked,
/turf/closed/mineral/volcanic/lava_land_surface,
/area/lavaland/surface/outdoors)
"Cy" = (
/obj/structure/stone_tile/slab,
/obj/item/coin/silver,
/turf/closed/mineral/volcanic/lava_land_surface,
/area/lavaland/surface/outdoors)
"CU" = (
/obj/structure/stone_tile/slab,
/obj/item/xenoarch/useless_relic{
	name = "Ancient relic";
	desc = "Sort of relic that can be exported through Cargo."
	},
/turf/closed/mineral/random/high_chance/volcanic,
/area/ruin/unpowered)
"Dl" = (
/obj/effect/spawner/random/structure/spikes,
/turf/closed/mineral/strange_rock/volcanic,
/area/lavaland/surface/outdoors)
"Dq" = (
/obj/structure/flora/rock/pile/style_random,
/obj/effect/spawner/random/mob/necropolis_mob,
/turf/open/misc/asteroid/basalt/lava_land_surface,
/area/lavaland/surface/outdoors)
"Ec" = (
/obj/structure/stone_tile/surrounding/cracked,
/turf/open/lava/smooth/lava_land_surface,
/area/lavaland/surface/outdoors)
"Fl" = (
/obj/item/reagent_containers/cup/bowl/wood_bowl,
/obj/structure/stone_tile/slab,
/turf/closed/mineral/volcanic/lava_land_surface,
/area/lavaland/surface/outdoors)
"FB" = (
/obj/structure/stone_tile{
	dir = 8
	},
/obj/structure/stone_tile{
	dir = 1
	},
/obj/structure/stone_tile{
	dir = 4
	},
/turf/closed/mineral/random/high_chance/volcanic,
/area/lavaland/surface/outdoors)
"FQ" = (
/obj/structure/stone_tile/slab,
/turf/open/lava/smooth/lava_land_surface,
/area/lavaland/surface/outdoors)
"Gn" = (
/obj/structure/stone_tile{
	dir = 8
	},
/obj/structure/stone_tile{
	dir = 1
	},
/obj/structure/stone_tile/cracked{
	dir = 4
	},
/turf/open/misc/asteroid/basalt/lava_land_surface,
/area/lavaland/surface/outdoors)
"GB" = (
/obj/structure/stone_tile/slab/cracked{
	dir = 4
	},
/obj/effect/spawner/random/mob/necropolis_mob,
/turf/open/misc/asteroid/basalt/lava_land_surface,
/area/lavaland/surface/outdoors)
"GY" = (
/turf/closed/indestructible/riveted/boss,
/area/lavaland/surface/outdoors)
"Hb" = (
/obj/structure/stone_tile/block{
	dir = 4
	},
/turf/closed/mineral/volcanic/lava_land_surface,
/area/lavaland/surface/outdoors)
"Ib" = (
/obj/structure/flora/rock/pile/style_random,
/obj/effect/spawner/random/structure/spikes,
/turf/open/misc/asteroid/basalt/lava_land_surface,
/area/lavaland/surface/outdoors)
"Id" = (
/obj/structure/stone_tile,
/obj/structure/stone_tile{
	dir = 8
	},
/obj/structure/stone_tile{
	dir = 4
	},
/turf/closed/mineral/volcanic/lava_land_surface,
/area/lavaland/surface/outdoors)
"Ih" = (
/obj/item/kitchen/spoon,
/obj/structure/stone_tile/slab,
/turf/closed/mineral/volcanic/lava_land_surface,
/area/lavaland/surface/outdoors)
"II" = (
/obj/structure/stone_tile/slab,
/mob/living/basic/mining/ancient_demon/ancient_demon_lesser,
/turf/open/misc/asteroid/basalt/lava_land_surface,
/area/lavaland/surface/outdoors)
"IL" = (
/obj/structure/stone_tile{
	dir = 8
	},
/obj/structure/stone_tile{
	dir = 4
	},
/turf/open/misc/asteroid/basalt/lava_land_surface,
/area/lavaland/surface/outdoors)
"IS" = (
/obj/structure/stone_tile/slab/cracked,
/turf/open/misc/asteroid/basalt/lava_land_surface,
/area/lavaland/surface/outdoors)
"JQ" = (
/obj/structure/stone_tile/block/cracked{
	dir = 1
	},
/turf/closed/mineral/volcanic/lava_land_surface,
/area/lavaland/surface/outdoors)
"Kx" = (
/obj/structure/stone_tile{
	dir = 8
	},
/obj/structure/stone_tile{
	dir = 4
	},
/obj/structure/stone_tile{
	dir = 1
	},
/turf/open/misc/asteroid/basalt/lava_land_surface,
/area/lavaland/surface/outdoors)
"KD" = (
/obj/structure/stone_tile{
	dir = 8
	},
/obj/structure/stone_tile/cracked,
/obj/effect/spawner/random/structure/spikes,
/turf/closed/mineral/volcanic/lava_land_surface,
/area/lavaland/surface/outdoors)
"KE" = (
/turf/closed/mineral/strange_rock/volcanic,
/area/lavaland/surface/outdoors)
"La" = (
/obj/structure/stone_tile/surrounding/cracked{
	dir = 4
	},
/turf/open/lava/smooth/lava_land_surface,
/area/lavaland/surface/outdoors)
"LE" = (
/obj/structure/stone_tile/slab,
/mob/living/basic/mining/ancient_demon/ancient_demon_lesser,
/turf/closed/mineral/random/high_chance/volcanic,
/area/ruin/unpowered)
"LN" = (
/obj/structure/stone_tile,
/obj/structure/stone_tile{
	dir = 8
	},
/obj/effect/spawner/random/structure/spikes,
/turf/closed/mineral/volcanic/lava_land_surface,
/area/lavaland/surface/outdoors)
"Mk" = (
/obj/structure/stone_tile/slab/cracked{
	dir = 6
	},
/turf/open/misc/asteroid/basalt/lava_land_surface,
/area/lavaland/surface/outdoors)
"Mt" = (
/turf/open/misc/asteroid/basalt/lava_land_surface,
/area/lavaland/surface/outdoors)
"MO" = (
/obj/structure/stone_tile/slab,
/turf/open/misc/asteroid/basalt/lava_land_surface,
/area/lavaland/surface/outdoors)
"MX" = (
/obj/structure/stone_tile/slab,
/obj/item/coin/silver{
	pixel_x = 3;
	pixel_y = -12
	},
/turf/closed/mineral/random/high_chance/volcanic,
/area/lavaland/surface/outdoors)
"Ng" = (
/obj/structure/stone_tile{
	dir = 8
	},
/obj/structure/stone_tile/burnt,
/obj/effect/spawner/random/structure/spikes,
/turf/closed/mineral/volcanic/lava_land_surface,
/area/lavaland/surface/outdoors)
"Nm" = (
/obj/structure/stone_tile{
	dir = 8
	},
/obj/structure/stone_tile{
	dir = 4
	},
/turf/closed/mineral/random/high_chance/volcanic,
/area/lavaland/surface/outdoors)
"NM" = (
/obj/structure/stone_tile/slab,
/obj/effect/spawner/random/entertainment/coin{
	pixel_x = -6;
	pixel_y = -10
	},
/turf/closed/mineral/random/high_chance/volcanic,
/area/lavaland/surface/outdoors)
"Oy" = (
/obj/effect/spawner/random/structure/orevein_longregen,
/turf/closed/mineral/volcanic/lava_land_surface,
/area/lavaland/surface/outdoors)
"OD" = (
/obj/structure/stone_tile/slab/cracked,
/obj/effect/spawner/random/mob/necropolis_mob,
/turf/open/misc/asteroid/basalt/lava_land_surface,
/area/lavaland/surface/outdoors)
"Pj" = (
/obj/structure/stone_tile/surrounding_tile{
	dir = 4
	},
/obj/structure/stone_tile/surrounding_tile,
/obj/structure/stone_tile/center,
/turf/closed/mineral/volcanic/lava_land_surface,
/area/lavaland/surface/outdoors)
"Pm" = (
/obj/item/reagent_containers/cup/bowl/wood_bowl,
/obj/structure/stone_tile/slab,
/turf/closed/mineral/random/high_chance/volcanic,
/area/ruin/unpowered)
"Pv" = (
/obj/structure/stone_tile/slab,
/obj/item/coin/silver{
	pixel_x = -6;
	pixel_y = 0
	},
/turf/closed/mineral/volcanic/lava_land_surface,
/area/ruin/unpowered)
"QB" = (
/obj/effect/spawner/random/structure/orevein_longregen,
/turf/closed/mineral/strange_rock/volcanic,
/area/ruin/unpowered)
"QN" = (
/obj/structure/stone_tile/block{
	dir = 1
	},
/obj/structure/stone_tile/block,
/turf/open/misc/asteroid/basalt/lava_land_surface,
/area/lavaland/surface/outdoors)
"Rd" = (
/obj/structure/flora/rock/pile/style_random,
/turf/closed/mineral/random/high_chance/volcanic,
/area/lavaland/surface/outdoors)
"Rs" = (
/obj/structure/stone_tile/slab/cracked{
	dir = 6
	},
/mob/living/basic/mining/ancient_demon,
/turf/closed/mineral/volcanic/lava_land_surface,
/area/lavaland/surface/outdoors)
"RC" = (
/obj/structure/stone_tile/block/cracked{
	dir = 4
	},
/obj/effect/spawner/random/mob/necropolis_mob,
/turf/open/misc/asteroid/basalt/lava_land_surface,
/area/lavaland/surface/outdoors)
"RJ" = (
/obj/structure/stone_tile/slab/cracked{
	dir = 1
	},
/turf/open/lava/smooth/lava_land_surface,
/area/lavaland/surface/outdoors)
"Sa" = (
/obj/structure/stone_tile/slab,
/obj/effect/spawner/random/entertainment/coin{
	pixel_x = -10;
	pixel_y = 3
	},
/turf/closed/mineral/random/high_chance/volcanic,
/area/lavaland/surface/outdoors)
"Sg" = (
/obj/structure/stone_tile/slab,
/turf/closed/mineral/random/high_chance/volcanic,
/area/ruin/unpowered)
"Sk" = (
/obj/structure/stone_tile/slab,
/obj/item/coin/silver{
	pixel_x = -8;
	pixel_y = 7
	},
/turf/closed/mineral/volcanic/lava_land_surface,
/area/lavaland/surface/outdoors)
"SJ" = (
/obj/structure/stone_tile,
/obj/structure/stone_tile{
	dir = 8
	},
/obj/structure/stone_tile{
	dir = 4
	},
/obj/structure/stone_tile/cracked{
	dir = 1
	},
/turf/open/misc/asteroid/basalt/lava_land_surface,
/area/lavaland/surface/outdoors)
"SS" = (
/obj/structure/stone_tile,
/obj/structure/stone_tile{
	dir = 1
	},
/obj/structure/stone_tile/cracked{
	dir = 4
	},
/turf/closed/mineral/volcanic/lava_land_surface,
/area/lavaland/surface/outdoors)
"Tb" = (
/obj/structure/stone_tile/slab/cracked{
	dir = 4
	},
/obj/structure/stone_tile/slab/cracked{
	dir = 8
	},
/turf/open/lava/smooth/lava_land_surface,
/area/lavaland/surface/outdoors)
"Tz" = (
/obj/structure/stone_tile,
/obj/structure/stone_tile{
	dir = 1
	},
/obj/structure/stone_tile{
	dir = 4
	},
/turf/closed/mineral/volcanic/lava_land_surface,
/area/lavaland/surface/outdoors)
"TN" = (
/obj/structure/stone_tile,
/obj/structure/stone_tile{
	dir = 8
	},
/obj/structure/stone_tile{
	dir = 4
	},
/turf/open/misc/asteroid/basalt/lava_land_surface,
/area/lavaland/surface/outdoors)
"UN" = (
/turf/template_noop,
/area/template_noop)
"UY" = (
/obj/structure/stone_tile/slab/cracked{
	dir = 4
	},
/obj/structure/stone_tile/slab/cracked{
	dir = 8
	},
/turf/open/misc/asteroid/basalt/lava_land_surface,
/area/lavaland/surface/outdoors)
"Va" = (
/obj/structure/stone_tile,
/obj/structure/stone_tile{
	dir = 8
	},
/obj/structure/stone_tile{
	dir = 1
	},
/turf/closed/mineral/volcanic/lava_land_surface,
/area/lavaland/surface/outdoors)
"Vj" = (
/obj/structure/stone_tile/surrounding_tile,
/obj/structure/stone_tile/surrounding_tile{
	dir = 4
	},
/obj/structure/stone_tile/center,
/turf/closed/mineral/random/high_chance/volcanic,
/area/lavaland/surface/outdoors)
"We" = (
/obj/structure/stone_tile/slab,
/obj/item/xenoarch/useless_relic{
	name = "Ancient relic";
	desc = "Sort of relic that can be exported through Cargo."
	},
/turf/closed/mineral/volcanic/lava_land_surface,
/area/ruin/unpowered)
"WQ" = (
/obj/structure/stone_tile/slab/cracked{
	dir = 6
	},
/turf/closed/mineral/random/high_chance/volcanic,
/area/ruin/unpowered)
"WR" = (
/obj/structure/stone_tile/slab,
/obj/effect/spawner/random/mob/necropolis_mob,
/turf/closed/mineral/random/high_chance/volcanic,
/area/lavaland/surface/outdoors)
"Xr" = (
/obj/structure/stone_tile/block{
	dir = 1
	},
/obj/structure/stone_tile/block,
/turf/closed/mineral/volcanic/lava_land_surface,
/area/lavaland/surface/outdoors)
"XE" = (
/obj/effect/spawner/random/structure/orevein_longregen,
/turf/closed/mineral/random/high_chance/volcanic,
/area/ruin/unpowered)
"Zs" = (
/obj/structure/stone_tile/slab/cracked{
	dir = 6
	},
/obj/effect/spawner/random/entertainment/coin{
	pixel_x = 6;
	pixel_y = -8
	},
/turf/open/misc/asteroid/basalt/lava_land_surface,
/area/lavaland/surface/outdoors)
"ZX" = (
/turf/closed/mineral/volcanic/lava_land_surface,
/area/lavaland/surface/outdoors)

(1,1,1) = {"
UN
UN
UN
UN
UN
UN
UN
UN
ZX
Oy
ZX
ZX
ZX
ZX
ZX
IL
UN
IL
UN
mz
fJ
Nm
Oy
UN
"}
(2,1,1) = {"
UN
Kx
GY
GY
GY
GY
GY
GY
ZX
fJ
Nm
cP
cP
GY
GY
GY
GY
GY
GY
GY
tc
GY
Id
cP
"}
(3,1,1) = {"
cP
GY
GY
tC
kI
GY
MO
MO
MO
yQ
fJ
fJ
yQ
yQ
tz
kZ
GY
br
sS
Rd
tz
fi
fi
Ng
"}
(4,1,1) = {"
zW
GY
kZ
NM
AK
FQ
sd
La
rx
MO
GY
GB
MO
tz
WR
tz
MX
mN
sS
sS
LE
Sg
fi
tc
"}
(5,1,1) = {"
cP
fn
hm
UN
wU
qV
qV
qV
qV
hm
GY
MO
MO
Mk
fJ
gq
tz
sS
uY
Pv
WQ
mB
fi
cP
"}
(6,1,1) = {"
UN
GY
hm
dB
qV
qV
FQ
FQ
qV
qV
qV
qV
MO
UN
UN
MO
fi
QB
xF
XE
pE
CU
fi
UN
"}
(7,1,1) = {"
UN
GY
GY
qV
qV
GY
GY
GY
GY
GY
qV
qV
qV
MO
GY
GY
fi
fi
fi
fi
fi
fi
fi
UN
"}
(8,1,1) = {"
UN
GY
qV
qV
FQ
MO
tz
mN
Sa
Oy
GY
qV
qV
FQ
UN
Mk
GY
Mk
qV
qV
qV
hm
fn
UN
"}
(9,1,1) = {"
qV
qV
qV
Ec
sm
sS
ZX
fJ
Rd
wI
GY
MO
qV
qV
UN
UN
GY
qV
qV
qV
qV
qV
GY
cP
"}
(10,1,1) = {"
UN
GY
fB
MO
sS
Fl
UN
UN
tz
sS
GY
qV
qV
Dq
UN
MO
FQ
qV
RJ
Ib
qV
qV
GY
aq
"}
(11,1,1) = {"
qy
GY
MO
zW
tz
BF
Rs
UN
ZX
MO
GY
qV
qV
qV
FQ
FQ
qV
qV
rx
MO
FQ
qV
qV
UN
"}
(12,1,1) = {"
UN
GY
GY
kZ
Oy
sS
UN
UN
cp
GY
GY
GY
qV
qV
qV
qV
qV
FQ
UN
MO
UY
GY
qV
qV
"}
(13,1,1) = {"
UN
ak
GY
GY
GY
GY
ZX
ZX
GY
GY
cR
GY
GY
GY
GY
qV
GY
GY
UN
AX
GY
GY
bO
UN
"}
(14,1,1) = {"
UN
UN
UN
cP
cP
tc
fJ
ZX
ZX
ZX
UN
Dl
aq
cP
UN
qV
qV
qV
UN
sS
Oy
aq
ZX
UN
"}
(15,1,1) = {"
rE
IS
Gn
MO
RC
qt
pM
WR
SS
MO
QN
Vj
xQ
rX
qt
Be
kb
Ec
MO
Hb
yQ
FB
OD
sn
"}
(16,1,1) = {"
UN
UY
KD
MO
qk
MO
BI
tH
bV
II
JQ
qj
Pj
Xr
MO
SJ
RJ
fA
OD
mV
sS
Va
sS
QN
"}
(17,1,1) = {"
UN
UN
cP
cP
UN
UN
UN
ZX
UN
UN
ZX
ZX
UN
UN
UN
qV
qV
UN
cP
fJ
UN
UN
UN
UN
"}
(18,1,1) = {"
UN
uh
fi
fi
GY
GY
UN
cP
GY
GY
mz
GY
GY
GY
GY
qV
GY
GY
ZX
tc
fi
fi
TN
UN
"}
(19,1,1) = {"
UN
fi
fi
xF
mN
hq
UN
sS
Ih
GY
GY
GY
MO
qV
qV
qV
FQ
Zs
ZX
yQ
Sk
ry
fi
ZX
"}
(20,1,1) = {"
cP
fi
We
sS
ZX
qy
UN
UN
sS
sS
GY
MO
Mk
qV
qV
qV
FQ
MO
ZX
bU
tz
oJ
fi
ZX
"}
(21,1,1) = {"
cP
fi
XE
Sg
dP
Cy
AX
UN
mN
yQ
GY
xb
UN
Mt
qV
qV
qV
Tb
Mk
sS
Pm
tN
fi
fJ
"}
(22,1,1) = {"
cP
fi
fi
oJ
yQ
tz
zy
sS
Oy
GY
GY
GY
UN
UN
Dq
GY
qV
FQ
MO
fJ
XE
fi
fi
fJ
"}
(23,1,1) = {"
cP
Tz
fi
fi
GY
ZX
ZX
GY
GY
GY
cR
GY
fn
GY
GY
GY
qV
qV
GY
GY
fi
fi
LN
KE
"}
(24,1,1) = {"
UN
UN
UN
UN
ZX
ZX
ZX
zW
ZX
UN
UN
UN
UN
UN
cP
cP
cP
qV
UN
qy
cP
fJ
ZX
UN
"}
