//MAP CONVERTED BY dmm2tgm.py THIS HEADER COMMENT PREVENTS RECONVERSION, DO NOT REMOVE
"a" = (
/turf/template_noop,
/area/template_noop)
"b" = (
/obj/structure/flora/rock/style_random,
/turf/closed/mineral/random/high_chance/volcanic,
/area/lavaland/surface/outdoors)
"i" = (
/obj/structure/punji_sticks/spikes,
/turf/closed/mineral/volcanic/lava_land_surface,
/area/lavaland/surface/outdoors)
"o" = (
/obj/structure/healingfountain,
/turf/closed/mineral/random/high_chance/volcanic,
/area/lavaland/surface/outdoors)
"p" = (
/turf/open/chasm/lavaland,
/area/lavaland/surface/outdoors)
"s" = (
/turf/closed/mineral/volcanic/lava_land_surface,
/area/lavaland/surface/outdoors)
"t" = (
/mob/living/basic/mining/brimdemon,
/turf/closed/mineral/random/high_chance/volcanic,
/area/lavaland/surface/outdoors)
"A" = (
/obj/structure/punji_sticks/spikes,
/turf/closed/mineral/random/high_chance/volcanic,
/area/lavaland/surface/outdoors)
"C" = (
/obj/structure/flora/rock/pile/style_random,
/turf/closed/mineral/random/high_chance/volcanic,
/area/lavaland/surface/outdoors)
"D" = (
/mob/living/basic/mining/goliath,
/turf/closed/mineral/random/high_chance/volcanic,
/area/lavaland/surface/outdoors)
"O" = (
/obj/structure/flora/rock/pile/style_random,
/turf/closed/mineral/volcanic/lava_land_surface,
/area/lavaland/surface/outdoors)

(1,1,1) = {"
a
a
s
O
a
a
"}
(2,1,1) = {"
a
s
A
p
p
i
"}
(3,1,1) = {"
s
t
C
p
A
s
"}
(4,1,1) = {"
i
p
p
p
D
a
"}
(5,1,1) = {"
s
b
p
o
A
a
"}
(6,1,1) = {"
a
a
p
A
s
a
"}
(7,1,1) = {"
a
a
A
C
a
a
"}
