//MAP CONVERTED BY dmm2tgm.py THIS HEADER COMMENT PREVENTS RECONVERSION, DO NOT REMOVE
"c" = (
/turf/closed/mineral/asteroid,
/area/template_noop)
"R" = (
/turf/template_noop,
/area/template_noop)
"T" = (
/turf/closed/mineral/bananium,
/area/template_noop)

(1,1,1) = {"
R
R
R
R
R
R
R
R
R
c
c
c
R
"}
(2,1,1) = {"
R
R
R
R
R
R
R
R
c
T
T
c
c
"}
(3,1,1) = {"
R
R
R
R
R
R
R
R
c
T
T
c
c
"}
(4,1,1) = {"
R
R
R
R
R
R
R
R
c
T
T
c
c
"}
(5,1,1) = {"
R
R
R
R
R
R
R
c
c
T
T
c
c
"}
(6,1,1) = {"
R
R
R
R
R
R
c
c
T
T
T
c
c
"}
(7,1,1) = {"
R
R
R
R
R
R
c
T
T
T
T
c
c
"}
(8,1,1) = {"
c
c
R
R
c
c
c
T
T
T
T
c
c
"}
(9,1,1) = {"
c
c
c
c
c
T
T
T
T
T
T
c
R
"}
(10,1,1) = {"
c
T
T
T
T
T
T
T
T
T
c
c
R
"}
(11,1,1) = {"
c
c
T
T
T
T
T
T
T
c
c
R
R
"}
(12,1,1) = {"
R
c
c
T
T
T
T
T
c
c
R
R
R
"}
(13,1,1) = {"
R
R
c
c
c
c
c
c
c
R
R
R
R
"}
