//MAP CONVERTED BY dmm2tgm.py THIS HEADER COMMENT PREVENTS RECONVERSION, DO NOT REMOVE
"a" = (
/mob/living/basic/mining/basilisk,
/turf/closed/mineral/diamond,
/area/template_noop)
"j" = (
/turf/open/misc/asteroid/airless,
/area/template_noop)
"o" = (
/turf/closed/mineral/diamond,
/area/template_noop)
"J" = (
/turf/template_noop,
/area/template_noop)

(1,1,1) = {"
J
J
j
J
J
J
J
J
J
J
J
J
J
"}
(2,1,1) = {"
J
j
o
J
J
o
J
J
J
o
J
J
J
"}
(3,1,1) = {"
J
j
o
J
j
o
J
J
o
o
J
J
J
"}
(4,1,1) = {"
J
o
o
J
o
j
J
J
o
o
J
J
J
"}
(5,1,1) = {"
j
o
o
J
j
J
J
o
a
o
J
J
J
"}
(6,1,1) = {"
j
o
o
J
j
J
J
o
o
o
J
J
J
"}
(7,1,1) = {"
o
o
o
J
J
J
o
o
o
J
J
J
J
"}
(8,1,1) = {"
o
a
o
J
J
J
o
o
o
J
J
J
J
"}
(9,1,1) = {"
o
o
o
J
J
o
a
o
J
J
J
J
J
"}
(10,1,1) = {"
o
o
o
J
J
o
o
J
J
J
J
J
J
"}
(11,1,1) = {"
o
o
o
J
o
o
o
J
J
J
j
j
J
"}
(12,1,1) = {"
o
o
j
J
j
j
J
J
J
j
o
o
J
"}
(13,1,1) = {"
J
o
J
J
j
J
J
J
J
J
J
J
J
"}
