//MAP CONVERTED BY dmm2tgm.py THIS HEADER COMMENT PREVENTS RECONVERSION, DO NOT REMOVE
"d" = (
/turf/open/misc/asteroid/forest/mushroom/blue,
/area/template_noop)
"j" = (
/obj/structure/flora/tree/mushroom,
/turf/open/misc/asteroid/forest/mushroom,
/area/template_noop)
"m" = (
/obj/structure/flora/tree/mushroom/blue,
/turf/open/misc/asteroid/forest/mushroom/blue,
/area/template_noop)
"o" = (
/turf/open/misc/asteroid/forest/mushroom,
/area/template_noop)
"s" = (
/obj/structure/flora/tree/mushroom/blue/reverse,
/turf/open/misc/asteroid/forest/mushroom/blue,
/area/template_noop)
"z" = (
/obj/structure/flora/tree/mushroom/green,
/turf/open/misc/asteroid/forest/mushroom/green,
/area/template_noop)
"E" = (
/obj/structure/flora/tree/mushroom/green/reverse,
/turf/open/misc/asteroid/forest/mushroom/green,
/area/template_noop)
"H" = (
/turf/closed/mineral/asteroid,
/area/template_noop)
"L" = (
/turf/open/misc/asteroid/forest/mushroom/green,
/area/template_noop)
"R" = (
/turf/template_noop,
/area/template_noop)
"S" = (
/turf/closed/mineral/gold{
	mineralAmt = 5
	},
/area/template_noop)

(1,1,1) = {"
R
R
R
R
R
R
R
R
R
R
R
R
R
"}
(2,1,1) = {"
R
R
H
H
H
H
H
H
H
R
R
R
R
"}
(3,1,1) = {"
R
H
H
o
j
o
L
L
H
H
R
R
R
"}
(4,1,1) = {"
H
H
o
o
o
L
L
L
L
H
H
R
R
"}
(5,1,1) = {"
H
o
o
o
S
S
L
L
L
E
H
H
R
"}
(6,1,1) = {"
H
o
j
S
S
S
S
L
L
L
L
H
R
"}
(7,1,1) = {"
H
o
o
S
S
S
S
S
S
L
L
H
R
"}
(8,1,1) = {"
H
H
d
d
S
S
S
S
S
L
z
H
R
"}
(9,1,1) = {"
R
H
d
d
d
S
S
S
d
L
L
H
R
"}
(10,1,1) = {"
R
H
H
d
d
d
S
S
d
d
L
H
R
"}
(11,1,1) = {"
R
R
H
H
d
s
d
d
m
d
H
H
R
"}
(12,1,1) = {"
R
R
R
H
H
H
d
d
d
d
H
R
R
"}
(13,1,1) = {"
R
R
R
R
R
H
H
H
H
H
H
R
R
"}
