//MAP CONVERTED BY dmm2tgm.py THIS HEADER COMMENT PREVENTS RECONVERSION, DO NOT REMOVE
"k" = (
/turf/closed/mineral/iron,
/area/template_noop)
"R" = (
/turf/template_noop,
/area/template_noop)

(1,1,1) = {"
R
R
R
R
R
R
R
R
R
R
R
R
R
"}
(2,1,1) = {"
R
R
k
k
k
k
k
k
R
R
R
R
R
"}
(3,1,1) = {"
R
R
k
k
k
k
k
k
k
k
R
R
R
"}
(4,1,1) = {"
R
k
k
k
k
k
k
k
k
k
k
R
R
"}
(5,1,1) = {"
R
k
k
k
k
k
k
k
k
k
k
k
R
"}
(6,1,1) = {"
k
k
k
k
k
k
k
k
k
k
k
k
R
"}
(7,1,1) = {"
k
k
k
k
k
k
k
k
k
k
k
k
R
"}
(8,1,1) = {"
k
k
k
k
k
k
k
k
k
k
k
k
R
"}
(9,1,1) = {"
R
k
k
k
k
k
k
k
k
k
k
k
R
"}
(10,1,1) = {"
R
k
k
k
k
k
k
k
k
k
k
k
R
"}
(11,1,1) = {"
R
R
k
k
k
k
k
k
k
k
k
k
R
"}
(12,1,1) = {"
R
R
R
k
k
k
k
k
k
k
k
R
R
"}
(13,1,1) = {"
R
R
R
R
R
R
R
R
R
R
R
R
R
"}
