//MAP CONVERTED BY dmm2tgm.py THIS HEADER COMMENT PREVENTS RECONVERSION, DO NOT REMOVE
"a" = (
/turf/closed/mineral/plasma,
/area/template_noop)
"M" = (
/turf/open/lava/plasma,
/area/template_noop)
"R" = (
/turf/template_noop,
/area/template_noop)

(1,1,1) = {"
R
a
a
a
a
R
R
R
R
R
R
R
R
"}
(2,1,1) = {"
a
a
a
a
a
a
a
a
a
a
R
R
R
"}
(3,1,1) = {"
a
a
a
a
a
a
a
a
a
a
a
R
R
"}
(4,1,1) = {"
a
a
a
M
a
a
a
M
M
a
a
R
R
"}
(5,1,1) = {"
a
a
a
M
M
a
M
M
a
a
a
a
a
"}
(6,1,1) = {"
a
a
a
a
M
M
M
M
a
a
a
a
a
"}
(7,1,1) = {"
a
a
a
a
a
M
M
M
M
M
a
a
a
"}
(8,1,1) = {"
a
a
a
a
a
M
M
M
a
M
M
a
a
"}
(9,1,1) = {"
R
a
a
M
M
a
M
a
a
a
M
a
a
"}
(10,1,1) = {"
R
a
a
a
M
M
M
M
a
a
a
a
a
"}
(11,1,1) = {"
R
R
a
a
a
a
a
a
a
a
a
a
R
"}
(12,1,1) = {"
R
R
R
R
a
a
a
a
a
a
a
R
R
"}
(13,1,1) = {"
R
R
R
R
R
R
a
a
a
R
R
R
R
"}
