//MAP CONVERTED BY dmm2tgm.py THIS HEADER COMMENT PREVENTS RECONVERSION, DO NOT REMOVE
"a" = (
/turf/closed/mineral/asteroid,
/area/template_noop)
"M" = (
/turf/closed/mineral/silver,
/area/template_noop)
"R" = (
/turf/template_noop,
/area/template_noop)

(1,1,1) = {"
R
R
a
a
a
a
R
R
R
R
R
R
R
"}
(2,1,1) = {"
R
a
a
a
M
a
a
a
R
R
R
R
R
"}
(3,1,1) = {"
R
a
M
a
a
M
M
a
a
R
R
R
R
"}
(4,1,1) = {"
R
a
M
M
a
a
M
a
a
a
a
R
R
"}
(5,1,1) = {"
R
a
a
M
M
a
a
M
a
a
a
a
R
"}
(6,1,1) = {"
R
a
a
a
M
M
M
M
M
M
M
a
a
"}
(7,1,1) = {"
a
a
a
a
a
M
M
a
M
a
M
M
a
"}
(8,1,1) = {"
a
M
M
a
a
a
M
M
M
a
a
M
a
"}
(9,1,1) = {"
a
a
M
M
a
M
M
a
M
M
a
a
a
"}
(10,1,1) = {"
R
a
a
a
M
M
M
a
a
M
M
a
a
"}
(11,1,1) = {"
R
a
a
M
M
a
a
M
a
a
a
a
a
"}
(12,1,1) = {"
R
R
a
M
a
a
a
M
M
a
a
a
R
"}
(13,1,1) = {"
R
R
a
a
a
a
a
a
a
a
R
R
R
"}
