//MAP CONVERTED BY dmm2tgm.py THIS HEADER COMMENT PREVENTS RECONVERSION, DO NOT REMOVE
"R" = (
/turf/template_noop,
/area/template_noop)
"X" = (
/turf/closed/mineral/titanium{
	mineralAmt = 1
	},
/area/template_noop)

(1,1,1) = {"
X
X
R
R
X
X
X
X
X
R
X
X
X
"}
(2,1,1) = {"
X
X
R
R
X
X
X
X
X
R
X
X
X
"}
(3,1,1) = {"
R
R
R
R
X
X
X
X
X
R
X
X
X
"}
(4,1,1) = {"
X
X
X
R
X
X
X
X
X
R
R
R
R
"}
(5,1,1) = {"
X
X
X
R
X
X
X
X
X
R
X
X
R
"}
(6,1,1) = {"
X
X
X
R
X
X
X
X
X
R
X
X
R
"}
(7,1,1) = {"
R
R
R
R
R
R
R
R
R
R
R
R
R
"}
(8,1,1) = {"
X
X
X
X
X
X
R
X
X
X
X
X
X
"}
(9,1,1) = {"
X
X
X
X
X
X
R
X
X
X
X
X
X
"}
(10,1,1) = {"
X
X
X
X
X
X
R
X
X
X
X
X
X
"}
(11,1,1) = {"
X
X
X
X
X
X
R
X
X
X
X
X
X
"}
(12,1,1) = {"
X
X
X
X
X
X
R
X
X
X
X
X
X
"}
(13,1,1) = {"
X
X
X
X
X
X
R
X
X
X
X
X
X
"}
