//MAP CONVERTED BY dmm2tgm.py THIS HEADER COMMENT PREVENTS RECONVERSION, DO NOT REMOVE
"i" = (
/turf/open/misc/asteroid/airless,
/area/template_noop)
"j" = (
/turf/closed/mineral/asteroid,
/area/template_noop)
"o" = (
/turf/closed/mineral/uranium,
/area/template_noop)
"P" = (
/obj/structure/statue/uranium/nuke,
/turf/open/misc/asteroid/airless,
/area/template_noop)
"R" = (
/turf/template_noop,
/area/template_noop)

(1,1,1) = {"
R
R
o
o
j
j
j
j
j
j
o
o
R
"}
(2,1,1) = {"
R
o
o
o
i
i
i
i
i
i
o
o
R
"}
(3,1,1) = {"
o
o
o
o
i
i
i
i
i
o
o
o
o
"}
(4,1,1) = {"
o
i
o
o
o
i
i
i
o
o
o
o
o
"}
(5,1,1) = {"
j
i
i
o
o
o
i
o
o
o
o
o
j
"}
(6,1,1) = {"
j
i
i
i
o
o
i
o
o
i
i
i
j
"}
(7,1,1) = {"
j
i
i
i
i
i
P
i
i
i
i
i
j
"}
(8,1,1) = {"
j
i
i
i
o
o
i
o
i
i
i
i
j
"}
(9,1,1) = {"
j
i
i
o
o
o
i
o
o
o
i
i
o
"}
(10,1,1) = {"
o
o
o
o
o
i
i
o
o
o
o
o
o
"}
(11,1,1) = {"
o
o
o
o
i
i
i
i
o
o
o
o
o
"}
(12,1,1) = {"
R
o
o
o
i
i
i
i
i
o
o
o
o
"}
(13,1,1) = {"
R
R
o
j
j
j
j
j
o
o
o
o
R
"}
