//MAP CONVERTED BY dmm2tgm.py THIS HEADER COMMENT PREVENTS RECONVERSION, DO NOT REMOVE
"q" = (
/turf/closed/mineral/random/low_chance,
/area/template_noop)
"R" = (
/turf/template_noop,
/area/template_noop)

(1,1,1) = {"
R
R
R
R
R
R
R
R
R
R
R
R
R
"}
(2,1,1) = {"
R
R
q
q
q
q
R
R
q
q
q
R
R
"}
(3,1,1) = {"
R
R
q
q
q
q
R
q
q
q
q
R
R
"}
(4,1,1) = {"
R
q
q
q
q
q
R
q
q
q
q
q
R
"}
(5,1,1) = {"
R
q
q
q
q
q
R
q
q
q
q
q
R
"}
(6,1,1) = {"
R
q
q
q
q
R
R
q
q
q
q
q
R
"}
(7,1,1) = {"
R
q
q
q
q
R
R
q
q
q
q
q
R
"}
(8,1,1) = {"
R
q
q
q
R
R
R
R
q
q
q
q
R
"}
(9,1,1) = {"
R
q
q
q
q
R
R
R
q
q
q
q
R
"}
(10,1,1) = {"
R
q
q
q
q
q
q
R
q
q
q
q
R
"}
(11,1,1) = {"
R
R
q
q
q
q
q
R
R
q
q
q
R
"}
(12,1,1) = {"
R
R
R
q
q
q
R
R
R
R
q
q
R
"}
(13,1,1) = {"
R
R
R
R
R
R
R
R
R
R
R
R
R
"}
