//MAP CONVERTED BY dmm2tgm.py THIS HEADER COMMENT PREVENTS RECONVERSION, DO NOT REMOVE
"D" = (
/turf/open/misc/asteroid/airless,
/area/template_noop)
"P" = (
/turf/closed/mineral/random/high_chance,
/area/template_noop)
"R" = (
/turf/template_noop,
/area/template_noop)

(1,1,1) = {"
R
P
P
P
R
R
R
P
P
R
R
R
R
"}
(2,1,1) = {"
P
P
P
P
P
D
P
P
P
P
P
R
R
"}
(3,1,1) = {"
P
P
P
P
P
D
D
P
P
P
P
P
R
"}
(4,1,1) = {"
D
P
P
P
P
P
D
D
P
P
P
P
R
"}
(5,1,1) = {"
D
P
P
P
P
P
P
D
P
P
P
P
P
"}
(6,1,1) = {"
D
P
P
P
P
P
P
D
P
P
P
P
P
"}
(7,1,1) = {"
D
D
P
P
P
P
P
D
D
P
P
P
P
"}
(8,1,1) = {"
P
D
D
D
P
P
D
D
D
P
P
P
P
"}
(9,1,1) = {"
P
P
P
D
D
D
D
D
D
P
P
P
P
"}
(10,1,1) = {"
P
P
P
P
D
D
D
D
D
P
P
P
R
"}
(11,1,1) = {"
P
P
P
P
P
P
D
D
D
P
P
P
R
"}
(12,1,1) = {"
R
P
P
P
P
P
P
D
D
P
P
R
R
"}
(13,1,1) = {"
R
R
R
R
R
R
R
R
R
R
R
R
R
"}
