//MAP CONVERTED BY dmm2tgm.py THIS HEADER COMMENT PREVENTS RECONVERSION, DO NOT REMOVE
"f" = (
/turf/closed/mineral/random/high_chance,
/area/template_noop)
"q" = (
/turf/closed/mineral/random,
/area/template_noop)
"R" = (
/turf/template_noop,
/area/template_noop)

(1,1,1) = {"
R
R
R
R
R
R
R
R
R
R
R
R
R
"}
(2,1,1) = {"
R
R
q
q
q
R
R
R
R
R
q
q
R
"}
(3,1,1) = {"
R
q
q
f
q
q
R
R
R
R
f
f
R
"}
(4,1,1) = {"
q
q
f
f
q
q
R
R
R
q
f
f
R
"}
(5,1,1) = {"
q
q
q
q
q
R
R
R
q
f
f
q
R
"}
(6,1,1) = {"
R
R
q
q
R
R
q
R
q
f
f
q
R
"}
(7,1,1) = {"
R
R
R
R
R
q
f
R
q
f
f
q
R
"}
(8,1,1) = {"
q
q
q
R
R
q
q
R
q
q
f
q
R
"}
(9,1,1) = {"
q
f
f
q
R
R
R
R
R
q
q
R
R
"}
(10,1,1) = {"
q
q
f
f
q
R
R
R
R
R
R
R
R
"}
(11,1,1) = {"
R
q
f
f
f
q
R
q
f
f
q
R
R
"}
(12,1,1) = {"
R
q
q
q
q
q
R
R
q
q
q
q
R
"}
(13,1,1) = {"
R
R
R
R
q
R
R
R
R
R
R
R
R
"}
