//MAP CONVERTED BY dmm2tgm.py THIS HEADER COMMENT PREVENTS RECONVERSION, DO NOT REMOVE
"a" = (
/turf/closed/mineral/volcanic/lava_land_surface,
/area/lavaland/surface/outdoors)
"b" = (
/obj/structure/meateor_fluff/eyeball,
/obj/effect/gibspawner/human/bodypartless,
/obj/item/food/meat/slab/meatproduct,
/turf/open/indestructible/meat{
	initial_gas_mix = "LAVALAND_ATMOS"
	},
/area/ruin/powered)
"c" = (
/obj/structure/stone_tile/surrounding_tile/burnt{
	dir = 1
	},
/obj/effect/gibspawner/human/bodypartless,
/turf/open/misc/asteroid/basalt/lava_land_surface,
/area/lavaland/surface/outdoors)
"d" = (
/obj/structure/stone_tile/slab/cracked,
/turf/closed/mineral/volcanic/lava_land_surface,
/area/lavaland/surface/outdoors)
"e" = (
/obj/structure/stone_tile/block,
/obj/effect/gibspawner/human/bodypartless,
/turf/open/misc/asteroid/basalt/lava_land_surface,
/area/lavaland/surface/outdoors)
"f" = (
/obj/structure/statue/bone/rib{
	dir = 1;
	pixel_y = 10
	},
/turf/closed/indestructible/meat,
/area/lavaland/surface/outdoors)
"g" = (
/obj/structure/stone_tile/slab/cracked,
/obj/item/flashlight/flare/torch,
/turf/closed/mineral/volcanic/lava_land_surface,
/area/lavaland/surface/outdoors)
"h" = (
/obj/structure/stone_tile/slab/cracked{
	dir = 6
	},
/turf/closed/mineral/volcanic/lava_land_surface,
/area/lavaland/surface/outdoors)
"i" = (
/obj/structure/stone_tile/surrounding_tile/burnt{
	dir = 1
	},
/turf/open/chasm/lavaland,
/area/lavaland/surface/outdoors)
"j" = (
/obj/structure/meateor_fluff/flesh_pod,
/turf/open/indestructible/meat{
	initial_gas_mix = "LAVALAND_ATMOS"
	},
/area/ruin/powered)
"l" = (
/obj/structure/flora/ash/tall_shroom,
/turf/closed/mineral/volcanic/lava_land_surface,
/area/lavaland/surface/outdoors)
"m" = (
/mob/living/basic/mining/hivelord,
/turf/closed/mineral/volcanic/lava_land_surface,
/area/lavaland/surface/outdoors)
"n" = (
/turf/open/chasm/lavaland,
/area/lavaland/surface/outdoors)
"o" = (
/obj/structure/stone_tile/burnt,
/obj/structure/stone_tile{
	dir = 4
	},
/obj/effect/gibspawner/human/bodypartless,
/turf/open/misc/asteroid/basalt/lava_land_surface,
/area/lavaland/surface/outdoors)
"p" = (
/obj/structure/stone_tile/surrounding_tile/cracked,
/turf/closed/mineral/volcanic/lava_land_surface,
/area/lavaland/surface/outdoors)
"q" = (
/obj/structure/punji_sticks/spikes,
/turf/closed/mineral/volcanic/lava_land_surface,
/area/lavaland/surface/outdoors)
"r" = (
/obj/structure/statue/bone/rib{
	dir = 8
	},
/turf/closed/indestructible/meat,
/area/lavaland/surface/outdoors)
"s" = (
/obj/structure/flora/ash/fireblossom,
/turf/open/misc/asteroid/basalt/lava_land_surface,
/area/lavaland/surface/outdoors)
"t" = (
/obj/structure/stone_tile/block/cracked,
/obj/effect/gibspawner/human/bodypartless,
/mob/living/basic/mining/hivelord,
/turf/open/misc/asteroid/basalt/lava_land_surface,
/area/lavaland/surface/outdoors)
"u" = (
/obj/structure/stone_tile/block/cracked{
	dir = 1
	},
/turf/closed/mineral/volcanic/lava_land_surface,
/area/lavaland/surface/outdoors)
"v" = (
/obj/structure/stone_tile,
/obj/structure/stone_tile{
	dir = 8
	},
/turf/closed/mineral/volcanic/lava_land_surface,
/area/lavaland/surface/outdoors)
"w" = (
/obj/structure/stone_tile/block,
/turf/closed/mineral/volcanic/lava_land_surface,
/area/lavaland/surface/outdoors)
"x" = (
/mob/living/basic/mining/hivelord/no_wander,
/turf/open/misc/asteroid/basalt/lava_land_surface,
/area/lavaland/surface/outdoors)
"y" = (
/obj/effect/mapping_helpers/bombable_wall,
/turf/closed/indestructible/riveted/boss/wasteland{
	base_icon_state = "meat_wall";
	icon = 'icons/turf/walls/meat_wall.dmi';
	icon_state = "meat_wall-0"
	},
/area/lavaland/surface/outdoors)
"z" = (
/obj/structure/stone_tile/slab/burnt,
/turf/closed/mineral/volcanic/lava_land_surface,
/area/lavaland/surface/outdoors)
"A" = (
/obj/structure/statue/bone/rib{
	pixel_y = 10
	},
/turf/closed/indestructible/meat,
/area/lavaland/surface/outdoors)
"B" = (
/obj/structure/stone_tile{
	dir = 8
	},
/obj/structure/stone_tile{
	dir = 1
	},
/turf/open/chasm/lavaland,
/area/lavaland/surface/outdoors)
"C" = (
/obj/structure/stone_tile/cracked{
	dir = 4
	},
/turf/closed/mineral/volcanic/lava_land_surface,
/area/lavaland/surface/outdoors)
"E" = (
/obj/structure/stone_tile/surrounding_tile/cracked{
	dir = 8
	},
/turf/closed/mineral/volcanic/lava_land_surface,
/area/lavaland/surface/outdoors)
"F" = (
/obj/structure/stone_tile{
	dir = 8
	},
/obj/structure/stone_tile{
	dir = 1
	},
/turf/closed/mineral/volcanic/lava_land_surface,
/area/lavaland/surface/outdoors)
"G" = (
/obj/effect/gibspawner/human/bodypartless,
/turf/open/misc/asteroid/basalt/lava_land_surface,
/area/lavaland/surface/outdoors)
"H" = (
/obj/structure/meateor_fluff/eyeball,
/obj/effect/gibspawner/human,
/turf/open/indestructible/meat{
	initial_gas_mix = "LAVALAND_ATMOS"
	},
/area/ruin/powered)
"J" = (
/obj/structure/flora/ash/seraka,
/turf/closed/mineral/volcanic/lava_land_surface,
/area/lavaland/surface/outdoors)
"K" = (
/obj/item/food/meat/slab/meatwheat,
/turf/closed/indestructible/meat,
/area/lavaland/surface/outdoors)
"L" = (
/obj/structure/flora/rock/pile/style_random,
/mob/living/basic/mining/hivelord,
/turf/closed/mineral/volcanic/lava_land_surface,
/area/lavaland/surface/outdoors)
"M" = (
/turf/template_noop,
/area/template_noop)
"N" = (
/obj/effect/gibspawner/generic,
/obj/item/food/meat/slab/meatproduct,
/turf/open/indestructible/meat{
	initial_gas_mix = "LAVALAND_ATMOS"
	},
/area/ruin/powered)
"O" = (
/obj/structure/stone_tile/surrounding/cracked{
	dir = 6
	},
/obj/effect/gibspawner/human/bodypartless,
/turf/open/misc/asteroid/basalt/lava_land_surface,
/area/lavaland/surface/outdoors)
"P" = (
/obj/structure/punji_sticks/spikes,
/turf/open/misc/asteroid/basalt/lava_land_surface,
/area/lavaland/surface/outdoors)
"Q" = (
/obj/structure/stone_tile/burnt,
/obj/structure/stone_tile/burnt{
	dir = 1
	},
/obj/structure/stone_tile/cracked{
	dir = 4
	},
/mob/living/basic/mining/hivelord,
/turf/open/misc/asteroid/basalt/lava_land_surface,
/area/lavaland/surface/outdoors)
"R" = (
/obj/structure/flora/rock/pile/style_random,
/turf/closed/mineral/volcanic/lava_land_surface,
/area/lavaland/surface/outdoors)
"S" = (
/obj/structure/stone_tile/surrounding_tile/burnt{
	dir = 8
	},
/turf/open/chasm/lavaland,
/area/lavaland/surface/outdoors)
"T" = (
/obj/structure/flora/rock/style_random,
/turf/closed/mineral/volcanic/lava_land_surface,
/area/lavaland/surface/outdoors)
"U" = (
/obj/structure/stone_tile/block/cracked{
	dir = 1
	},
/mob/living/basic/mining/hivelord/no_wander,
/turf/open/misc/asteroid/basalt/lava_land_surface,
/area/lavaland/surface/outdoors)
"V" = (
/turf/closed/indestructible/meat,
/area/lavaland/surface/outdoors)
"W" = (
/obj/structure/stone_tile/block{
	dir = 8
	},
/obj/structure/stone_tile/block/burnt{
	dir = 4
	},
/turf/closed/mineral/volcanic/lava_land_surface,
/area/lavaland/surface/outdoors)
"X" = (
/obj/item/food/meat/slab/meatproduct,
/turf/open/indestructible/meat{
	initial_gas_mix = "LAVALAND_ATMOS"
	},
/area/ruin/powered)
"Y" = (
/mob/living/basic/mining/hivelord,
/obj/effect/gibspawner/human/bodypartless,
/turf/open/misc/asteroid/basalt/lava_land_surface,
/area/lavaland/surface/outdoors)
"Z" = (
/obj/item/antag_granter/changeling,
/mob/living/basic/meteor_heart,
/obj/item/food/meat/slab/meatproduct,
/turf/open/indestructible/meat{
	initial_gas_mix = "LAVALAND_ATMOS"
	},
/area/ruin/powered)

(1,1,1) = {"
M
M
M
M
a
T
n
a
a
M
M
M
"}
(2,1,1) = {"
M
n
T
e
m
G
i
Y
R
a
M
M
"}
(3,1,1) = {"
M
n
n
n
n
n
n
n
G
n
n
M
"}
(4,1,1) = {"
p
L
n
n
f
V
r
n
n
n
l
a
"}
(5,1,1) = {"
q
n
n
f
K
j
V
r
n
x
M
a
"}
(6,1,1) = {"
z
n
f
K
H
X
N
y
n
t
w
a
"}
(7,1,1) = {"
d
n
V
j
Z
b
K
A
n
U
u
a
"}
(8,1,1) = {"
L
n
A
V
j
K
A
n
n
n
a
a
"}
(9,1,1) = {"
G
n
n
A
V
A
n
n
M
n
W
M
"}
(10,1,1) = {"
E
s
n
n
n
n
n
B
o
C
g
M
"}
(11,1,1) = {"
M
S
n
P
c
Q
O
n
h
v
F
M
"}
(12,1,1) = {"
M
M
a
a
J
M
a
a
a
a
M
M
"}
