//MAP CONVERTED BY dmm2tgm.py THIS HEADER COMMENT PREVENTS RECONVERSION, DO NOT REMOVE
"a" = (
/turf/open/lava/smooth/lava_land_surface,
/area/ruin/unpowered)
"b" = (
/turf/closed/indestructible/riveted/boss,
/area/lavaland/surface/outdoors)
"c" = (
/turf/closed/mineral/strong{
	base_icon_state = "smoothrocks";
	icon = 'modular_nova/modules/liquids/icons/turf/smoothrocks.dmi';
	icon_state = "smoothrocks-55"
	},
/area/ruin/unpowered)
"g" = (
/obj/structure/stone_tile/block/cracked,
/turf/closed/mineral/volcanic/lava_land_surface,
/area/lavaland/surface/outdoors)
"i" = (
/turf/closed/indestructible/riveted/boss,
/area/ruin/unpowered)
"k" = (
/obj/structure/flora/rock/pile/style_random,
/mob/living/basic/mining/brimdemon,
/turf/closed/mineral/volcanic/lava_land_surface,
/area/ruin/unpowered)
"m" = (
/obj/structure/flora/rock/pile/style_random,
/turf/closed/mineral/strong{
	base_icon_state = "smoothrocks";
	icon = 'modular_nova/modules/liquids/icons/turf/smoothrocks.dmi';
	icon_state = "smoothrocks-55"
	},
/area/lavaland/surface/outdoors)
"n" = (
/turf/closed/mineral/strong{
	base_icon_state = "smoothrocks";
	icon = 'modular_nova/modules/liquids/icons/turf/smoothrocks.dmi';
	icon_state = "smoothrocks-55"
	},
/area/lavaland/surface/outdoors)
"o" = (
/obj/structure/stone_tile/slab/cracked{
	dir = 4
	},
/turf/closed/mineral/strong{
	base_icon_state = "smoothrocks";
	icon = 'modular_nova/modules/liquids/icons/turf/smoothrocks.dmi';
	icon_state = "smoothrocks-55"
	},
/area/ruin/unpowered)
"q" = (
/turf/closed/mineral/volcanic/lava_land_surface,
/area/lavaland/surface/outdoors)
"r" = (
/turf/open/chasm/lavaland,
/area/ruin/unpowered)
"s" = (
/obj/structure/stone_tile/surrounding/cracked{
	dir = 8
	},
/turf/closed/mineral/strong{
	base_icon_state = "smoothrocks";
	icon = 'modular_nova/modules/liquids/icons/turf/smoothrocks.dmi';
	icon_state = "smoothrocks-55"
	},
/area/ruin/unpowered)
"t" = (
/obj/structure/stone_tile/block/cracked{
	dir = 1
	},
/turf/open/lava/smooth/lava_land_surface,
/area/lavaland/surface/outdoors)
"u" = (
/obj/structure/stone_tile/block/burnt,
/obj/structure/stone_tile/burnt{
	dir = 4
	},
/turf/open/lava/smooth/lava_land_surface,
/area/lavaland/surface/outdoors)
"w" = (
/obj/structure/flora/rock/style_random,
/turf/closed/mineral/volcanic/lava_land_surface,
/area/ruin/unpowered)
"x" = (
/turf/open/chasm/lavaland,
/area/lavaland/surface/outdoors)
"y" = (
/obj/structure/stone_tile/block/burnt{
	dir = 8
	},
/turf/open/lava/smooth/lava_land_surface,
/area/lavaland/surface/outdoors)
"B" = (
/obj/structure/punji_sticks/spikes,
/turf/closed/mineral/volcanic/lava_land_surface,
/area/lavaland/surface/outdoors)
"C" = (
/obj/structure/stone_tile/surrounding_tile/cracked{
	dir = 1
	},
/turf/open/lava/smooth/lava_land_surface,
/area/lavaland/surface/outdoors)
"E" = (
/obj/structure/stone_tile/burnt{
	dir = 4
	},
/obj/structure/stone_tile/cracked{
	dir = 1
	},
/turf/open/lava/smooth/lava_land_surface,
/area/lavaland/surface/outdoors)
"F" = (
/obj/structure/ore_vent/random{
	ore_vent_options = list("large" = 15, "medium" = 0, "small" = 0);
	name = "Large ore vent"
	},
/turf/closed/mineral/volcanic/lava_land_surface,
/area/ruin/unpowered)
"G" = (
/turf/template_noop,
/area/template_noop)
"I" = (
/obj/structure/stone_tile/block/cracked{
	dir = 4
	},
/turf/open/lava/smooth/lava_land_surface,
/area/lavaland/surface/outdoors)
"K" = (
/turf/open/lava/smooth/lava_land_surface,
/area/lavaland/surface/outdoors)
"L" = (
/obj/effect/mapping_helpers/bombable_wall,
/turf/closed/indestructible/riveted/boss/wasteland,
/area/ruin/unpowered)
"N" = (
/obj/structure/stone_tile{
	dir = 1
	},
/obj/structure/stone_tile/cracked,
/obj/structure/stone_tile/burnt{
	dir = 4
	},
/turf/closed/mineral/volcanic/lava_land_surface,
/area/lavaland/surface/outdoors)
"O" = (
/obj/effect/mapping_helpers/bombable_wall,
/turf/closed/indestructible/riveted/boss/wasteland,
/area/lavaland/surface/outdoors)
"Q" = (
/obj/structure/stone_tile/slab/cracked,
/turf/open/misc/asteroid/basalt/lava_land_surface,
/area/ruin/unpowered)
"R" = (
/obj/structure/stone_tile/surrounding/cracked{
	dir = 4
	},
/mob/living/basic/mining/brimdemon,
/turf/closed/mineral/strong{
	base_icon_state = "smoothrocks";
	icon = 'modular_nova/modules/liquids/icons/turf/smoothrocks.dmi';
	icon_state = "smoothrocks-55"
	},
/area/ruin/unpowered)
"S" = (
/obj/structure/stone_tile/surrounding_tile/burnt{
	dir = 4
	},
/turf/open/lava/smooth/lava_land_surface,
/area/lavaland/surface/outdoors)
"V" = (
/obj/structure/punji_sticks/spikes,
/turf/closed/mineral/strong{
	base_icon_state = "smoothrocks";
	icon = 'modular_nova/modules/liquids/icons/turf/smoothrocks.dmi';
	icon_state = "smoothrocks-55"
	},
/area/lavaland/surface/outdoors)
"X" = (
/obj/structure/stone_tile/surrounding/cracked{
	dir = 6
	},
/obj/structure/stone_tile/center/cracked,
/turf/closed/mineral/strong{
	base_icon_state = "smoothrocks";
	icon = 'modular_nova/modules/liquids/icons/turf/smoothrocks.dmi';
	icon_state = "smoothrocks-55"
	},
/area/ruin/unpowered)
"Z" = (
/obj/structure/flora/rock/pile/style_random,
/turf/closed/mineral/volcanic/lava_land_surface,
/area/lavaland/surface/outdoors)

(1,1,1) = {"
G
G
G
b
B
q
Z
G
G
K
G
G
"}
(2,1,1) = {"
G
q
b
b
m
n
K
t
b
u
C
b
"}
(3,1,1) = {"
Z
q
b
b
O
b
O
b
b
b
K
b
"}
(4,1,1) = {"
q
b
b
c
r
i
a
a
a
O
K
Z
"}
(5,1,1) = {"
b
b
X
r
r
R
a
i
r
b
x
B
"}
(6,1,1) = {"
x
O
r
r
w
F
L
i
i
b
x
G
"}
(7,1,1) = {"
x
b
s
a
L
k
a
i
Q
b
x
G
"}
(8,1,1) = {"
G
b
c
a
i
o
a
a
r
b
g
G
"}
(9,1,1) = {"
Z
b
b
a
i
r
r
r
r
b
b
G
"}
(10,1,1) = {"
q
N
b
O
b
b
b
b
O
b
S
y
"}
(11,1,1) = {"
G
G
V
m
n
x
x
x
I
K
E
b
"}
(12,1,1) = {"
G
G
G
G
q
q
Z
q
K
G
G
G
"}
