//MAP CONVERTED BY dmm2tgm.py THIS HEADER COMMENT PREVENTS RECONVERSION, DO NOT REMOVE
"a" = (
/turf/template_noop,
/area/template_noop)
"h" = (
/obj/item/stack/sheet/mineral/coal/ten{
	pixel_y = -12
	},
/obj/structure/railroad,
/obj/item/stack/ore/glass,
/turf/open/misc/asteroid/basalt/lava_land_surface,
/area/ruin/unpowered)
"i" = (
/obj/effect/mapping_helpers/bombable_wall,
/turf/closed/indestructible/riveted/boss/wasteland,
/area/lavaland/surface/outdoors)
"k" = (
/turf/closed/indestructible/riveted/boss,
/area/lavaland/surface/outdoors)
"n" = (
/turf/closed/indestructible/riveted/boss,
/area/ruin/unpowered)
"t" = (
/obj/structure/deployable_barricade/guardrail,
/turf/open/misc/asteroid/basalt/lava_land_surface,
/area/ruin/unpowered)
"x" = (
/obj/effect/mapping_helpers/bombable_wall,
/turf/closed/indestructible/riveted/boss/wasteland,
/area/ruin/unpowered)
"A" = (
/obj/item/stack/sheet/mineral/coal/ten{
	pixel_y = -12
	},
/obj/item/stack/sheet/mineral/coal/ten{
	pixel_y = -12
	},
/turf/open/misc/asteroid/basalt/lava_land_surface,
/area/ruin/unpowered)
"B" = (
/obj/item/stack/sheet/mineral/coal/ten,
/turf/closed/mineral/random/high_chance/volcanic,
/area/ruin/unpowered)
"F" = (
/obj/item/stack/sheet/mineral/coal/ten{
	pixel_y = -12
	},
/turf/closed/mineral/random/high_chance/volcanic,
/area/lavaland/surface/outdoors)
"H" = (
/turf/closed/mineral/random/high_chance/volcanic,
/area/ruin/unpowered)
"L" = (
/obj/structure/closet/crate/miningcar,
/obj/item/stack/ore/titanium,
/turf/open/misc/asteroid/basalt/lava_land_surface,
/area/ruin/unpowered)
"O" = (
/obj/structure/closet/crate/miningcar,
/obj/item/stack/ore/gold,
/turf/open/misc/asteroid/basalt/lava_land_surface,
/area/ruin/unpowered)
"S" = (
/obj/item/shovel,
/obj/item/stack/sheet/mineral/coal/ten{
	pixel_y = -12
	},
/turf/closed/mineral/random/high_chance/volcanic,
/area/ruin/unpowered)
"U" = (
/obj/structure/closet/crate/miningcar,
/obj/item/stack/sheet/mineral/coal/ten{
	pixel_y = -12
	},
/obj/item/stack/ore/gold,
/turf/open/misc/asteroid/basalt/lava_land_surface,
/area/ruin/unpowered)
"V" = (
/obj/structure/closet/crate/miningcar,
/obj/item/stack/ore/iron,
/turf/open/misc/asteroid/basalt/lava_land_surface,
/area/ruin/unpowered)
"X" = (
/obj/structure/closet/crate/miningcar,
/obj/item/stack/sheet/mineral/coal/ten{
	pixel_y = -12
	},
/obj/item/stack/ore/diamond,
/turf/open/misc/asteroid/basalt/lava_land_surface,
/area/ruin/unpowered)

(1,1,1) = {"
a
a
k
"}
(2,1,1) = {"
n
a
i
"}
(3,1,1) = {"
A
L
a
"}
(4,1,1) = {"
a
U
a
"}
(5,1,1) = {"
a
V
B
"}
(6,1,1) = {"
S
X
H
"}
(7,1,1) = {"
H
h
H
"}
(8,1,1) = {"
H
O
n
"}
(9,1,1) = {"
t
V
a
"}
(10,1,1) = {"
n
H
a
"}
(11,1,1) = {"
x
F
a
"}
(12,1,1) = {"
a
a
k
"}
