//MAP CONVERTED BY dmm2tgm.py THIS HEADER COMMENT PREVENTS RECONVERSION, DO NOT REMOVE
"am" = (
/obj/structure/stone_tile/block/cracked{
	dir = 8
	},
/turf/open/misc/asteroid/basalt/lava_land_surface,
/area/ruin/unpowered)
"aM" = (
/obj/structure/alien/weeds,
/obj/effect/decal/cleanable/blood/gibs{
	icon_state = "u_madman_l"
	},
/obj/effect/decal/cleanable/blood/gibs{
	icon_state = "gibhead";
	dir = 4;
	pixel_y = 6;
	pixel_x = 3
	},
/turf/open/misc/asteroid/basalt/lava_land_surface,
/area/ruin/unpowered/xenonest)
"bj" = (
/obj/structure/stone_tile/slab,
/obj/effect/decal/cleanable/blood{
	icon_state = "floor7-old"
	},
/turf/closed/mineral/random/high_chance/volcanic,
/area/ruin/unpowered)
"bR" = (
/obj/structure/stone_tile/slab/cracked,
/turf/open/lava/smooth/lava_land_surface{
	slowdown = 0
	},
/area/ruin/unpowered)
"bW" = (
/obj/structure/stone_tile/slab,
/turf/closed/mineral/random/high_chance/volcanic,
/area/lavaland/surface/outdoors)
"cf" = (
/obj/structure/alien/weeds,
/obj/structure/alien/weeds,
/obj/effect/decal/cleanable/blood{
	icon_state = "floor7-old"
	},
/turf/open/misc/asteroid/basalt/lava_land_surface,
/area/ruin/unpowered/xenonest)
"cl" = (
/obj/structure/stone_tile/block,
/obj/structure/stone_tile/block{
	dir = 1
	},
/obj/structure/closet/crate/necropolis{
	name = "\improper Ancient Sarcophagus";
	anchored = 1;
	base_icon_state = "necro_bubblegum";
	icon_state = "necro_bubblegum";
	lid_icon_state = "necro_bubblegum_lid";
	desc = "Tools of gods."
	},
/obj/item/gun/energy/recharge/resonant_system{
	desc = "Gods came from the sky and built their temples. Probably with help of this...";
	name = "Unknown ancient tool"
	},
/turf/closed/mineral/random/high_chance/volcanic,
/area/ruin/unpowered)
"db" = (
/turf/closed/mineral/volcanic/lava_land_surface,
/area/ruin/unpowered)
"dr" = (
/obj/structure/alien/weeds,
/obj/structure/alien/weeds,
/turf/open/misc/asteroid/basalt/lava_land_surface,
/area/ruin/unpowered/xenonest)
"dE" = (
/obj/structure/alien/weeds,
/obj/effect/decal/cleanable/blood,
/turf/open/misc/asteroid/basalt/lava_land_surface,
/area/ruin/unpowered/xenonest)
"ep" = (
/obj/structure/stone_tile/slab/burnt,
/obj/item/nullrod/tribal_knife,
/turf/closed/mineral/random/high_chance/volcanic,
/area/ruin/unpowered)
"ez" = (
/obj/structure/stone_tile/block/cracked{
	dir = 8
	},
/obj/structure/stone_tile/cracked,
/obj/structure/stone_tile/cracked{
	dir = 1
	},
/turf/open/lava/smooth/lava_land_surface{
	slowdown = 0
	},
/area/ruin/unpowered)
"eW" = (
/obj/structure/alien/weeds/node,
/mob/living/basic/alien,
/turf/open/misc/asteroid/basalt/lava_land_surface,
/area/ruin/unpowered/xenonest)
"hF" = (
/obj/structure/alien/weeds,
/obj/effect/decal/cleanable/blood{
	icon_state = "floor5-old"
	},
/turf/open/misc/asteroid/basalt/lava_land_surface,
/area/ruin/unpowered/xenonest)
"iR" = (
/obj/structure/bed/nest,
/obj/structure/alien/weeds,
/obj/effect/spawner/random/exotic/antag_gear,
/obj/effect/mob_spawn/corpse/human/syndicatecommando,
/obj/effect/decal/cleanable/blood{
	icon_state = "floor7-old"
	},
/obj/structure/marker_beacon/burgundy,
/turf/open/misc/asteroid/basalt/lava_land_surface,
/area/ruin/unpowered/xenonest)
"iW" = (
/obj/structure/stone_tile/block,
/obj/structure/stone_tile/block{
	dir = 1
	},
/turf/closed/mineral/random/high_chance/volcanic,
/area/ruin/unpowered)
"jc" = (
/turf/closed/mineral/random/high_chance/volcanic,
/area/lavaland/surface/outdoors)
"jz" = (
/obj/structure/stone_tile/surrounding_tile{
	dir = 4
	},
/obj/structure/stone_tile/surrounding_tile,
/obj/item/clothing/under/costume/gladiator/ash_walker/tribal,
/turf/closed/mineral/random/high_chance/volcanic,
/area/ruin/unpowered)
"jJ" = (
/obj/structure/alien/weeds,
/obj/effect/decal/cleanable/blood,
/obj/item/clothing/mask/facehugger/impregnated,
/turf/open/misc/asteroid/basalt/lava_land_surface,
/area/ruin/unpowered/xenonest)
"jT" = (
/obj/structure/alien/weeds,
/obj/item/flashlight/flare/torch,
/turf/open/misc/asteroid/basalt/lava_land_surface,
/area/ruin/unpowered/xenonest)
"kz" = (
/obj/effect/decal/cleanable/blood/tracks{
	desc = "Your instincts say you shouldn't be following these.";
	dir = 8;
	icon_state = "ltrails_1"
	},
/obj/structure/stone_tile/block/cracked{
	dir = 4
	},
/turf/open/misc/asteroid/basalt/lava_land_surface,
/area/ruin/unpowered)
"kI" = (
/obj/structure/alien/weeds,
/obj/structure/bed/nest,
/obj/effect/decal/cleanable/blood/gibs,
/obj/effect/decal/cleanable/blood,
/obj/item/clothing/under/syndicate,
/obj/item/clothing/glasses/night,
/turf/open/misc/asteroid/basalt/lava_land_surface,
/area/ruin/unpowered/xenonest)
"li" = (
/obj/structure/alien/weeds/node,
/obj/structure/alien/weeds,
/turf/open/misc/asteroid/basalt/lava_land_surface,
/area/ruin/unpowered/xenonest)
"ly" = (
/obj/structure/alien/weeds,
/turf/open/misc/asteroid/basalt/lava_land_surface,
/area/ruin/unpowered/xenonest)
"lM" = (
/obj/effect/mapping_helpers/bombable_wall,
/turf/closed/indestructible/riveted/boss/wasteland,
/area/lavaland/surface/outdoors)
"lQ" = (
/obj/structure/alien/resin/wall,
/obj/structure/alien/weeds,
/obj/effect/decal/cleanable/blood/tracks{
	dir = 8
	},
/obj/effect/spawner/random/medical/two_percent_xeno_egg_spawner,
/turf/open/misc/asteroid/basalt/lava_land_surface,
/area/ruin/unpowered/xenonest)
"mu" = (
/mob/living/basic/alien/queen/large,
/obj/structure/alien/weeds,
/obj/structure/alien/egg/burst,
/turf/open/misc/asteroid/basalt/lava_land_surface,
/area/ruin/unpowered/xenonest)
"mS" = (
/obj/structure/alien/weeds,
/mob/living/basic/alien,
/turf/open/misc/asteroid/basalt/lava_land_surface,
/area/ruin/unpowered/xenonest)
"nL" = (
/obj/structure/stone_tile/slab/cracked{
	dir = 4
	},
/turf/closed/mineral/volcanic/lava_land_surface,
/area/ruin/unpowered)
"nM" = (
/obj/structure/alien/weeds,
/obj/structure/alien/weeds,
/mob/living/basic/alien,
/turf/open/misc/asteroid/basalt/lava_land_surface,
/area/ruin/unpowered/xenonest)
"oL" = (
/obj/structure/stone_tile/cracked,
/obj/effect/spawner/random/engineering/flashlight,
/turf/open/misc/asteroid/basalt/lava_land_surface,
/area/ruin/unpowered)
"pN" = (
/obj/structure/alien/resin/wall,
/obj/structure/alien/weeds,
/obj/structure/alien/weeds,
/obj/effect/mob_spawn/corpse/human/damaged,
/turf/open/misc/asteroid/basalt/lava_land_surface,
/area/ruin/unpowered/xenonest)
"pU" = (
/obj/structure/alien/weeds,
/obj/effect/gibspawner/human/bodypartless,
/obj/effect/spawner/random/food_or_drink/snack/lizard,
/turf/open/misc/asteroid/basalt/lava_land_surface,
/area/ruin/unpowered/xenonest)
"qd" = (
/obj/structure/alien/resin/wall,
/obj/effect/mob_spawn/corpse/human/damaged,
/turf/open/misc/asteroid/basalt/lava_land_surface,
/area/ruin/unpowered/xenonest)
"rp" = (
/turf/template_noop,
/area/template_noop)
"sR" = (
/obj/structure/alien/weeds/node,
/obj/structure/alien/weeds,
/mob/living/basic/alien,
/turf/open/misc/asteroid/basalt/lava_land_surface,
/area/ruin/unpowered/xenonest)
"tq" = (
/obj/structure/stone_tile/block/cracked{
	dir = 4
	},
/obj/structure/stone_tile/block{
	dir = 8
	},
/turf/open/lava/smooth/lava_land_surface{
	slowdown = 0
	},
/area/ruin/unpowered)
"tA" = (
/obj/structure/fluff/drake_statue/falling,
/turf/open/misc/asteroid/basalt/lava_land_surface,
/area/ruin/unpowered)
"tO" = (
/obj/structure/stone_tile/surrounding_tile{
	dir = 1
	},
/obj/structure/stone_tile/surrounding_tile{
	dir = 8
	},
/turf/closed/mineral/random/high_chance/volcanic,
/area/ruin/unpowered)
"ud" = (
/obj/structure/stone_tile/slab/cracked{
	dir = 4
	},
/obj/structure/stone_tile/slab/cracked{
	dir = 8
	},
/turf/open/lava/smooth/lava_land_surface{
	slowdown = 0
	},
/area/ruin/unpowered)
"uy" = (
/obj/structure/stone_tile/block/cracked,
/obj/structure/stone_tile/block/burnt{
	dir = 1
	},
/turf/open/lava/smooth/lava_land_surface{
	slowdown = 0
	},
/area/ruin/unpowered)
"va" = (
/obj/structure/bed/nest,
/obj/structure/alien/weeds,
/obj/item/gun/ballistic/automatic/pistol,
/obj/item/clothing/under/syndicate,
/obj/structure/marker_beacon/burgundy,
/turf/open/misc/asteroid/basalt/lava_land_surface,
/area/ruin/unpowered/xenonest)
"vn" = (
/obj/structure/stone_tile/block,
/obj/structure/stone_tile/block{
	dir = 1
	},
/turf/closed/mineral/volcanic/lava_land_surface,
/area/ruin/unpowered)
"vG" = (
/turf/closed/indestructible/riveted/boss,
/area/ruin/unpowered)
"we" = (
/obj/structure/stone_tile/slab/cracked,
/turf/closed/mineral/random/high_chance/volcanic,
/area/ruin/unpowered)
"wq" = (
/obj/structure/alien/weeds,
/obj/effect/spawner/random/junk_shell,
/turf/open/misc/asteroid/basalt/lava_land_surface,
/area/ruin/unpowered/xenonest)
"wy" = (
/obj/structure/stone_tile/surrounding_tile,
/obj/structure/stone_tile/surrounding_tile{
	dir = 4
	},
/turf/closed/mineral/random/high_chance/volcanic,
/area/ruin/unpowered)
"wD" = (
/obj/structure/alien/weeds,
/obj/effect/gibspawner/human/bodypartless,
/turf/open/misc/asteroid/basalt/lava_land_surface,
/area/ruin/unpowered/xenonest)
"wP" = (
/obj/structure/alien/weeds,
/obj/structure/alien/weeds,
/obj/effect/decal/cleanable/blood,
/turf/open/misc/asteroid/basalt/lava_land_surface,
/area/ruin/unpowered/xenonest)
"xu" = (
/obj/structure/alien/weeds,
/mob/living/basic/alien/drone,
/turf/open/misc/asteroid/basalt/lava_land_surface,
/area/ruin/unpowered/xenonest)
"xx" = (
/obj/structure/bed/nest,
/obj/structure/alien/weeds,
/obj/effect/mob_spawn/corpse/human/miner,
/obj/effect/spawner/random/contraband/grenades/dangerous,
/turf/open/misc/asteroid/basalt/lava_land_surface,
/area/ruin/unpowered/xenonest)
"xJ" = (
/obj/effect/spawner/random/medical/supplies,
/obj/effect/gibspawner/human/bodypartless,
/obj/structure/stone_tile{
	dir = 1
	},
/turf/open/misc/asteroid/basalt/lava_land_surface,
/area/ruin/unpowered)
"ya" = (
/obj/structure/stone_tile/slab/cracked{
	dir = 5
	},
/turf/open/lava/smooth/lava_land_surface{
	slowdown = 0
	},
/area/ruin/unpowered)
"Am" = (
/obj/structure/alien/weeds,
/mob/living/basic/alien/sentinel,
/turf/open/misc/asteroid/basalt/lava_land_surface,
/area/ruin/unpowered/xenonest)
"Bl" = (
/obj/structure/alien/weeds,
/obj/structure/alien/egg/burst,
/turf/open/misc/asteroid/basalt/lava_land_surface,
/area/ruin/unpowered/xenonest)
"Bu" = (
/obj/structure/wall_torch/mount_only,
/turf/closed/indestructible/riveted/boss,
/area/ruin/unpowered)
"BB" = (
/obj/structure/stone_tile/block/cracked,
/obj/structure/stone_tile/cracked{
	dir = 1
	},
/turf/open/lava/smooth/lava_land_surface{
	slowdown = 0
	},
/area/ruin/unpowered)
"Ci" = (
/obj/structure/alien/weeds,
/obj/effect/decal/cleanable/blood/tracks{
	desc = "Your instincts say you shouldn't be following these.";
	icon_state = "ltrails_1";
	dir = 10
	},
/turf/open/misc/asteroid/basalt/lava_land_surface,
/area/ruin/unpowered/xenonest)
"CH" = (
/obj/effect/decal/cleanable/blood/tracks,
/obj/structure/stone_tile/block/cracked,
/turf/open/misc/asteroid/basalt/lava_land_surface,
/area/ruin/unpowered)
"CP" = (
/obj/structure/alien/weeds,
/obj/effect/mob_spawn/corpse/human/damaged/ashwalker,
/turf/open/misc/asteroid/basalt/lava_land_surface,
/area/ruin/unpowered/xenonest)
"Da" = (
/obj/effect/mapping_helpers/bombable_wall,
/turf/closed/indestructible/riveted/boss/wasteland,
/area/ruin/unpowered)
"Dz" = (
/turf/closed/mineral/random/high_chance/volcanic,
/area/ruin/unpowered)
"DX" = (
/obj/effect/decal/cleanable/blood,
/obj/effect/decal/cleanable/blood/tracks{
	dir = 9
	},
/obj/structure/stone_tile/block{
	dir = 1
	},
/turf/open/misc/asteroid/basalt/lava_land_surface,
/area/ruin/unpowered)
"Em" = (
/obj/structure/stone_tile/surrounding,
/obj/structure/stone_tile/center/cracked,
/obj/structure/closet/crate/necropolis{
	name = "\improper Ancient Sarcophagus";
	anchored = 1;
	base_icon_state = "necro_bubblegum";
	icon_state = "necro_bubblegum";
	lid_icon_state = "necro_bubblegum_lid";
	desc = "Tools of gods."
	},
/obj/item/organ/internal/cyberimp/arm/gun/laser{
	name = "Unknown ancient weapon";
	desc = "This strange tech has no visible power source and way to use it. Pity that you do not understand those glyphs, but, by some reason, one of them looks exactly like a hand. Strange, isn't it?"
	},
/turf/closed/mineral/volcanic/lava_land_surface,
/area/ruin/unpowered)
"EH" = (
/obj/structure/stone_tile/slab,
/obj/item/flashlight/flare/torch,
/turf/closed/mineral/random/high_chance/volcanic,
/area/ruin/unpowered)
"EM" = (
/obj/structure/stone_tile/block{
	dir = 8
	},
/obj/structure/stone_tile/cracked,
/turf/open/lava/smooth/lava_land_surface{
	slowdown = 0
	},
/area/ruin/unpowered)
"Fv" = (
/obj/structure/stone_tile/surrounding/cracked{
	dir = 1
	},
/obj/structure/stone_tile/center/burnt,
/turf/open/lava/smooth/lava_land_surface{
	slowdown = 0
	},
/area/ruin/unpowered)
"FL" = (
/obj/structure/alien/resin/wall,
/obj/structure/alien/weeds,
/obj/structure/alien/weeds,
/turf/open/misc/asteroid/basalt/lava_land_surface,
/area/ruin/unpowered/xenonest)
"FS" = (
/obj/structure/stone_tile/slab/cracked{
	dir = 4
	},
/obj/structure/stone_tile/slab/cracked{
	dir = 8
	},
/turf/closed/mineral/volcanic/lava_land_surface,
/area/ruin/unpowered)
"FZ" = (
/obj/structure/stone_tile{
	dir = 4
	},
/turf/open/misc/asteroid/basalt/lava_land_surface,
/area/ruin/unpowered)
"HJ" = (
/obj/structure/alien/weeds/node,
/obj/structure/alien/weeds,
/obj/effect/decal/cleanable/blood/tracks{
	desc = "Your instincts say you shouldn't be following these.";
	icon_state = "ltrails_1";
	dir = 6
	},
/mob/living/basic/alien,
/turf/open/misc/asteroid/basalt/lava_land_surface,
/area/ruin/unpowered/xenonest)
"IE" = (
/obj/structure/alien/weeds,
/obj/structure/bed/nest,
/obj/effect/decal/cleanable/blood/gibs,
/obj/item/tank/internals/oxygen,
/obj/item/clothing/suit/space/syndicate/orange,
/obj/item/clothing/mask/gas,
/obj/item/clothing/head/helmet/space/syndicate/orange,
/obj/structure/marker_beacon/burgundy,
/turf/open/misc/asteroid/basalt/lava_land_surface,
/area/ruin/unpowered/xenonest)
"Jp" = (
/obj/structure/fluff/drake_statue,
/turf/open/misc/asteroid/basalt/lava_land_surface,
/area/ruin/unpowered)
"JG" = (
/obj/structure/stone_tile/center/burnt,
/obj/structure/stone_tile/surrounding/cracked{
	dir = 1
	},
/obj/item/clothing/gloves/military/claw,
/turf/closed/mineral/random/high_chance/volcanic,
/area/ruin/unpowered)
"KF" = (
/obj/item/flashlight/flare/torch,
/obj/structure/stone_tile{
	dir = 4
	},
/turf/open/misc/asteroid/basalt/lava_land_surface,
/area/ruin/unpowered)
"La" = (
/obj/structure/alien/resin/wall,
/obj/structure/alien/weeds,
/turf/open/misc/asteroid/basalt/lava_land_surface,
/area/ruin/unpowered/xenonest)
"LA" = (
/obj/structure/stone_tile/surrounding/cracked,
/turf/open/lava/smooth/lava_land_surface{
	slowdown = 0
	},
/area/ruin/unpowered)
"LX" = (
/obj/structure/stone_tile/surrounding_tile,
/obj/structure/stone_tile/surrounding_tile{
	dir = 4
	},
/obj/item/clothing/mask/animal/small/tribal,
/turf/closed/mineral/random/high_chance/volcanic,
/area/ruin/unpowered)
"Mg" = (
/obj/structure/alien/resin/wall,
/obj/structure/alien/weeds,
/obj/structure/alien/weeds,
/obj/effect/spawner/random/medical/two_percent_xeno_egg_spawner,
/turf/open/misc/asteroid/basalt/lava_land_surface,
/area/ruin/unpowered/xenonest)
"Mw" = (
/obj/structure/stone_tile/block{
	dir = 1
	},
/obj/structure/stone_tile/block/cracked,
/turf/closed/mineral/strange_rock,
/area/ruin/unpowered)
"NA" = (
/turf/closed/indestructible/riveted/boss/wasteland,
/area/ruin/unpowered)
"Og" = (
/obj/structure/alien/weeds,
/obj/effect/decal/cleanable/blood/tracks{
	dir = 10
	},
/obj/structure/alien/resin/wall,
/turf/open/misc/asteroid/basalt/lava_land_surface,
/area/ruin/unpowered/xenonest)
"Oo" = (
/obj/structure/stone_tile/surrounding_tile{
	dir = 4
	},
/obj/structure/stone_tile/surrounding_tile,
/turf/closed/mineral/volcanic/lava_land_surface,
/area/ruin/unpowered)
"OC" = (
/obj/structure/alien/weeds,
/obj/effect/spawner/random/medical/two_percent_xeno_egg_spawner,
/turf/open/misc/asteroid/basalt/lava_land_surface,
/area/ruin/unpowered/xenonest)
"OK" = (
/obj/structure/stone_tile/burnt{
	dir = 8
	},
/turf/open/misc/asteroid/basalt/lava_land_surface,
/area/ruin/unpowered)
"ON" = (
/obj/effect/decal/cleanable/blood/tracks,
/obj/structure/stone_tile/slab,
/turf/open/misc/asteroid/basalt/lava_land_surface,
/area/ruin/unpowered)
"Pu" = (
/obj/structure/alien/weeds,
/obj/effect/decal/cleanable/blood/tracks{
	dir = 8
	},
/turf/open/misc/asteroid/basalt/lava_land_surface,
/area/ruin/unpowered/xenonest)
"Py" = (
/turf/open/lava/smooth/lava_land_surface{
	slowdown = 0
	},
/area/ruin/unpowered)
"PN" = (
/turf/closed/indestructible/riveted/boss,
/area/lavaland/surface/outdoors)
"PT" = (
/obj/structure/stone_tile/slab,
/turf/closed/mineral/random/high_chance/volcanic,
/area/ruin/unpowered)
"Qd" = (
/obj/structure/alien/weeds,
/obj/effect/gibspawner/human/bodypartless,
/obj/effect/spawner/random/food_or_drink/snack,
/turf/open/misc/asteroid/basalt/lava_land_surface,
/area/ruin/unpowered/xenonest)
"Qf" = (
/obj/structure/punji_sticks/spikes,
/obj/structure/stone_tile{
	dir = 8
	},
/turf/closed/mineral/random/high_chance/volcanic,
/area/ruin/unpowered)
"Qz" = (
/obj/structure/alien/resin/wall,
/obj/structure/alien/weeds,
/obj/effect/gibspawner/human/bodypartless,
/obj/effect/spawner/random/contraband/narcotics,
/turf/open/misc/asteroid/basalt/lava_land_surface,
/area/ruin/unpowered/xenonest)
"Ro" = (
/obj/structure/alien/weeds/node,
/obj/structure/alien/weeds,
/obj/effect/decal/cleanable/blood{
	icon_state = "floor7-old"
	},
/turf/open/misc/asteroid/basalt/lava_land_surface,
/area/ruin/unpowered/xenonest)
"Ru" = (
/obj/structure/alien/resin/wall,
/obj/structure/alien/weeds,
/obj/effect/mob_spawn/corpse/human/damaged/ashwalker,
/turf/open/misc/asteroid/basalt/lava_land_surface,
/area/ruin/unpowered/xenonest)
"SM" = (
/obj/structure/stone_tile/burnt,
/turf/open/lava/smooth/lava_land_surface{
	slowdown = 0
	},
/area/ruin/unpowered)
"SX" = (
/obj/structure/stone_tile/block{
	dir = 8
	},
/turf/closed/mineral/random/high_chance/volcanic,
/area/ruin/unpowered)
"Tk" = (
/obj/structure/alien/weeds,
/obj/structure/alien/resin/wall,
/turf/open/misc/asteroid/basalt/lava_land_surface,
/area/ruin/unpowered/xenonest)
"To" = (
/obj/structure/stone_tile/slab/cracked,
/turf/closed/mineral/random/high_chance/volcanic,
/area/lavaland/surface/outdoors)
"Ty" = (
/obj/structure/alien/resin/wall,
/obj/structure/alien/weeds,
/obj/effect/decal/cleanable/blood,
/obj/effect/gibspawner/human/bodypartless,
/obj/effect/spawner/random/medical/injector,
/turf/open/misc/asteroid/basalt/lava_land_surface,
/area/ruin/unpowered/xenonest)
"TF" = (
/turf/closed/indestructible/riveted/boss,
/area/ruin/unpowered/xenonest)
"UB" = (
/turf/closed/mineral/strange_rock,
/area/ruin/unpowered)
"UI" = (
/obj/structure/alien/weeds,
/obj/structure/bed/nest,
/obj/effect/decal/cleanable/blood/gibs,
/obj/item/clothing/under/rank/security/officer,
/obj/item/clothing/suit/armor/vest,
/obj/item/melee/baton/security/loaded,
/obj/item/clothing/head/helmet,
/obj/structure/marker_beacon/burgundy,
/turf/open/misc/asteroid/basalt/lava_land_surface,
/area/ruin/unpowered/xenonest)
"Vg" = (
/obj/structure/alien/weeds/node,
/obj/structure/alien/weeds,
/obj/effect/spawner/random/medical/two_percent_xeno_egg_spawner,
/turf/open/misc/asteroid/basalt/lava_land_surface,
/area/ruin/unpowered/xenonest)
"Wa" = (
/obj/structure/alien/weeds,
/obj/effect/decal/cleanable/blood{
	icon_state = "floor7-old"
	},
/turf/open/misc/asteroid/basalt/lava_land_surface,
/area/ruin/unpowered/xenonest)
"Wm" = (
/obj/structure/stone_tile/surrounding/burnt,
/obj/structure/stone_tile/center/cracked,
/turf/open/lava/smooth/lava_land_surface{
	slowdown = 0
	},
/area/ruin/unpowered)
"Wq" = (
/obj/effect/decal/cleanable/blood/tracks,
/obj/structure/stone_tile/surrounding,
/obj/structure/stone_tile/center,
/turf/open/misc/asteroid/basalt/lava_land_surface,
/area/ruin/unpowered)
"WI" = (
/obj/structure/alien/weeds,
/obj/item/clothing/mask/facehugger/impregnated,
/obj/effect/decal/cleanable/blood{
	icon_state = "floor5-old"
	},
/turf/open/misc/asteroid/basalt/lava_land_surface,
/area/ruin/unpowered/xenonest)
"WO" = (
/obj/structure/alien/weeds,
/obj/effect/decal/cleanable/blood/tracks{
	desc = "Your instincts say you shouldn't be following these.";
	dir = 8;
	icon_state = "ltrails_1"
	},
/turf/open/misc/asteroid/basalt/lava_land_surface,
/area/ruin/unpowered/xenonest)
"Yn" = (
/obj/structure/stone_tile/surrounding,
/obj/structure/stone_tile/center,
/turf/open/misc/asteroid/basalt/lava_land_surface,
/area/ruin/unpowered)

(1,1,1) = {"
rp
PN
PN
rp
rp
rp
rp
rp
rp
rp
PN
rp
rp
PN
rp
rp
rp
rp
rp
rp
rp
PN
PN
rp
"}
(2,1,1) = {"
PN
PN
PN
PN
rp
PN
PN
rp
rp
lM
PN
PN
PN
PN
PN
rp
rp
PN
PN
rp
PN
PN
PN
PN
"}
(3,1,1) = {"
PN
PN
PN
PN
PN
PN
PN
PN
lM
lM
PN
La
La
Bl
PN
PN
lM
PN
PN
PN
PN
La
PN
PN
"}
(4,1,1) = {"
rp
PN
PN
TF
La
La
mS
TF
TF
TF
TF
La
CP
wP
ly
ly
ly
ly
TF
OC
La
pN
PN
rp
"}
(5,1,1) = {"
rp
rp
PN
ly
mS
wq
ly
cf
OC
dr
dr
Mg
vG
vG
vG
vG
vG
wD
hF
dr
xu
wq
PN
rp
"}
(6,1,1) = {"
rp
PN
PN
ly
Tk
ly
wq
La
La
cf
nM
vG
vG
UB
UB
vG
vG
TF
TF
TF
TF
jT
PN
PN
"}
(7,1,1) = {"
rp
PN
PN
xu
La
Ty
HJ
TF
TF
TF
TF
vG
Dz
LX
tO
db
vG
Tk
IE
eW
TF
ly
PN
PN
"}
(8,1,1) = {"
rp
lM
PN
FL
TF
TF
TF
TF
Qd
ly
xu
vG
Dz
tO
Oo
Dz
vG
ly
jJ
ly
ly
ly
PN
rp
"}
(9,1,1) = {"
rp
PN
PN
ly
ly
ly
ly
ly
ly
TF
Ru
vG
db
bj
PT
db
vG
mS
Bl
Tk
TF
TF
PN
rp
"}
(10,1,1) = {"
rp
PN
PN
TF
TF
TF
TF
TF
TF
TF
ly
vG
vG
Dz
we
vG
vG
vG
vG
vG
vG
vG
PN
PN
"}
(11,1,1) = {"
PN
PN
Am
iR
mS
TF
Bl
La
kI
TF
La
vG
Jp
FS
EH
Bu
vG
ya
vG
KF
SX
Qf
PN
PN
"}
(12,1,1) = {"
PN
PN
La
mu
wq
Vg
xu
wq
jJ
ly
ly
vG
db
iW
cl
vG
LA
EM
tq
uy
vG
Wm
jc
bW
"}
(13,1,1) = {"
PN
PN
La
Bl
WI
ly
Ro
Bl
OC
ly
Ci
Da
db
JG
Em
vG
Yn
BB
ud
ez
vG
Fv
lM
To
"}
(14,1,1) = {"
PN
PN
mS
va
Am
TF
xx
La
qd
TF
WO
vG
tA
vn
Mw
Bu
vG
we
Bu
bR
SM
Py
PN
lM
"}
(15,1,1) = {"
rp
PN
PN
TF
TF
TF
TF
TF
TF
TF
aM
vG
vG
nL
PT
vG
vG
NA
vG
Da
vG
vG
PN
PN
"}
(16,1,1) = {"
rp
PN
PN
dr
ly
ly
Wa
ly
ly
TF
ly
vG
UB
Dz
ep
db
vG
FZ
am
OK
vG
vG
PN
rp
"}
(17,1,1) = {"
rp
PN
PN
ly
TF
TF
TF
TF
xu
La
ly
vG
Dz
wy
tO
Dz
vG
DX
Wq
CH
ON
Og
PN
rp
"}
(18,1,1) = {"
rp
lM
PN
ly
Tk
UI
xu
TF
TF
TF
TF
vG
Dz
tO
jz
UB
vG
xJ
kz
oL
vG
lQ
PN
PN
"}
(19,1,1) = {"
rp
PN
PN
ly
Wa
jJ
Tk
La
Qz
La
Bl
vG
vG
UB
Dz
vG
vG
vG
vG
vG
vG
Pu
PN
PN
"}
(20,1,1) = {"
rp
rp
PN
Bl
li
ly
hF
ly
La
ly
ly
wq
vG
vG
vG
vG
vG
ly
ly
xu
dE
wD
PN
rp
"}
(21,1,1) = {"
rp
PN
PN
TF
mS
Tk
Bl
TF
TF
TF
TF
ly
pU
cf
La
ly
jT
OC
TF
mS
Bl
hF
lM
rp
"}
(22,1,1) = {"
PN
PN
PN
PN
PN
PN
PN
PN
lM
PN
PN
sR
ly
OC
PN
PN
PN
PN
PN
PN
PN
mS
PN
lM
"}
(23,1,1) = {"
PN
PN
PN
PN
rp
PN
lM
rp
rp
lM
PN
PN
PN
PN
PN
rp
rp
lM
PN
rp
PN
PN
PN
PN
"}
(24,1,1) = {"
rp
PN
lM
rp
rp
rp
rp
rp
rp
rp
lM
rp
rp
PN
rp
rp
rp
rp
rp
rp
rp
PN
PN
rp
"}
