//MAP CONVERTED BY dmm2tgm.py THIS HEADER COMMENT PREVENTS RECONVERSION, DO NOT REMOVE
"ah" = (
/obj/effect/turf_decal/tile/dark/full,
/turf/closed/wall/mineral/titanium/survival/pod,
/area/ruin/powered/seedvault)
"aZ" = (
/obj/effect/turf_decal/trimline/dark/filled/line{
	dir = 1
	},
/obj/effect/turf_decal/trimline/dark/filled/corner,
/obj/effect/turf_decal/trimline/dark/filled/mid_joiner{
	dir = 1
	},
/obj/effect/turf_decal/trimline/dark/filled/mid_joiner{
	dir = 1
	},
/turf/open/floor/iron/dark/smooth_large,
/area/ruin/powered/seedvault)
"bs" = (
/obj/effect/turf_decal/trimline/dark/filled/line,
/obj/effect/turf_decal/trimline/dark/filled/mid_joiner,
/obj/effect/turf_decal/siding/dark{
	dir = 1
	},
/obj/structure/extinguisher_cabinet/directional/south,
/turf/open/floor/iron/dark/smooth_large,
/area/ruin/powered/seedvault)
"cJ" = (
/obj/structure/flora/bush/lavendergrass/style_random,
/turf/open/misc/grass/jungle,
/area/ruin/powered/seedvault)
"de" = (
/obj/machinery/vending/dorms{
	onstation = 0;
	extended_inventory = 1
	},
/obj/structure/curtain/bounty/start_closed{
	color = "#7d7d7d"
	},
/obj/effect/turf_decal/tile/dark/full,
/turf/open/floor/iron/dark/smooth_large,
/area/ruin/powered/seedvault)
"ed" = (
/obj/effect/turf_decal/trimline/dark/filled/line{
	dir = 1
	},
/obj/effect/turf_decal/trimline/dark/filled/line,
/obj/effect/turf_decal/trimline/dark/filled/mid_joiner,
/obj/effect/turf_decal/trimline/dark/filled/mid_joiner{
	dir = 1
	},
/turf/open/floor/iron/dark/smooth_large,
/area/ruin/powered/seedvault)
"fx" = (
/obj/effect/turf_decal/siding/wood{
	dir = 10
	},
/obj/structure/table/wood,
/obj/item/stack/marker_beacon/thirty{
	pixel_y = 10;
	pixel_x = 10
	},
/obj/item/geneshears,
/obj/item/gun/energy/floragun,
/turf/open/floor/wood/large,
/area/ruin/powered/seedvault)
"fC" = (
/obj/structure/flora/bush/lavendergrass/style_random,
/turf/open/floor/grass/fairy,
/area/ruin/powered/seedvault)
"fW" = (
/obj/structure/table/reinforced/plastitaniumglass,
/obj/item/shovel,
/obj/item/pickaxe/drill,
/obj/item/mining_scanner{
	pixel_y = 10;
	pixel_x = 10
	},
/obj/effect/turf_decal/tile/dark/full,
/obj/item/stack/sheet/glass{
	amount = 10
	},
/turf/open/floor/iron/dark/smooth_large,
/area/ruin/powered/seedvault)
"gT" = (
/obj/structure/fans/tiny,
/obj/structure/marker_beacon/burgundy,
/obj/machinery/door/airlock/survival_pod,
/obj/effect/turf_decal/trimline/dark/filled/corner{
	dir = 8
	},
/obj/effect/turf_decal/trimline/dark/filled/corner,
/obj/item/card/id/advanced/mining,
/obj/item/radio/headset/headset_cargo/mining,
/obj/effect/decal/cleanable/blood/tracks,
/turf/open/floor/pod/dark,
/area/ruin/powered/seedvault)
"hh" = (
/turf/open/floor/plating/elevatorshaft,
/area/ruin/powered/seedvault)
"id" = (
/obj/effect/turf_decal/siding/wood{
	dir = 1
	},
/obj/structure/flora/bush/flowers_br/style_random,
/turf/open/misc/hay,
/area/ruin/powered/seedvault)
"kc" = (
/obj/effect/turf_decal/trimline/dark/filled/line{
	dir = 9
	},
/obj/effect/turf_decal/trimline/dark/filled/mid_joiner{
	dir = 8
	},
/obj/effect/turf_decal/trimline/dark/filled/mid_joiner{
	dir = 1
	},
/turf/open/floor/iron/dark/smooth_large,
/area/ruin/powered/seedvault)
"kx" = (
/obj/effect/turf_decal/siding/wood{
	dir = 1
	},
/obj/structure/flora/bush/lavendergrass/style_random,
/turf/open/misc/grass/jungle,
/area/ruin/powered/seedvault)
"kA" = (
/obj/effect/turf_decal/siding/wood/corner,
/obj/structure/flora/bush/sparsegrass/style_random,
/turf/open/misc/grass/jungle,
/area/ruin/powered/seedvault)
"lb" = (
/obj/structure/marker_beacon/burgundy,
/obj/effect/turf_decal/siding/wood,
/turf/open/misc/hay,
/area/ruin/powered/seedvault)
"lz" = (
/obj/structure/window/reinforced/shuttle/survival_pod,
/obj/structure/curtain/bounty/start_closed{
	color = "#7d7d7d"
	},
/obj/item/decoration/new_year/garland,
/turf/open/floor/pod/dark,
/area/ruin/powered/seedvault)
"lN" = (
/obj/effect/turf_decal/trimline/dark/filled/line{
	dir = 1
	},
/obj/effect/turf_decal/trimline/dark/filled/mid_joiner{
	dir = 1
	},
/obj/effect/turf_decal/siding/dark,
/turf/open/floor/iron/dark/smooth_large,
/area/ruin/powered/seedvault)
"ma" = (
/obj/machinery/vending/clothing{
	onstation = 0
	},
/obj/structure/curtain/bounty/start_closed{
	color = "#7d7d7d"
	},
/obj/effect/turf_decal/tile/dark/full,
/turf/open/floor/iron/dark/smooth_large,
/area/ruin/powered/seedvault)
"ns" = (
/obj/machinery/autolathe,
/obj/effect/turf_decal/tile/dark/full,
/turf/open/floor/iron/dark/smooth_large,
/area/ruin/powered/seedvault)
"of" = (
/obj/effect/turf_decal/trimline/dark/filled/end{
	dir = 4
	},
/obj/effect/turf_decal/trimline/dark/filled/mid_joiner,
/obj/effect/turf_decal/trimline/dark/filled/mid_joiner{
	dir = 4
	},
/obj/effect/turf_decal/trimline/dark/filled/mid_joiner{
	dir = 1
	},
/obj/effect/spawner/random/entertainment/lighter,
/obj/effect/decal/cleanable/oil/streak,
/turf/open/floor/iron/dark/smooth_large,
/area/ruin/powered/seedvault)
"oj" = (
/obj/structure/flora/bush/ferny/style_random,
/turf/open/floor/grass/fairy,
/area/ruin/powered/seedvault)
"oR" = (
/obj/effect/turf_decal/siding/dark{
	dir = 8
	},
/obj/effect/turf_decal/trimline/dark/filled/line{
	dir = 9
	},
/obj/effect/turf_decal/trimline/dark/filled/mid_joiner{
	dir = 1
	},
/obj/effect/turf_decal/trimline/dark/filled/mid_joiner{
	dir = 8
	},
/obj/structure/curtain/bounty/start_closed{
	color = "#7d7d7d"
	},
/turf/open/floor/iron/dark/smooth_large,
/area/ruin/powered/seedvault)
"pi" = (
/obj/effect/turf_decal/tile/dark/full,
/obj/machinery/portable_atmospherics/canister/oxygen,
/turf/open/floor/iron/dark/smooth_large,
/area/ruin/powered/seedvault)
"px" = (
/obj/effect/turf_decal/trimline/dark/filled/line{
	dir = 4
	},
/obj/effect/turf_decal/trimline/dark/filled/mid_joiner{
	dir = 4
	},
/obj/effect/turf_decal/siding/dark{
	dir = 8
	},
/obj/effect/decal/cleanable/oil/streak,
/turf/open/floor/iron/dark/smooth_large,
/area/ruin/powered/seedvault)
"qp" = (
/obj/effect/turf_decal/trimline/dark/filled/corner{
	dir = 8
	},
/obj/effect/turf_decal/siding/dark{
	dir = 1
	},
/obj/effect/decal/cleanable/blood/old,
/turf/open/floor/iron/dark/smooth_large,
/area/ruin/powered/seedvault)
"qt" = (
/obj/effect/turf_decal/trimline/dark/filled/corner{
	dir = 1
	},
/obj/effect/turf_decal/siding/dark{
	dir = 4
	},
/obj/effect/decal/cleanable/blood/tracks{
	desc = "Your instincts say you shouldn't be following these.";
	icon_state = "ltrails_1";
	dir = 6
	},
/turf/open/floor/iron/dark/smooth_large,
/area/ruin/powered/seedvault)
"qM" = (
/obj/effect/turf_decal/siding/wood/corner{
	dir = 4
	},
/turf/open/misc/grass/jungle,
/area/ruin/powered/seedvault)
"qQ" = (
/obj/effect/turf_decal/trimline/dark/filled/line{
	dir = 8
	},
/obj/effect/turf_decal/trimline/dark/filled/corner{
	dir = 4
	},
/obj/effect/turf_decal/trimline/dark/filled/mid_joiner{
	dir = 8
	},
/obj/effect/turf_decal/siding/dark/corner,
/obj/item/sharpener{
	pixel_x = -9;
	pixel_y = 7
	},
/obj/effect/decal/cleanable/blood/tracks{
	desc = "Your instincts say you shouldn't be following these.";
	dir = 8;
	icon_state = "ltrails_2";
	pixel_y = 15
	},
/obj/effect/decal/cleanable/blood/tracks{
	desc = "Your instincts say you shouldn't be following these.";
	icon_state = "ltrails_1";
	dir = 10
	},
/turf/open/floor/iron/dark/smooth_large,
/area/ruin/powered/seedvault)
"qR" = (
/obj/item/reagent_containers/cup/bucket/wooden{
	pixel_x = 10;
	pixel_y = -5
	},
/obj/effect/turf_decal/siding/wood{
	dir = 4
	},
/obj/effect/spawner/random/food_or_drink/seed_rare,
/turf/open/misc/hay,
/area/ruin/powered/seedvault)
"rZ" = (
/obj/structure/marker_beacon/teal,
/obj/effect/turf_decal/siding/wood,
/turf/open/misc/hay,
/area/ruin/powered/seedvault)
"sK" = (
/obj/effect/turf_decal/siding/wood{
	dir = 9
	},
/obj/machinery/biogenerator,
/turf/open/floor/wood/large,
/area/ruin/powered/seedvault)
"tD" = (
/obj/effect/turf_decal/tile/dark/full,
/obj/structure/reagent_dispensers/fueltank,
/turf/open/floor/iron/dark/smooth_large,
/area/ruin/powered/seedvault)
"uU" = (
/obj/machinery/hydroponics/constructable,
/turf/open/misc/grass/jungle,
/area/ruin/powered/seedvault)
"vz" = (
/obj/effect/turf_decal/siding/wood{
	dir = 10
	},
/obj/machinery/chem_dispenser/mutagensaltpeter,
/turf/open/floor/wood/large,
/area/ruin/powered/seedvault)
"vR" = (
/obj/structure/flora/grass/jungle/a/style_random,
/turf/open/misc/grass/jungle,
/area/ruin/powered/seedvault)
"wP" = (
/obj/machinery/light/directional/east{
	bulb_colour = "#2C3BFF";
	color = "#aa1200";
	light_color = "#aa1200"
	},
/obj/effect/turf_decal/trimline/dark/filled/line{
	dir = 4
	},
/obj/effect/turf_decal/trimline/dark/filled/mid_joiner{
	dir = 4
	},
/obj/effect/turf_decal/siding/dark/corner{
	dir = 8
	},
/turf/open/floor/iron/dark/smooth_large,
/area/ruin/powered/seedvault)
"xw" = (
/obj/effect/turf_decal/siding/wood,
/obj/structure/flora/bush/pale,
/turf/open/misc/hay,
/area/ruin/powered/seedvault)
"xY" = (
/obj/structure/marker_beacon/violet,
/obj/structure/flora/bush/flowers_pp/style_random,
/turf/open/misc/grass/jungle,
/area/ruin/powered/seedvault)
"zn" = (
/obj/machinery/light/directional/east{
	bulb_colour = "#2C3BFF";
	color = "#aa1200";
	light_color = "#aa1200"
	},
/obj/effect/turf_decal/trimline/dark/filled/line{
	dir = 4
	},
/obj/effect/turf_decal/trimline/dark/filled/mid_joiner{
	dir = 4
	},
/obj/effect/turf_decal/siding/dark/corner{
	dir = 1
	},
/obj/item/oxygen_candle{
	pixel_x = 7;
	pixel_y = 16
	},
/turf/open/floor/iron/dark/smooth_large,
/area/ruin/powered/seedvault)
"zO" = (
/obj/effect/turf_decal/siding/wood{
	dir = 5
	},
/obj/machinery/vending/hydronutrients{
	onstation = 0;
	extended_inventory = 1;
	products = list(/obj/item/gun/energy/floragun = 3, /obj/item/geneshears = 3, /obj/item/hatchet = 3, /obj/item/cultivator = 3, /obj/item/plant_analyzer = 3, /obj/item/reagent_containers/cup/bottle/nutrient/ez = 5, /obj/item/reagent_containers/cup/bottle/nutrient/l4z = 5, /obj/item/reagent_containers/cup/bottle/nutrient/rh = 3, /obj/item/reagent_containers/spray/pestspray = 2, /obj/item/reagent_containers/syringe = 5, /obj/item/secateurs = 3, /obj/item/shovel/spade = 3, /obj/item/storage/bag/plants = 3)
	},
/turf/open/floor/wood/large,
/area/ruin/powered/seedvault)
"Ag" = (
/obj/effect/turf_decal/tile/dark/full,
/obj/structure/reagent_dispensers/watertank/high,
/turf/open/floor/iron/dark/smooth_large,
/area/ruin/powered/seedvault)
"Aj" = (
/obj/effect/turf_decal/trimline/dark/filled/corner{
	dir = 8
	},
/obj/effect/turf_decal/siding/dark{
	dir = 4
	},
/turf/open/floor/iron/dark/smooth_large,
/area/ruin/powered/seedvault)
"Ax" = (
/obj/effect/turf_decal/siding/wood{
	dir = 1
	},
/obj/structure/marker_beacon/purple,
/obj/item/pillow{
	pixel_y = 5;
	pixel_x = 15
	},
/turf/open/floor/carpet/red,
/area/ruin/powered/seedvault)
"BB" = (
/obj/effect/turf_decal/siding/wood{
	dir = 4
	},
/obj/structure/flora/bush/flowers_yw/style_random,
/turf/open/misc/hay,
/area/ruin/powered/seedvault)
"BV" = (
/obj/machinery/light/directional/north{
	light_color = "#777777";
	color = "#777777"
	},
/obj/effect/turf_decal/siding/wood{
	dir = 9
	},
/obj/machinery/smartfridge,
/turf/open/floor/carpet/red,
/area/ruin/powered/seedvault)
"Cd" = (
/turf/template_noop,
/area/template_noop)
"CF" = (
/obj/effect/turf_decal/siding/wood{
	dir = 8
	},
/obj/item/reagent_containers/cup/bucket/wooden,
/turf/open/misc/grass/jungle,
/area/ruin/powered/seedvault)
"CY" = (
/obj/structure/flora/bush/fullgrass/style_random,
/turf/open/misc/grass/jungle,
/area/ruin/powered/seedvault)
"Dl" = (
/obj/machinery/light/directional/south{
	light_color = "#777777";
	color = "#777777"
	},
/obj/structure/table/wood,
/obj/effect/turf_decal/siding/wood{
	dir = 6
	},
/obj/item/construction/plumbing/engineering,
/obj/item/storage/bag/plants{
	pixel_x = 5
	},
/turf/open/floor/wood/large,
/area/ruin/powered/seedvault)
"Dr" = (
/obj/effect/turf_decal/trimline/dark/filled/line,
/obj/effect/turf_decal/trimline/dark/filled/corner{
	dir = 4
	},
/obj/effect/turf_decal/trimline/dark/filled/mid_joiner,
/turf/open/floor/iron/dark/smooth_large,
/area/ruin/powered/seedvault)
"Eg" = (
/obj/structure/flora/ocean/glowweed,
/turf/open/floor/grass/fairy,
/area/ruin/powered/seedvault)
"Ek" = (
/obj/effect/turf_decal/trimline/dark/filled/line{
	dir = 4
	},
/obj/effect/turf_decal/trimline/dark/filled/mid_joiner{
	dir = 4
	},
/obj/effect/turf_decal/siding/dark{
	dir = 8
	},
/turf/open/floor/iron/dark/smooth_large,
/area/ruin/powered/seedvault)
"EF" = (
/obj/effect/mob_spawn/ghost_role/human/seed_vault,
/obj/effect/turf_decal/siding/wood,
/turf/open/floor/wood/large,
/area/ruin/powered/seedvault)
"FP" = (
/obj/structure/marker_beacon/bronze,
/turf/open/misc/grass/jungle,
/area/ruin/powered/seedvault)
"FT" = (
/obj/effect/turf_decal/trimline/dark/filled/line{
	dir = 8
	},
/obj/effect/turf_decal/trimline/dark/filled/corner,
/obj/effect/turf_decal/trimline/dark/filled/mid_joiner{
	dir = 8
	},
/obj/effect/turf_decal/siding/dark/corner{
	dir = 4
	},
/obj/effect/decal/cleanable/oil,
/obj/effect/decal/remains/robot,
/turf/open/floor/iron/dark/smooth_large,
/area/ruin/powered/seedvault)
"GB" = (
/obj/effect/turf_decal/siding/wood{
	dir = 1
	},
/obj/structure/flora/bush/flowers_br/style_random,
/turf/open/misc/grass/jungle,
/area/ruin/powered/seedvault)
"GR" = (
/obj/effect/turf_decal/siding/wood{
	dir = 1
	},
/obj/machinery/hydroponics/constructable,
/turf/open/misc/grass/jungle,
/area/ruin/powered/seedvault)
"He" = (
/turf/open/floor/grass/fairy,
/area/ruin/powered/seedvault)
"HA" = (
/obj/item/secateurs,
/obj/effect/turf_decal/siding/wood{
	dir = 1
	},
/obj/structure/flora/bush/fullgrass/style_random,
/turf/open/misc/grass/jungle,
/area/ruin/powered/seedvault)
"Ic" = (
/obj/machinery/power/shuttle_engine/propulsion{
	dir = 4
	},
/turf/open/misc/asteroid/basalt/lava_land_surface,
/area/lavaland/surface/outdoors)
"JI" = (
/obj/effect/turf_decal/trimline/dark/filled/end{
	dir = 4
	},
/obj/effect/turf_decal/trimline/dark/filled/mid_joiner,
/obj/effect/turf_decal/trimline/dark/filled/mid_joiner{
	dir = 4
	},
/obj/effect/turf_decal/trimline/dark/filled/mid_joiner{
	dir = 1
	},
/obj/effect/decal/cleanable/cobweb/cobweb2,
/obj/effect/spawner/random/clothing/backpack,
/turf/open/floor/iron/dark/smooth_large,
/area/ruin/powered/seedvault)
"JV" = (
/obj/effect/turf_decal/siding/wood{
	dir = 5
	},
/obj/structure/bed/pillow_large,
/obj/effect/spawner/random/bedsheet/double,
/turf/open/floor/carpet/red,
/area/ruin/powered/seedvault)
"Kh" = (
/obj/effect/turf_decal/siding/wood{
	dir = 6
	},
/obj/machinery/vending/hydroseeds{
	onstation = 0;
	extended_inventory = 1
	},
/turf/open/floor/wood/large,
/area/ruin/powered/seedvault)
"Kt" = (
/obj/effect/spawner/random/food_or_drink/seed_vault,
/turf/open/misc/grass/jungle,
/area/ruin/powered/seedvault)
"KL" = (
/obj/machinery/power/shuttle_engine/heater{
	dir = 4
	},
/obj/structure/marker_beacon/burgundy,
/turf/closed/wall/mineral/titanium/survival/pod,
/area/ruin/powered/seedvault)
"KU" = (
/obj/effect/turf_decal/siding/wood{
	dir = 8
	},
/turf/open/misc/grass/jungle,
/area/ruin/powered/seedvault)
"KZ" = (
/obj/item/storage/fancy/rollingpapers,
/turf/open/floor/plating/elevatorshaft,
/area/ruin/powered/seedvault)
"Ln" = (
/obj/effect/turf_decal/siding/wood{
	dir = 8
	},
/obj/structure/flora/grass/jungle/b/style_random,
/turf/open/misc/grass/jungle,
/area/ruin/powered/seedvault)
"MS" = (
/obj/effect/spawner/random/decoration/glowstick,
/turf/open/floor/plating/elevatorshaft,
/area/ruin/powered/seedvault)
"Nd" = (
/obj/item/stack/sheet/iron/twenty{
	pixel_x = -10;
	pixel_y = 7
	},
/turf/open/floor/plating/elevatorshaft,
/area/ruin/powered/seedvault)
"Oh" = (
/obj/machinery/portable_atmospherics/scrubber,
/obj/effect/turf_decal/tile/dark/full,
/turf/open/floor/iron/dark/smooth_large,
/area/ruin/powered/seedvault)
"Pn" = (
/obj/effect/turf_decal/trimline/dark/filled/line{
	dir = 10
	},
/obj/effect/turf_decal/trimline/dark/filled/mid_joiner,
/obj/effect/turf_decal/trimline/dark/filled/mid_joiner{
	dir = 8
	},
/turf/open/floor/iron/dark/smooth_large,
/area/ruin/powered/seedvault)
"PE" = (
/obj/structure/table/survival_pod,
/obj/effect/turf_decal/tile/dark/full,
/obj/item/storage/toolbox/syndicate{
	pixel_x = 3;
	pixel_y = 7
	},
/obj/item/pipe_dispenser,
/obj/structure/curtain/bounty/start_closed{
	color = "#7d7d7d"
	},
/obj/item/clothing/suit/space/orange,
/obj/item/clothing/head/helmet/space/orange,
/obj/item/tank/internals/oxygen,
/turf/open/floor/iron/dark/smooth_large,
/area/ruin/powered/seedvault)
"PI" = (
/obj/effect/turf_decal/siding/wood{
	dir = 8
	},
/obj/machinery/chem_master/condimaster,
/turf/open/floor/wood/large,
/area/ruin/powered/seedvault)
"PM" = (
/obj/structure/flora/tree/jungle/small/style_random,
/obj/effect/turf_decal/siding/wood/corner{
	dir = 4
	},
/obj/effect/turf_decal/siding/wood/corner{
	dir = 8
	},
/turf/open/misc/grass/jungle,
/area/ruin/powered/seedvault)
"QB" = (
/obj/structure/sink/directional/south,
/obj/effect/turf_decal/trimline/dark/filled/line{
	dir = 1
	},
/obj/effect/turf_decal/trimline/dark/filled/mid_joiner{
	dir = 1
	},
/obj/effect/turf_decal/siding/dark,
/obj/structure/mirror/directional/north{
	pixel_y = 34
	},
/turf/open/floor/iron/dark/smooth_large,
/area/ruin/powered/seedvault)
"QT" = (
/obj/effect/turf_decal/trimline/dark/filled/line,
/obj/effect/turf_decal/trimline/dark/filled/mid_joiner,
/obj/effect/turf_decal/siding/dark{
	dir = 1
	},
/turf/open/floor/iron/dark/smooth_large,
/area/ruin/powered/seedvault)
"Rv" = (
/obj/effect/turf_decal/siding/wood,
/obj/structure/flora/bush/flowers_br/style_random,
/turf/open/misc/grass/jungle,
/area/ruin/powered/seedvault)
"Rz" = (
/obj/effect/turf_decal/siding/wood{
	dir = 8
	},
/obj/machinery/seed_extractor,
/turf/open/floor/wood/large,
/area/ruin/powered/seedvault)
"RU" = (
/obj/effect/turf_decal/siding/wood/corner{
	dir = 8
	},
/obj/effect/turf_decal/siding/wood/corner{
	dir = 4
	},
/obj/structure/flora/bush/flowers_yw/style_random,
/obj/structure/loom,
/turf/open/misc/hay,
/area/ruin/powered/seedvault)
"Sv" = (
/obj/structure/flora/bush/sparsegrass/style_random,
/turf/open/misc/grass/jungle,
/area/ruin/powered/seedvault)
"TB" = (
/turf/closed/wall/mineral/titanium/survival/pod,
/area/ruin/powered/seedvault)
"TN" = (
/turf/open/misc/grass/jungle,
/area/ruin/powered/seedvault)
"TQ" = (
/obj/effect/turf_decal/siding/wood{
	dir = 1
	},
/turf/open/floor/carpet/red,
/area/ruin/powered/seedvault)
"Ut" = (
/obj/structure/flora/bush/fullgrass/style_random,
/turf/open/floor/grass/fairy,
/area/ruin/powered/seedvault)
"Vg" = (
/obj/structure/flora/tree/jungle/style_random,
/obj/effect/turf_decal/siding/wood/corner{
	dir = 1
	},
/obj/effect/turf_decal/siding/wood/corner,
/obj/structure/flora/bush/flowers_pp/style_random,
/turf/open/misc/grass/jungle,
/area/ruin/powered/seedvault)
"Vv" = (
/obj/effect/turf_decal/siding/wood/corner,
/obj/effect/turf_decal/siding/wood/corner{
	dir = 1
	},
/obj/structure/table/wood,
/obj/machinery/reagentgrinder{
	pixel_y = 5;
	pixel_x = -8
	},
/obj/item/reagent_containers/cup/bowl/wood_bowl{
	pixel_x = 7;
	pixel_y = 5
	},
/turf/open/misc/hay,
/area/ruin/powered/seedvault)
"VF" = (
/turf/closed/wall/mineral/titanium/survival/nodiagonal,
/area/ruin/powered/seedvault)
"VP" = (
/obj/structure/closet/crate/hydroponics,
/obj/structure/beebox,
/obj/item/honey_frame,
/obj/item/honey_frame,
/obj/item/honey_frame,
/obj/item/melee/flyswatter,
/obj/item/clothing/head/utility/beekeeper_head,
/obj/item/clothing/suit/utility/beekeeper_suit,
/obj/item/queen_bee/bought,
/obj/effect/decal/cleanable/cobweb,
/obj/effect/turf_decal/tile/dark/full,
/turf/open/floor/iron/dark/smooth_large,
/area/ruin/powered/seedvault)
"WT" = (
/obj/effect/turf_decal/siding/dark{
	dir = 8
	},
/obj/effect/turf_decal/trimline/dark/filled/line{
	dir = 10
	},
/obj/effect/turf_decal/trimline/dark/filled/mid_joiner,
/obj/effect/turf_decal/trimline/dark/filled/mid_joiner{
	dir = 8
	},
/obj/structure/curtain/bounty/start_closed{
	color = "#7d7d7d"
	},
/turf/open/floor/iron/dark/smooth_large,
/area/ruin/powered/seedvault)
"WX" = (
/obj/effect/turf_decal/siding/wood{
	dir = 1
	},
/obj/item/binoculars,
/turf/open/floor/carpet/red,
/area/ruin/powered/seedvault)
"WY" = (
/obj/effect/turf_decal/siding/wood{
	dir = 8
	},
/obj/structure/flora/bush/flowers_yw/style_random,
/turf/open/misc/hay,
/area/ruin/powered/seedvault)
"Xd" = (
/obj/effect/turf_decal/trimline/dark/filled/corner{
	dir = 1
	},
/obj/effect/turf_decal/siding/dark,
/turf/open/floor/iron/dark/smooth_large,
/area/ruin/powered/seedvault)
"XQ" = (
/obj/effect/turf_decal/siding/wood,
/obj/effect/spawner/random/contraband/cannabis,
/turf/open/misc/grass/jungle,
/area/ruin/powered/seedvault)
"Yn" = (
/obj/structure/fans/tiny,
/obj/structure/marker_beacon/burgundy,
/obj/machinery/door/airlock/survival_pod,
/obj/effect/turf_decal/trimline/dark/filled/corner{
	dir = 1
	},
/obj/effect/turf_decal/trimline/dark/filled/corner{
	dir = 4
	},
/turf/open/floor/pod/dark,
/area/ruin/powered/seedvault)
"YH" = (
/obj/structure/flora/bush/flowers_pp/style_random,
/turf/open/floor/grass/fairy,
/area/ruin/powered/seedvault)
"Zj" = (
/obj/effect/turf_decal/siding/wood,
/turf/open/misc/grass/jungle,
/area/ruin/powered/seedvault)

(1,1,1) = {"
Cd
Cd
VF
VF
lz
lz
VF
VF
Cd
Cd
"}
(2,1,1) = {"
Cd
VF
VF
sK
Rz
PI
vz
VF
VF
Cd
"}
(3,1,1) = {"
VF
VF
PM
Ln
CF
KU
WY
Vv
VF
VF
"}
(4,1,1) = {"
VF
BV
GR
fC
uU
Kt
xY
xw
fx
VF
"}
(5,1,1) = {"
lz
WX
GB
oj
He
cJ
Sv
XQ
EF
lz
"}
(6,1,1) = {"
lz
TQ
kx
He
Eg
He
Ut
Zj
EF
lz
"}
(7,1,1) = {"
lz
Ax
GR
CY
YH
Ut
uU
Rv
EF
lz
"}
(8,1,1) = {"
VF
JV
HA
FP
uU
TN
vR
rZ
Dl
VF
"}
(9,1,1) = {"
VF
VF
Vg
BB
qM
kA
qR
RU
VF
VF
"}
(10,1,1) = {"
Cd
VF
VF
zO
id
lb
Kh
VF
VF
Cd
"}
(11,1,1) = {"
Cd
Cd
VF
VF
oR
WT
VF
VF
Cd
Cd
"}
(12,1,1) = {"
Cd
Cd
gT
qQ
qt
Aj
FT
Yn
Cd
Cd
"}
(13,1,1) = {"
Cd
TB
TB
QB
hh
MS
bs
TB
TB
Cd
"}
(14,1,1) = {"
Cd
TB
VP
lN
KZ
hh
QT
ns
TB
Cd
"}
(15,1,1) = {"
TB
ah
kc
Xd
Nd
hh
qp
Pn
ah
TB
"}
(16,1,1) = {"
TB
ma
aZ
wP
px
Ek
zn
Dr
Ag
TB
"}
(17,1,1) = {"
TB
de
ed
TB
fW
Oh
TB
ed
pi
TB
"}
(18,1,1) = {"
TB
PE
of
TB
KL
KL
TB
JI
tD
TB
"}
(19,1,1) = {"
TB
KL
TB
TB
Ic
Ic
TB
TB
KL
TB
"}
(20,1,1) = {"
TB
Ic
TB
TB
Cd
Cd
TB
TB
Ic
TB
"}
