//MAP CONVERTED BY dmm2tgm.py THIS HEADER COMMENT PREVENTS RECONVERSION, DO NOT REMOVE
"a" = (
/turf/closed/wall/mineral/bronze,
/area/ruin/unpowered/ratvar)
"b" = (
/obj/structure/lattice,
/obj/structure/grille/broken,
/turf/open/misc/asteroid/basalt/lava_land_surface,
/area/ruin/unpowered/ratvar)
"c" = (
/obj/structure/fluff/clockwork/alloy_shards/medium,
/obj/structure/grille/broken,
/turf/open/misc/asteroid/basalt/lava_land_surface,
/area/ruin/unpowered/ratvar)
"e" = (
/obj/structure/fluff/clockwork/alloy_shards/medium_gearbit{
	pixel_x = 12;
	pixel_y = 7
	},
/turf/open/floor/bronze/filled/lavaland,
/area/ruin/unpowered/ratvar)
"f" = (
/turf/open/floor/bronze/filled/lavaland,
/area/ruin/unpowered/ratvar)
"h" = (
/turf/template_noop,
/area/template_noop)
"i" = (
/obj/structure/fluff/clockwork/alloy_shards/medium_gearbit{
	pixel_x = 12;
	pixel_y = 7
	},
/obj/item/stack/sheet/bronze{
	pixel_y = 7;
	pixel_x = -5
	},
/turf/open/floor/bronze/filled/lavaland,
/area/ruin/unpowered/ratvar)
"j" = (
/obj/structure/fluff/clockwork/alloy_shards/medium_gearbit{
	pixel_x = 12;
	pixel_y = 7
	},
/turf/closed/wall/mineral/bronze,
/area/ruin/unpowered/ratvar)
"k" = (
/obj/structure/grille,
/turf/open/misc/asteroid/basalt/lava_land_surface,
/area/ruin/unpowered/ratvar)
"l" = (
/obj/structure/girder/bronze,
/turf/open/floor/bronze/filled/lavaland,
/area/ruin/unpowered/ratvar)
"m" = (
/obj/structure/fluff/clockwork/alloy_shards/large,
/turf/open/misc/asteroid/basalt/lava_land_surface,
/area/ruin/unpowered/ratvar)
"n" = (
/obj/structure/lattice,
/obj/structure/fluff/clockwork/alloy_shards/large,
/turf/open/misc/asteroid/basalt/lava_land_surface,
/area/ruin/unpowered/ratvar)
"o" = (
/obj/structure/fluff/clockwork/alloy_shards/medium_gearbit{
	pixel_x = -12;
	pixel_y = -7
	},
/turf/open/misc/asteroid/basalt/lava_land_surface,
/area/ruin/unpowered/ratvar)
"p" = (
/obj/structure/fluff/clockwork/alloy_shards/medium_gearbit{
	pixel_x = -12;
	pixel_y = -7
	},
/obj/structure/fluff/clockwork/alloy_shards/medium,
/obj/structure/grille/broken,
/turf/open/floor/bronze/filled/lavaland,
/area/ruin/unpowered/ratvar)
"q" = (
/obj/structure/grille/broken,
/obj/item/stack/sheet/bronze,
/turf/open/floor/bronze/filled/lavaland,
/area/ruin/unpowered/ratvar)
"s" = (
/obj/structure/fluff/clockwork/fallen_armor,
/turf/open/floor/bronze/filled/lavaland,
/area/ruin/unpowered/ratvar)
"t" = (
/obj/structure/fluff/clockwork/clockgolem_remains,
/turf/open/floor/bronze/filled/lavaland,
/area/ruin/unpowered/ratvar)
"v" = (
/obj/structure/lattice,
/obj/structure/girder/bronze,
/turf/open/misc/asteroid/basalt/lava_land_surface,
/area/ruin/unpowered/ratvar)
"w" = (
/obj/structure/dead_ratvar,
/turf/open/misc/asteroid/basalt/lava_land_surface,
/area/ruin/unpowered/ratvar)
"x" = (
/turf/closed/indestructible/riveted/boss,
/area/ruin/unpowered/ratvar)
"y" = (
/obj/structure/fluff/clockwork/alloy_shards/small,
/turf/open/floor/bronze/filled/lavaland,
/area/ruin/unpowered/ratvar)
"z" = (
/obj/structure/fluff/clockwork/alloy_shards/medium{
	pixel_x = -7;
	pixel_y = 7
	},
/turf/open/floor/bronze/filled/lavaland,
/area/ruin/unpowered/ratvar)
"A" = (
/obj/structure/lattice,
/obj/structure/fluff/clockwork/alloy_shards,
/turf/open/misc/asteroid/basalt/lava_land_surface,
/area/ruin/unpowered/ratvar)
"B" = (
/obj/item/stack/sheet/bronze/thirty,
/turf/open/floor/bronze/filled/lavaland,
/area/ruin/unpowered/ratvar)
"D" = (
/obj/structure/fluff/clockwork/blind_eye,
/turf/open/floor/bronze/filled/lavaland,
/area/ruin/unpowered/ratvar)
"E" = (
/obj/structure/fluff/clockwork/alloy_shards/medium_gearbit{
	pixel_x = -12;
	pixel_y = -7
	},
/turf/open/floor/bronze/filled/lavaland,
/area/ruin/unpowered/ratvar)
"F" = (
/obj/structure/lattice,
/turf/open/misc/asteroid/basalt/lava_land_surface,
/area/ruin/unpowered/ratvar)
"G" = (
/obj/structure/fluff/clockwork/alloy_shards/large,
/turf/open/floor/bronze/filled/lavaland,
/area/ruin/unpowered/ratvar)
"H" = (
/obj/structure/lattice,
/obj/structure/fluff/clockwork/alloy_shards/small,
/turf/closed/indestructible/riveted/boss,
/area/ruin/unpowered/ratvar)
"J" = (
/obj/item/stack/sheet/bronze/thirty{
	pixel_x = 5
	},
/turf/open/floor/bronze/filled/lavaland,
/area/ruin/unpowered/ratvar)
"K" = (
/obj/structure/girder/bronze,
/turf/open/misc/asteroid/basalt/lava_land_surface,
/area/ruin/unpowered/ratvar)
"L" = (
/obj/structure/fluff/clockwork/alloy_shards/medium{
	pixel_x = -7;
	pixel_y = 7
	},
/obj/item/stack/sheet/bronze,
/turf/open/floor/bronze/filled/lavaland,
/area/ruin/unpowered/ratvar)
"M" = (
/obj/item/nullrod/spear,
/turf/open/floor/bronze/filled/lavaland,
/area/ruin/unpowered/ratvar)
"O" = (
/obj/structure/lattice,
/obj/structure/fluff/clockwork/alloy_shards/small,
/obj/structure/fluff/clockwork/alloy_shards/small,
/turf/open/misc/asteroid/basalt/lava_land_surface,
/area/ruin/unpowered/ratvar)
"Q" = (
/obj/structure/lattice,
/obj/structure/fluff/clockwork/alloy_shards/small,
/turf/open/misc/asteroid/basalt/lava_land_surface,
/area/ruin/unpowered/ratvar)
"R" = (
/obj/structure/fluff/clockwork/alloy_shards/medium{
	pixel_x = 7;
	pixel_y = 3
	},
/turf/open/misc/asteroid/basalt/lava_land_surface,
/area/ruin/unpowered/ratvar)
"T" = (
/turf/closed/mineral/random/high_chance/volcanic,
/area/ruin/unpowered/ratvar)
"U" = (
/turf/open/misc/asteroid/basalt/lava_land_surface,
/area/ruin/unpowered/ratvar)
"V" = (
/obj/structure/lattice,
/turf/closed/wall/mineral/bronze,
/area/ruin/unpowered/ratvar)
"Y" = (
/turf/open/lava/smooth/lava_land_surface,
/area/ruin/unpowered/ratvar)

(1,1,1) = {"
h
x
Y
k
Y
h
h
h
"}
(2,1,1) = {"
Y
x
c
E
Y
Y
h
h
"}
(3,1,1) = {"
Y
U
w
J
Y
Y
a
h
"}
(4,1,1) = {"
F
V
U
l
t
Y
L
k
"}
(5,1,1) = {"
v
V
U
z
e
f
y
j
"}
(6,1,1) = {"
o
v
F
y
f
Y
q
T
"}
(7,1,1) = {"
a
K
F
A
s
Y
y
y
"}
(8,1,1) = {"
a
a
U
n
M
O
n
a
"}
(9,1,1) = {"
a
a
U
A
E
Y
Q
H
"}
(10,1,1) = {"
a
a
U
F
y
Y
h
Q
"}
(11,1,1) = {"
a
a
U
f
z
Y
h
h
"}
(12,1,1) = {"
a
a
U
b
t
z
h
h
"}
(13,1,1) = {"
m
K
K
R
l
B
m
h
"}
(14,1,1) = {"
h
K
U
x
G
k
a
T
"}
(15,1,1) = {"
h
a
U
i
D
p
x
T
"}
(16,1,1) = {"
h
h
U
y
Y
Y
x
h
"}
