//MAP CONVERTED BY dmm2tgm.py THIS HEADER COMMENT PREVENTS RECONVERSION, DO NOT REMOVE
"a" = (
/turf/closed/indestructible/riveted/boss,
/area/lavaland/surface/outdoors)
"b" = (
/obj/structure/stone_tile/block{
	dir = 1
	},
/turf/closed/mineral/random/high_chance/volcanic,
/area/lavaland/surface/outdoors)
"j" = (
/obj/structure/stone_tile/block,
/obj/structure/stone_tile/block,
/obj/structure/stone_tile/block,
/obj/structure/stone_tile/cracked{
	dir = 1
	},
/turf/closed/mineral/volcanic/lava_land_surface,
/area/lavaland/surface/outdoors)
"n" = (
/turf/closed/mineral/volcanic/lava_land_surface,
/area/lavaland/surface/outdoors)
"q" = (
/obj/structure/stone_tile/block,
/turf/closed/mineral/volcanic/lava_land_surface,
/area/lavaland/surface/outdoors)
"t" = (
/obj/structure/stone_tile/block/cracked{
	dir = 1
	},
/turf/closed/mineral/volcanic/lava_land_surface,
/area/lavaland/surface/outdoors)
"u" = (
/obj/structure/stone_tile/block,
/turf/closed/mineral/random/high_chance/volcanic,
/area/lavaland/surface/outdoors)
"v" = (
/turf/template_noop,
/area/template_noop)
"w" = (
/obj/structure/stone_tile/block/cracked{
	dir = 1
	},
/turf/closed/mineral/random/high_chance/volcanic,
/area/lavaland/surface/outdoors)
"x" = (
/obj/structure/stone_tile/block{
	dir = 1
	},
/turf/closed/mineral/volcanic/lava_land_surface,
/area/lavaland/surface/outdoors)
"y" = (
/obj/structure/flora/rock/pile/style_random,
/turf/closed/mineral/random/high_chance/volcanic,
/area/lavaland/surface/outdoors)
"z" = (
/obj/structure/flora/rock/pile/style_random,
/turf/closed/mineral/volcanic/lava_land_surface,
/area/lavaland/surface/outdoors)
"B" = (
/obj/structure/stone_tile/block/cracked,
/turf/closed/mineral/volcanic/lava_land_surface,
/area/lavaland/surface/outdoors)
"E" = (
/obj/effect/mapping_helpers/bombable_wall,
/turf/closed/indestructible/riveted/boss/wasteland,
/area/lavaland/surface/outdoors)
"L" = (
/obj/structure/stone_tile/cracked{
	dir = 4
	},
/turf/closed/mineral/volcanic/lava_land_surface,
/area/lavaland/surface/outdoors)
"T" = (
/obj/structure/stone_tile/slab/cracked,
/turf/closed/mineral/random/high_chance/volcanic,
/area/lavaland/surface/outdoors)
"W" = (
/obj/structure/stone_tile/block/cracked,
/obj/structure/stone_tile/block{
	dir = 1
	},
/turf/closed/mineral/random/high_chance/volcanic,
/area/lavaland/surface/outdoors)
"Y" = (
/obj/structure/stone_tile/block{
	dir = 1
	},
/obj/structure/stone_tile,
/turf/closed/mineral/random/high_chance/volcanic,
/area/lavaland/surface/outdoors)

(1,1,1) = {"
v
a
z
"}
(2,1,1) = {"
v
a
a
"}
(3,1,1) = {"
a
a
a
"}
(4,1,1) = {"
a
a
a
"}
(5,1,1) = {"
b
E
u
"}
(6,1,1) = {"
t
a
u
"}
(7,1,1) = {"
v
a
B
"}
(8,1,1) = {"
v
a
a
"}
(9,1,1) = {"
v
v
a
"}
(10,1,1) = {"
v
a
a
"}
(11,1,1) = {"
L
a
y
"}
(12,1,1) = {"
Y
T
W
"}
(13,1,1) = {"
w
a
j
"}
(14,1,1) = {"
a
a
v
"}
(15,1,1) = {"
a
a
a
"}
(16,1,1) = {"
a
a
a
"}
(17,1,1) = {"
t
a
v
"}
(18,1,1) = {"
w
a
v
"}
(19,1,1) = {"
n
a
v
"}
(20,1,1) = {"
a
a
v
"}
(21,1,1) = {"
a
v
v
"}
(22,1,1) = {"
a
a
a
"}
(23,1,1) = {"
x
a
q
"}
(24,1,1) = {"
y
a
v
"}
