//MAP CONVERTED BY dmm2tgm.py THIS HEADER COMMENT PREVENTS RECONVERSION, DO NOT REMOVE
"bz" = (
/obj/structure/stone_tile{
	dir = 8
	},
/obj/structure/stone_tile/burnt,
/obj/structure/stone_tile/cracked{
	dir = 4
	},
/obj/structure/flora/ash/fireblossom,
/turf/open/misc/asteroid/basalt/lava_land_surface,
/area/lavaland/surface/outdoors)
"cQ" = (
/obj/structure/stone_tile/surrounding_tile{
	dir = 1
	},
/obj/structure/stone_tile/surrounding_tile{
	dir = 8
	},
/obj/structure/stone_tile/center/burnt,
/turf/closed/mineral/volcanic/lava_land_surface,
/area/lavaland/surface/outdoors)
"eh" = (
/obj/structure/stone_tile/surrounding_tile{
	dir = 4
	},
/obj/structure/stone_tile/surrounding_tile,
/turf/closed/mineral/volcanic/lava_land_surface,
/area/lavaland/surface/outdoors)
"el" = (
/obj/structure/stone_tile/block/burnt{
	dir = 4
	},
/turf/closed/mineral/volcanic/lava_land_surface,
/area/lavaland/surface/outdoors)
"eX" = (
/obj/structure/stone_tile/surrounding/burnt,
/obj/structure/stone_tile/center/burnt,
/turf/closed/mineral/volcanic/lava_land_surface,
/area/lavaland/surface/outdoors)
"fa" = (
/obj/structure/stone_tile/slab,
/obj/item/reagent_containers/cup/bowl/wood_bowl,
/turf/closed/mineral/volcanic/lava_land_surface,
/area/lavaland/surface/outdoors)
"ge" = (
/obj/structure/railing/stone/left,
/turf/open/misc/asteroid/basalt/lava_land_surface,
/area/lavaland/surface/outdoors)
"gX" = (
/obj/structure/stone_tile/surrounding_tile/burnt{
	dir = 1
	},
/obj/structure/stone_tile/surrounding_tile/burnt{
	dir = 8
	},
/obj/structure/stone_tile/center/cracked,
/turf/closed/mineral/volcanic/lava_land_surface,
/area/lavaland/surface/outdoors)
"ha" = (
/obj/structure/stone_tile{
	dir = 8
	},
/turf/open/lava/smooth/lava_land_surface,
/area/lavaland/surface/outdoors)
"hd" = (
/obj/structure/stone_tile/surrounding_tile{
	dir = 8
	},
/turf/closed/mineral/volcanic/lava_land_surface,
/area/lavaland/surface/outdoors)
"hY" = (
/obj/structure/stone_tile/surrounding/burnt,
/obj/structure/stone_tile/center/burnt,
/turf/open/lava/smooth/lava_land_surface,
/area/lavaland/surface/outdoors)
"is" = (
/obj/structure/stone_tile/slab/burnt,
/turf/closed/mineral/volcanic/lava_land_surface,
/area/lavaland/surface/outdoors)
"jJ" = (
/obj/structure/stone_tile/surrounding,
/turf/closed/mineral/volcanic/lava_land_surface,
/area/lavaland/surface/outdoors)
"kB" = (
/obj/structure/stone_tile/slab,
/turf/closed/mineral/volcanic/lava_land_surface,
/area/lavaland/surface/outdoors)
"lj" = (
/obj/structure/stone_tile/block,
/turf/open/misc/asteroid/basalt/lava_land_surface,
/area/lavaland/surface/outdoors)
"ma" = (
/obj/structure/stone_tile/block/cracked{
	dir = 1
	},
/turf/open/lava/smooth/lava_land_surface,
/area/lavaland/surface/outdoors)
"mi" = (
/obj/structure/stone_tile/block/cracked{
	dir = 4
	},
/turf/closed/mineral/volcanic/lava_land_surface,
/area/lavaland/surface/outdoors)
"mT" = (
/obj/structure/stone_tile{
	dir = 4
	},
/turf/open/lava/smooth/lava_land_surface,
/area/lavaland/surface/outdoors)
"nm" = (
/obj/structure/stone_tile/block/cracked{
	dir = 1
	},
/turf/closed/mineral/volcanic/lava_land_surface,
/area/lavaland/surface/outdoors)
"nL" = (
/obj/structure/flora/rock/style_random,
/turf/closed/mineral/volcanic/lava_land_surface,
/area/lavaland/surface/outdoors)
"ol" = (
/obj/structure/stone_tile/surrounding_tile/cracked{
	dir = 4
	},
/obj/structure/stone_tile/surrounding_tile/burnt,
/turf/closed/mineral/volcanic/lava_land_surface,
/area/lavaland/surface/outdoors)
"pc" = (
/turf/open/lava/smooth/lava_land_surface,
/area/lavaland/surface/outdoors)
"pP" = (
/obj/structure/stone_tile/burnt,
/obj/structure/stone_tile/burnt{
	dir = 1
	},
/obj/structure/stone_tile/cracked{
	dir = 4
	},
/obj/structure/railing/stone,
/turf/open/misc/asteroid/basalt/lava_land_surface,
/area/lavaland/surface/outdoors)
"rk" = (
/obj/structure/stone_tile/block{
	dir = 8
	},
/obj/structure/stone_tile/block{
	dir = 4
	},
/turf/closed/mineral/volcanic/lava_land_surface,
/area/lavaland/surface/outdoors)
"rJ" = (
/obj/structure/stone_tile/block{
	dir = 8
	},
/turf/open/lava/smooth/lava_land_surface,
/area/lavaland/surface/outdoors)
"sY" = (
/obj/structure/stone_tile/surrounding_tile/cracked,
/obj/structure/stone_tile/surrounding_tile/burnt{
	dir = 4
	},
/obj/structure/railing/stone,
/turf/open/misc/asteroid/basalt/lava_land_surface,
/area/lavaland/surface/outdoors)
"ti" = (
/obj/structure/stone_tile/block/burnt,
/turf/open/lava/smooth/lava_land_surface,
/area/lavaland/surface/outdoors)
"tJ" = (
/obj/structure/stone_tile/block/burnt,
/obj/structure/stone_tile/block{
	dir = 1
	},
/turf/closed/mineral/volcanic/lava_land_surface,
/area/lavaland/surface/outdoors)
"uv" = (
/obj/structure/stone_tile/block,
/obj/structure/stone_tile/block/cracked{
	dir = 1
	},
/turf/open/lava/smooth/lava_land_surface,
/area/lavaland/surface/outdoors)
"vd" = (
/turf/open/misc/asteroid/basalt/lava_land_surface,
/area/lavaland/surface/outdoors)
"vr" = (
/obj/structure/stone_tile/block/burnt{
	dir = 1
	},
/obj/structure/stone_tile/block,
/turf/closed/mineral/volcanic/lava_land_surface,
/area/lavaland/surface/outdoors)
"wn" = (
/obj/structure/flora/ash/cacti,
/turf/open/misc/asteroid/basalt/lava_land_surface,
/area/lavaland/surface/outdoors)
"wC" = (
/obj/structure/railing/stone,
/turf/open/misc/asteroid/basalt/lava_land_surface,
/area/lavaland/surface/outdoors)
"wF" = (
/obj/structure/stone_tile/slab/cracked,
/turf/closed/mineral/volcanic/lava_land_surface,
/area/lavaland/surface/outdoors)
"xd" = (
/obj/structure/stone_tile/slab/cracked{
	dir = 5
	},
/obj/structure/railing/stone/right,
/turf/open/misc/asteroid/basalt/lava_land_surface,
/area/lavaland/surface/outdoors)
"xp" = (
/obj/structure/flora/ash/seraka,
/turf/closed/mineral/volcanic/lava_land_surface,
/area/lavaland/surface/outdoors)
"yx" = (
/obj/structure/stone_tile/surrounding_tile{
	dir = 1
	},
/turf/closed/mineral/volcanic/lava_land_surface,
/area/lavaland/surface/outdoors)
"zj" = (
/obj/structure/stone_tile/block{
	dir = 8
	},
/obj/structure/stone_tile/block/burnt{
	dir = 4
	},
/turf/open/misc/asteroid/basalt/lava_land_surface,
/area/lavaland/surface/outdoors)
"zo" = (
/obj/structure/flora/ash/stem_shroom,
/turf/open/misc/asteroid/basalt/lava_land_surface,
/area/lavaland/surface/outdoors)
"zL" = (
/obj/structure/stone_tile/surrounding/cracked{
	dir = 1
	},
/obj/structure/stone_tile/center/burnt,
/turf/open/lava/smooth/lava_land_surface,
/area/lavaland/surface/outdoors)
"Ag" = (
/obj/structure/stone_tile/block,
/obj/structure/stone_tile/block/cracked{
	dir = 1
	},
/mob/living/basic/mining/brimdemon,
/mob/living/basic/mining/brimdemon,
/mob/living/basic/mining/brimdemon,
/obj/item/stack/sheet/bone,
/turf/closed/mineral/volcanic/lava_land_surface,
/area/lavaland/surface/outdoors)
"AO" = (
/obj/structure/stone_tile/slab/cracked{
	dir = 6
	},
/turf/closed/mineral/volcanic/lava_land_surface,
/area/lavaland/surface/outdoors)
"BY" = (
/obj/structure/flora/ash/cap_shroom,
/turf/open/misc/asteroid/basalt/lava_land_surface,
/area/lavaland/surface/outdoors)
"Cc" = (
/obj/structure/stone_tile/slab/cracked{
	dir = 6
	},
/mob/living/basic/mining/goliath,
/turf/closed/mineral/volcanic/lava_land_surface,
/area/lavaland/surface/outdoors)
"Cu" = (
/obj/structure/stone_tile/surrounding_tile{
	dir = 4
	},
/obj/structure/stone_tile/surrounding_tile,
/obj/structure/stone_tile/center/burnt,
/turf/open/misc/asteroid/basalt/lava_land_surface,
/area/lavaland/surface/outdoors)
"Cz" = (
/obj/structure/stone_tile/slab/burnt,
/turf/open/lava/smooth/lava_land_surface,
/area/lavaland/surface/outdoors)
"Ee" = (
/turf/closed/mineral/volcanic/lava_land_surface,
/area/lavaland/surface/outdoors)
"Ek" = (
/obj/structure/stone_tile/surrounding_tile/cracked{
	dir = 4
	},
/turf/closed/mineral/volcanic/lava_land_surface,
/area/lavaland/surface/outdoors)
"Ev" = (
/obj/structure/stone_tile/block{
	dir = 8
	},
/obj/structure/stone_tile/block/cracked{
	dir = 4
	},
/obj/structure/railing/stone,
/turf/open/misc/asteroid/basalt/lava_land_surface,
/area/lavaland/surface/outdoors)
"Ey" = (
/obj/structure/stone_tile/block{
	dir = 8
	},
/obj/structure/stone_tile/block/burnt{
	dir = 4
	},
/turf/closed/mineral/volcanic/lava_land_surface,
/area/lavaland/surface/outdoors)
"EB" = (
/obj/structure/stone_tile/slab/cracked,
/turf/open/lava/smooth/lava_land_surface,
/area/lavaland/surface/outdoors)
"EC" = (
/obj/structure/stone_tile/surrounding_tile{
	dir = 1
	},
/turf/open/lava/smooth/lava_land_surface,
/area/lavaland/surface/outdoors)
"FK" = (
/obj/structure/railing/stone/right,
/turf/open/misc/asteroid/basalt/lava_land_surface,
/area/lavaland/surface/outdoors)
"FP" = (
/obj/structure/stone_tile/slab,
/turf/open/lava/smooth/lava_land_surface,
/area/lavaland/surface/outdoors)
"Hh" = (
/obj/structure/stone_tile/burnt,
/turf/open/lava/smooth/lava_land_surface,
/area/lavaland/surface/outdoors)
"Hk" = (
/obj/structure/stone_tile/surrounding_tile/burnt{
	dir = 1
	},
/turf/closed/mineral/volcanic/lava_land_surface,
/area/lavaland/surface/outdoors)
"Id" = (
/obj/structure/flora/rock/pile/style_random,
/turf/open/misc/asteroid/basalt/lava_land_surface,
/area/lavaland/surface/outdoors)
"IR" = (
/obj/structure/stone_tile/block/cracked{
	dir = 8
	},
/turf/open/misc/asteroid/basalt/lava_land_surface,
/area/lavaland/surface/outdoors)
"Kg" = (
/obj/structure/stone_tile/slab/burnt,
/obj/structure/railing/stone,
/turf/open/misc/asteroid/basalt/lava_land_surface,
/area/lavaland/surface/outdoors)
"Ko" = (
/obj/structure/stone_tile/surrounding/cracked,
/turf/open/lava/smooth/lava_land_surface,
/area/lavaland/surface/outdoors)
"Lj" = (
/obj/structure/stone_tile/slab/burnt,
/turf/open/misc/asteroid/basalt/lava_land_surface,
/area/lavaland/surface/outdoors)
"MB" = (
/obj/structure/stone_tile/surrounding_tile{
	dir = 8
	},
/obj/structure/stone_tile/surrounding_tile/cracked{
	dir = 1
	},
/obj/structure/railing/stone/left,
/turf/open/misc/asteroid/basalt/lava_land_surface,
/area/lavaland/surface/outdoors)
"No" = (
/obj/structure/stone_tile{
	dir = 1
	},
/turf/open/misc/asteroid/basalt/lava_land_surface,
/area/lavaland/surface/outdoors)
"NK" = (
/obj/structure/stone_tile/surrounding,
/obj/structure/stone_tile/center/cracked,
/turf/closed/mineral/volcanic/lava_land_surface,
/area/lavaland/surface/outdoors)
"OR" = (
/obj/structure/stone_tile{
	dir = 1
	},
/obj/structure/stone_tile/burnt,
/obj/structure/stone_tile{
	dir = 4
	},
/turf/closed/mineral/volcanic/lava_land_surface,
/area/lavaland/surface/outdoors)
"Px" = (
/obj/structure/stone_tile/burnt{
	dir = 1
	},
/obj/structure/stone_tile/burnt{
	dir = 8
	},
/obj/structure/stone_tile/surrounding_tile,
/turf/open/lava/smooth/lava_land_surface,
/area/lavaland/surface/outdoors)
"PB" = (
/obj/structure/stone_tile/slab/cracked{
	dir = 4
	},
/obj/structure/stone_tile/slab/cracked{
	dir = 8
	},
/turf/closed/mineral/volcanic/lava_land_surface,
/area/lavaland/surface/outdoors)
"QL" = (
/obj/structure/stone_tile/slab/cracked{
	dir = 8
	},
/obj/structure/stone_tile/slab/cracked{
	dir = 4
	},
/turf/closed/mineral/volcanic/lava_land_surface,
/area/lavaland/surface/outdoors)
"QR" = (
/obj/structure/stone_tile/block,
/turf/open/lava/smooth/lava_land_surface,
/area/lavaland/surface/outdoors)
"RW" = (
/obj/structure/stone_tile/surrounding/cracked,
/turf/closed/mineral/volcanic/lava_land_surface,
/area/lavaland/surface/outdoors)
"Te" = (
/obj/structure/stone_tile{
	dir = 8
	},
/turf/open/misc/asteroid/basalt/lava_land_surface,
/area/lavaland/surface/outdoors)
"TE" = (
/turf/template_noop,
/area/template_noop)
"TP" = (
/obj/structure/stone_tile/surrounding/cracked{
	dir = 6
	},
/turf/open/lava/smooth/lava_land_surface,
/area/lavaland/surface/outdoors)
"Uj" = (
/obj/structure/stone_tile/block,
/turf/closed/mineral/volcanic/lava_land_surface,
/area/lavaland/surface/outdoors)
"VV" = (
/obj/structure/stone_tile/block{
	dir = 1
	},
/obj/structure/stone_tile/block/cracked,
/turf/closed/mineral/volcanic/lava_land_surface,
/area/lavaland/surface/outdoors)
"WU" = (
/obj/structure/flora/rock/style_random,
/turf/open/misc/asteroid/basalt/lava_land_surface,
/area/lavaland/surface/outdoors)
"XI" = (
/obj/structure/stone_tile{
	dir = 1
	},
/turf/closed/mineral/volcanic/lava_land_surface,
/area/lavaland/surface/outdoors)
"Yz" = (
/obj/structure/stone_tile,
/obj/structure/stone_tile{
	dir = 8
	},
/obj/structure/stone_tile{
	dir = 4
	},
/turf/closed/mineral/volcanic/lava_land_surface,
/area/lavaland/surface/outdoors)
"YH" = (
/obj/structure/stone_tile/surrounding/cracked{
	dir = 1
	},
/turf/open/misc/asteroid/basalt/lava_land_surface,
/area/lavaland/surface/outdoors)

(1,1,1) = {"
TE
pc
pc
TE
TE
TE
TE
TE
ge
pc
Ee
TE
"}
(2,1,1) = {"
TE
pc
pc
pc
TE
TE
RW
NK
wC
pc
Ee
TE
"}
(3,1,1) = {"
TE
Ee
pc
pc
WU
zo
kB
Cc
wC
pc
mT
TE
"}
(4,1,1) = {"
xp
Ee
pc
pc
pc
Te
OR
Yz
wC
pc
pc
TE
"}
(5,1,1) = {"
Ee
kB
EB
hY
Px
Ek
AO
fa
wC
pc
pc
TE
"}
(6,1,1) = {"
TE
rk
rJ
pc
pc
eX
mi
Ey
FK
pc
pc
TE
"}
(7,1,1) = {"
TE
ol
MB
pc
pc
uv
eh
cQ
pc
pc
nL
TE
"}
(8,1,1) = {"
TE
gX
sY
pc
pc
ti
yx
Cu
QR
pc
Ee
TE
"}
(9,1,1) = {"
TE
el
Ev
pc
pc
TP
IR
zj
zL
Ko
kB
nm
"}
(10,1,1) = {"
TE
QL
Kg
pc
pc
EC
Lj
Id
pc
pc
tJ
Ee
"}
(11,1,1) = {"
TE
Hk
pP
pc
pc
pc
bz
ha
pc
pc
hd
Uj
"}
(12,1,1) = {"
TE
vr
xd
wn
pc
pc
FP
Cz
pc
pc
eX
jJ
"}
(13,1,1) = {"
Ee
RW
eX
TE
Hh
pc
pc
pc
pc
vd
AO
XI
"}
(14,1,1) = {"
Ee
is
wF
TE
No
pc
pc
pc
pc
Id
TE
TE
"}
(15,1,1) = {"
TE
VV
Ag
TE
Id
pc
pc
ma
vd
TE
TE
TE
"}
(16,1,1) = {"
TE
PB
TE
TE
TE
pc
pc
pc
BY
TE
TE
TE
"}
(17,1,1) = {"
TE
TE
TE
TE
TE
TE
pc
pc
pc
TE
TE
TE
"}
(18,1,1) = {"
TE
TE
TE
TE
TE
TE
Lj
pc
pc
TE
TE
TE
"}
(19,1,1) = {"
TE
TE
TE
TE
TE
TE
YH
pc
pc
TE
TE
TE
"}
(20,1,1) = {"
TE
TE
TE
TE
TE
TE
No
lj
pc
pc
TE
TE
"}
