//MAP CONVERTED BY dmm2tgm.py THIS HEADER COMMENT PREVENTS RECONVERSION, DO NOT REMOVE
"a" = (
/turf/template_noop,
/area/template_noop)
"b" = (
/obj/structure/flora/rock/style_random,
/turf/closed/mineral/random/high_chance/volcanic,
/area/lavaland/surface/outdoors)
"p" = (
/turf/open/chasm/lavaland,
/area/lavaland/surface/outdoors)
"s" = (
/turf/closed/mineral/volcanic/lava_land_surface,
/area/lavaland/surface/outdoors)
"A" = (
/turf/closed/mineral/random/high_chance/volcanic,
/area/lavaland/surface/outdoors)
"C" = (
/obj/structure/flora/rock/pile/style_random,
/turf/closed/mineral/random/high_chance/volcanic,
/area/lavaland/surface/outdoors)
"O" = (
/obj/structure/flora/rock/pile/style_random,
/turf/closed/mineral/volcanic/lava_land_surface,
/area/lavaland/surface/outdoors)

(1,1,1) = {"
a
a
s
O
a
a
"}
(2,1,1) = {"
a
s
A
p
p
s
"}
(3,1,1) = {"
s
A
C
p
A
s
"}
(4,1,1) = {"
s
p
p
p
A
a
"}
(5,1,1) = {"
s
b
p
A
A
a
"}
(6,1,1) = {"
a
a
p
A
s
a
"}
(7,1,1) = {"
a
a
A
C
a
a
"}
