//MAP CONVERTED BY dmm2tgm.py THIS HEADER COMMENT PREVENTS RECONVERSION, DO NOT REMOVE
"a" = (
/turf/closed/indestructible/riveted/boss,
/area/ruin/unpowered)
"c" = (
/obj/structure/fluff/divine/powerpylon,
/obj/structure/marker_beacon/teal,
/turf/open/misc/snow/actually_safe{
	initial_gas_mix = "LAVALAND_ATMOS"
	},
/area/ruin/unpowered)
"d" = (
/obj/structure/fluff/divine/nexus,
/obj/item/clothing/neck/wreath/icewing,
/obj/structure/marker_beacon/teal,
/turf/open/misc/snow/actually_safe{
	initial_gas_mix = "LAVALAND_ATMOS"
	},
/area/ruin/unpowered)
"e" = (
/obj/effect/turf_decal/weather/snow/corner{
	dir = 9
	},
/mob/living/basic/mining/ice_demon,
/turf/open/misc/ice/icemoon{
	initial_gas_mix = "LAVALAND_ATMOS"
	},
/area/ruin/unpowered)
"h" = (
/mob/living/basic/mining/ice_demon,
/obj/effect/turf_decal/weather/snow/corner{
	dir = 9
	},
/turf/open/misc/ice/icemoon{
	initial_gas_mix = "LAVALAND_ATMOS"
	},
/area/ruin/unpowered)
"i" = (
/turf/template_noop,
/area/template_noop)
"k" = (
/turf/closed/indestructible/riveted/boss,
/area/lavaland/surface/outdoors)
"p" = (
/obj/item/grenade/gas_crystal/nitrous_oxide_crystal,
/turf/open/misc/ice/icemoon{
	initial_gas_mix = "LAVALAND_ATMOS"
	},
/area/ruin/unpowered)
"q" = (
/obj/effect/turf_decal/weather/snow/corner{
	dir = 6
	},
/turf/open/misc/ice/icemoon{
	initial_gas_mix = "LAVALAND_ATMOS"
	},
/area/ruin/unpowered)
"r" = (
/obj/effect/turf_decal/weather/snow/corner{
	dir = 1
	},
/turf/open/misc/ice/icemoon{
	initial_gas_mix = "LAVALAND_ATMOS"
	},
/area/ruin/unpowered)
"y" = (
/obj/effect/mapping_helpers/bombable_wall,
/turf/closed/indestructible/riveted/boss/wasteland,
/area/lavaland/surface/outdoors)
"z" = (
/obj/effect/turf_decal/weather/snow/corner,
/turf/open/misc/ice/icemoon{
	initial_gas_mix = "LAVALAND_ATMOS"
	},
/area/ruin/unpowered)
"B" = (
/obj/effect/turf_decal/weather/snow/corner{
	dir = 10
	},
/obj/structure/fluff/divine/powerpylon,
/obj/structure/marker_beacon/teal,
/turf/open/misc/ice/icemoon{
	initial_gas_mix = "LAVALAND_ATMOS"
	},
/area/ruin/unpowered)
"C" = (
/obj/effect/turf_decal/weather/snow/corner{
	dir = 6
	},
/mob/living/basic/mining/ice_demon,
/turf/open/misc/ice/icemoon{
	initial_gas_mix = "LAVALAND_ATMOS"
	},
/area/ruin/unpowered)
"D" = (
/mob/living/basic/mining/ice_demon,
/obj/structure/flora/ash/chilly,
/turf/open/misc/snow/actually_safe{
	initial_gas_mix = "LAVALAND_ATMOS"
	},
/area/ruin/unpowered)
"G" = (
/obj/structure/fluff/divine/conduit,
/turf/open/misc/snow/actually_safe{
	initial_gas_mix = "LAVALAND_ATMOS"
	},
/area/ruin/unpowered)
"I" = (
/mob/living/basic/mining/ice_demon,
/turf/open/misc/ice/icemoon{
	initial_gas_mix = "LAVALAND_ATMOS"
	},
/area/ruin/unpowered)
"L" = (
/obj/effect/turf_decal/weather/snow/corner{
	dir = 5
	},
/obj/effect/turf_decal/weather/snow/corner{
	dir = 8
	},
/obj/structure/fluff/divine/conduit,
/turf/open/misc/ice/icemoon{
	initial_gas_mix = "LAVALAND_ATMOS"
	},
/area/ruin/unpowered)
"N" = (
/obj/structure/flora/rock/pile/icy/style_random,
/turf/open/misc/snow/actually_safe{
	initial_gas_mix = "LAVALAND_ATMOS"
	},
/area/ruin/unpowered)
"P" = (
/obj/item/crusher_trophy/ice_demon_cube,
/turf/open/misc/ice/icemoon{
	initial_gas_mix = "LAVALAND_ATMOS"
	},
/area/ruin/unpowered)
"R" = (
/obj/effect/mapping_helpers/bombable_wall,
/turf/closed/indestructible/riveted/boss/wasteland,
/area/ruin/unpowered)
"U" = (
/obj/item/stock_parts/cell/crystal_cell,
/obj/structure/flora/grass/both/style_random,
/turf/open/misc/snow/actually_safe{
	initial_gas_mix = "LAVALAND_ATMOS"
	},
/area/ruin/unpowered)
"W" = (
/obj/effect/turf_decal/weather/snow/corner{
	dir = 5
	},
/obj/item/hypernoblium_crystal,
/turf/open/misc/ice/icemoon{
	initial_gas_mix = "LAVALAND_ATMOS"
	},
/area/ruin/unpowered)
"Y" = (
/obj/structure/fluff/divine/shrine,
/obj/effect/turf_decal/weather/snow/corner{
	dir = 6
	},
/obj/effect/turf_decal/weather/snow/corner{
	dir = 8
	},
/turf/open/misc/ice/icemoon{
	initial_gas_mix = "LAVALAND_ATMOS"
	},
/area/ruin/unpowered)
"Z" = (
/obj/structure/fluff/divine/shrine,
/turf/open/misc/snow/actually_safe{
	initial_gas_mix = "LAVALAND_ATMOS"
	},
/area/ruin/unpowered)

(1,1,1) = {"
i
i
k
k
i
k
k
i
i
"}
(2,1,1) = {"
i
k
k
a
a
a
k
k
i
"}
(3,1,1) = {"
k
k
a
U
e
B
a
k
k
"}
(4,1,1) = {"
k
a
G
D
r
p
Y
a
k
"}
(5,1,1) = {"
i
a
d
h
P
q
N
R
y
"}
(6,1,1) = {"
k
a
L
I
z
U
Z
a
k
"}
(7,1,1) = {"
k
k
a
W
C
c
a
k
k
"}
(8,1,1) = {"
i
k
k
a
a
a
k
k
i
"}
(9,1,1) = {"
i
i
k
k
i
k
k
i
i
"}
