//MAP CONVERTED BY dmm2tgm.py THIS HEADER COMMENT PREVENTS RECONVERSION, DO NOT REMOVE
"a" = (
/obj/effect/light_emitter/daylight,
/turf/open/misc/ice/coldroom,
/area/trainstation/outdoor)
"b" = (
/mob/living/simple_animal/hostile/asteroid/polarbear,
/obj/effect/light_emitter/daylight,
/turf/open/misc/asteroid/snow/standard_air,
/area/trainstation/outdoor)
"d" = (
/obj/item/restraints/legcuffs/beartrap/prearmed,
/obj/effect/light_emitter/daylight,
/turf/open/misc/asteroid/snow/standard_air,
/area/trainstation/outdoor)
"e" = (
/obj/structure/flora/rock/style_random,
/obj/structure/flora/bush/snow/style_random,
/obj/effect/light_emitter/daylight,
/turf/open/misc/asteroid/snow/indestructible,
/area/trainstation/outdoor)
"g" = (
/obj/structure/flora/tree/pine/style_random,
/obj/effect/light_emitter/daylight,
/turf/open/misc/asteroid/snow/indestructible,
/area/trainstation/outdoor)
"h" = (
/obj/effect/turf_decal/siding/wood,
/obj/effect/light_emitter/daylight,
/turf/open/floor/wood,
/area/trainstation/indoors)
"j" = (
/obj/effect/turf_decal/siding/wood{
	dir = 5
	},
/obj/structure/chair/wood,
/obj/effect/light_emitter/daylight,
/turf/open/floor/wood,
/area/trainstation/indoors)
"k" = (
/obj/effect/light_emitter/daylight,
/turf/open/floor/wood,
/area/trainstation/indoors)
"l" = (
/obj/structure/mineral_door/wood/large_gate{
	dir = 8
	},
/obj/effect/light_emitter/daylight,
/turf/open/misc/asteroid/snow/standard_air,
/area/trainstation/outdoor)
"n" = (
/obj/effect/light_emitter/daylight,
/turf/closed/indestructible/rock/snow/ice/ore,
/area/trainstation/outdoor)
"o" = (
/mob/living/simple_animal/hostile/asteroid/polarbear,
/obj/effect/light_emitter/daylight,
/turf/open/misc/asteroid/snow/indestructible,
/area/trainstation/outdoor)
"p" = (
/obj/structure/flora/bush/snow/style_random,
/mob/living/simple_animal/hostile/asteroid/polarbear,
/obj/effect/light_emitter/daylight,
/turf/open/misc/asteroid/snow/indestructible,
/area/trainstation/outdoor)
"q" = (
/obj/structure/mineral_door/wood/large_gate,
/obj/effect/light_emitter/daylight,
/turf/open/misc/asteroid/snow/standard_air,
/area/trainstation/outdoor)
"t" = (
/obj/structure/flora/bush/snow/style_random,
/obj/effect/light_emitter/daylight,
/turf/open/misc/asteroid/snow/indestructible,
/area/trainstation/outdoor)
"u" = (
/obj/item/chair/wood,
/obj/effect/light_emitter/daylight,
/turf/open/floor/wood,
/area/trainstation/indoors)
"v" = (
/obj/effect/turf_decal/siding/wood,
/obj/effect/light_emitter/daylight,
/turf/open/misc/ice/coldroom,
/area/trainstation/outdoor)
"w" = (
/obj/effect/turf_decal/siding/wood{
	dir = 8
	},
/obj/effect/light_emitter/daylight,
/turf/open/floor/wood,
/area/trainstation/indoors)
"x" = (
/obj/effect/turf_decal/siding/wood{
	dir = 10
	},
/obj/effect/light_emitter/daylight,
/turf/open/floor/wood,
/area/trainstation/indoors)
"z" = (
/obj/structure/mineral_door/wood/large_gate,
/obj/effect/light_emitter/daylight,
/turf/open/misc/asteroid/snow/indestructible,
/area/trainstation/outdoor)
"A" = (
/mob/living/basic/pet/fox,
/obj/effect/light_emitter/daylight,
/turf/open/misc/asteroid/snow/indestructible,
/area/trainstation/outdoor)
"B" = (
/obj/structure/barricade/wooden/crude,
/obj/structure/barricade/wooden/crude/snow,
/obj/structure/mineral_door/wood,
/obj/effect/light_emitter/daylight,
/turf/open/floor/wood,
/area/trainstation/indoors)
"C" = (
/obj/effect/turf_decal/siding/wood{
	dir = 1
	},
/obj/effect/light_emitter/daylight,
/turf/open/misc/ice/coldroom,
/area/trainstation/outdoor)
"D" = (
/obj/structure/flora/rock/style_random,
/obj/effect/light_emitter/daylight,
/turf/open/misc/asteroid/snow/indestructible,
/area/trainstation/outdoor)
"F" = (
/obj/effect/turf_decal/siding/wood{
	dir = 1
	},
/obj/effect/light_emitter/daylight,
/turf/open/floor/wood,
/area/trainstation/indoors)
"G" = (
/obj/effect/turf_decal/siding/wood{
	dir = 4
	},
/obj/structure/table/wood,
/obj/effect/light_emitter/daylight,
/turf/open/floor/wood,
/area/trainstation/indoors)
"H" = (
/obj/effect/light_emitter/daylight,
/turf/open/floor/wood/wood_1,
/area/trainstation/outdoor)
"I" = (
/obj/structure/table/wood,
/obj/effect/light_emitter/daylight,
/turf/open/floor/wood,
/area/trainstation/indoors)
"J" = (
/obj/effect/light_emitter/daylight,
/turf/open/misc/asteroid/snow/indestructible,
/area/trainstation/outdoor)
"L" = (
/mob/living/basic/pet/fox,
/obj/effect/light_emitter/daylight,
/turf/open/misc/asteroid/snow/standard_air,
/area/trainstation/outdoor)
"M" = (
/obj/effect/turf_decal/siding/wood{
	dir = 4
	},
/obj/effect/light_emitter/daylight,
/turf/open/floor/wood,
/area/trainstation/indoors)
"N" = (
/obj/effect/turf_decal/siding/wood{
	dir = 1
	},
/obj/structure/closet/crate/wooden/storage_barrel,
/obj/effect/light_emitter/daylight,
/turf/open/floor/wood,
/area/trainstation/indoors)
"O" = (
/obj/effect/light_emitter/daylight,
/turf/open/misc/asteroid/snow/standard_air,
/area/trainstation/outdoor)
"P" = (
/obj/effect/turf_decal/siding/wood{
	dir = 6
	},
/obj/effect/light_emitter/daylight,
/turf/open/floor/wood,
/area/trainstation/indoors)
"Q" = (
/obj/structure/flora/tree/pine/style_random,
/obj/structure/flora/bush/snow/style_random,
/obj/effect/light_emitter/daylight,
/turf/open/misc/asteroid/snow/indestructible,
/area/trainstation/outdoor)
"R" = (
/obj/effect/turf_decal/siding/wood{
	dir = 1
	},
/obj/effect/light_emitter/daylight,
/turf/open/misc/asteroid/snow/standard_air,
/area/trainstation/outdoor)
"S" = (
/obj/effect/turf_decal/siding/wood{
	dir = 9
	},
/obj/structure/closet/crate/wooden/storage_barrel,
/obj/effect/light_emitter/daylight,
/turf/open/floor/wood,
/area/trainstation/indoors)
"T" = (
/obj/structure/closet/crate/wooden/storage_barrel,
/obj/effect/light_emitter/daylight,
/turf/open/misc/asteroid/snow/standard_air,
/area/trainstation/outdoor)
"U" = (
/obj/effect/turf_decal/siding/wood,
/obj/effect/light_emitter/daylight,
/turf/open/misc/asteroid/snow/standard_air,
/area/trainstation/outdoor)
"V" = (
/obj/effect/turf_decal/siding/wood{
	dir = 8
	},
/obj/structure/closet/crate/wooden/storage_barrel,
/obj/effect/light_emitter/daylight,
/turf/open/floor/wood,
/area/trainstation/indoors)
"X" = (
/obj/effect/light_emitter/daylight,
/turf/closed/indestructible/wood,
/area/trainstation/indoors)
"Y" = (
/obj/structure/closet/crate/wooden/storage_barrel,
/obj/effect/light_emitter/daylight,
/turf/open/floor/wood,
/area/trainstation/indoors)
"Z" = (
/obj/effect/turf_decal/siding/wood{
	dir = 1
	},
/obj/structure/chair/wood,
/obj/effect/light_emitter/daylight,
/turf/open/floor/wood,
/area/trainstation/indoors)

(1,1,1) = {"
O
O
O
O
O
O
O
O
O
O
O
O
O
O
O
O
O
O
O
O
O
O
O
O
O
O
O
O
O
O
O
O
O
O
O
O
O
O
O
n
"}
(2,1,1) = {"
O
O
O
O
O
O
O
O
O
O
O
O
O
O
O
O
O
O
O
O
O
O
O
O
O
O
O
O
O
O
O
O
O
O
O
O
O
O
O
n
"}
(3,1,1) = {"
O
O
O
O
O
O
O
t
J
g
J
D
t
J
g
O
O
O
O
O
O
O
O
O
O
O
O
O
t
J
g
J
D
t
J
g
O
O
O
n
"}
(4,1,1) = {"
O
O
O
t
J
J
g
g
J
J
O
O
O
O
O
O
t
J
g
J
D
t
J
g
O
O
J
g
g
J
J
O
O
O
O
O
O
O
O
n
"}
(5,1,1) = {"
O
J
g
g
J
J
J
J
g
J
J
J
J
g
J
O
g
J
J
J
J
J
J
J
g
J
D
J
J
J
J
J
g
J
D
t
J
O
O
n
"}
(6,1,1) = {"
O
J
J
J
g
t
J
e
J
J
g
J
J
J
J
O
J
g
J
g
J
g
J
g
J
D
O
g
J
g
J
g
J
D
O
O
t
O
O
n
"}
(7,1,1) = {"
O
t
J
e
J
O
O
t
J
g
J
D
t
J
g
O
e
J
J
J
D
t
J
g
J
D
J
J
D
t
J
g
J
D
J
g
g
O
O
n
"}
(8,1,1) = {"
O
O
O
t
J
J
t
g
J
J
O
O
O
O
O
t
t
J
g
J
D
t
J
t
J
g
J
J
D
t
J
t
J
g
J
J
J
O
O
n
"}
(9,1,1) = {"
O
J
t
g
J
J
J
J
t
t
Q
J
J
t
g
J
t
J
J
J
g
O
t
J
g
J
t
J
g
O
p
J
g
J
t
J
e
O
O
n
"}
(10,1,1) = {"
O
J
J
J
t
J
O
J
Q
t
t
J
J
J
t
g
g
J
g
O
O
O
O
O
O
O
O
O
O
O
O
O
O
O
O
O
t
O
O
n
"}
(11,1,1) = {"
O
J
O
J
Q
J
O
J
J
J
J
g
J
d
J
t
J
g
J
g
J
O
O
O
O
O
J
g
J
O
O
O
O
O
J
t
g
O
O
n
"}
(12,1,1) = {"
O
J
O
J
J
g
O
J
g
J
J
J
J
O
J
J
e
J
J
J
J
O
O
O
O
O
J
J
J
O
O
O
O
O
J
J
J
O
O
n
"}
(13,1,1) = {"
O
g
O
J
g
J
J
g
J
D
t
J
g
O
A
J
t
J
J
J
g
O
O
t
J
g
J
J
g
O
O
t
J
g
J
D
t
O
O
n
"}
(14,1,1) = {"
O
J
J
g
J
J
g
J
D
t
J
g
J
D
t
J
g
J
O
O
O
t
O
g
J
J
O
O
O
t
O
g
J
J
O
O
O
t
O
n
"}
(15,1,1) = {"
O
J
g
J
D
t
J
g
J
D
t
J
J
J
J
J
J
t
g
J
O
O
O
O
O
J
t
g
J
J
t
t
Q
J
J
t
g
J
O
n
"}
(16,1,1) = {"
O
O
O
O
O
O
O
O
g
O
J
g
J
J
J
O
J
Q
J
J
O
O
O
O
O
J
J
J
O
J
Q
t
t
J
J
J
t
g
O
n
"}
(17,1,1) = {"
O
O
O
O
O
O
O
O
J
J
g
J
D
t
J
O
J
J
J
g
O
O
t
J
g
J
D
t
O
J
J
J
J
g
J
L
J
t
O
n
"}
(18,1,1) = {"
O
t
J
g
J
D
t
J
g
O
J
D
t
J
g
O
J
g
O
O
t
O
g
J
J
O
O
O
O
J
g
J
J
J
J
O
J
J
O
n
"}
(19,1,1) = {"
g
g
J
J
O
O
O
O
O
O
t
J
g
J
J
J
g
J
D
t
J
g
O
J
J
J
g
J
J
g
J
D
t
J
g
O
J
J
O
n
"}
(20,1,1) = {"
J
J
g
J
J
J
J
g
J
g
g
J
J
O
J
g
J
D
t
J
g
J
D
t
J
J
J
J
g
J
D
t
J
g
J
D
t
J
O
n
"}
(21,1,1) = {"
J
e
J
J
g
J
J
J
J
J
J
g
J
J
J
J
J
g
J
J
J
J
g
J
O
g
O
O
J
J
J
J
J
g
J
D
t
J
O
n
"}
(22,1,1) = {"
O
t
J
g
J
D
t
J
t
J
e
J
O
O
t
J
g
J
D
t
J
g
O
J
O
O
J
g
g
J
g
J
g
J
D
O
O
t
O
n
"}
(23,1,1) = {"
t
g
J
J
O
O
O
O
O
O
t
J
J
g
g
J
J
O
O
O
O
O
O
g
O
J
J
J
J
D
t
J
g
J
D
J
g
g
O
n
"}
(24,1,1) = {"
J
J
t
t
Q
J
J
t
J
t
g
J
J
J
J
g
J
J
J
J
g
J
O
O
t
J
g
J
J
D
t
J
t
J
g
J
J
J
O
n
"}
(25,1,1) = {"
O
J
Q
t
t
J
O
O
t
J
g
J
D
t
J
g
O
g
J
J
J
J
O
g
g
J
O
O
J
g
O
t
J
g
J
t
J
e
O
n
"}
(26,1,1) = {"
O
J
J
J
J
g
J
g
g
J
J
O
O
O
O
O
O
J
D
t
J
g
O
J
J
g
J
g
O
d
O
O
O
O
O
O
O
t
O
n
"}
(27,1,1) = {"
O
t
J
g
J
D
t
J
g
O
J
J
J
J
g
J
O
O
O
O
O
O
t
J
e
J
J
J
g
J
O
O
O
O
O
J
t
g
O
n
"}
(28,1,1) = {"
g
g
J
J
O
O
O
O
O
O
J
g
J
J
J
J
O
Q
J
J
t
g
J
O
t
J
t
J
J
J
O
O
O
O
O
J
J
J
O
n
"}
(29,1,1) = {"
J
J
g
J
J
J
J
g
J
O
g
J
D
t
J
g
O
t
J
J
J
t
g
t
g
J
O
O
J
g
O
O
t
J
g
J
D
t
O
n
"}
(30,1,1) = {"
J
e
J
J
g
J
J
J
J
O
J
O
O
O
O
O
t
J
g
J
O
J
t
J
J
t
J
t
O
O
t
O
g
J
J
O
O
O
O
n
"}
(31,1,1) = {"
O
t
J
g
J
D
t
J
g
O
t
Q
J
J
t
g
J
J
J
J
O
o
J
O
J
Q
J
J
J
t
t
Q
J
J
t
g
J
O
O
n
"}
(32,1,1) = {"
t
g
J
J
O
O
O
O
O
t
t
t
J
J
J
t
g
t
J
g
O
J
J
O
J
J
J
O
J
Q
t
t
J
J
J
t
g
O
O
n
"}
(33,1,1) = {"
J
J
t
t
Q
J
J
t
g
o
J
J
g
J
O
J
t
J
g
J
D
t
J
O
J
g
J
O
J
J
J
J
g
J
O
J
t
O
O
n
"}
(34,1,1) = {"
O
J
Q
t
t
J
J
J
t
g
J
J
J
J
O
J
J
O
O
O
O
O
J
J
g
J
g
O
J
g
J
J
J
J
O
J
J
O
O
n
"}
(35,1,1) = {"
O
J
J
J
J
g
J
O
J
t
D
t
J
g
O
J
J
O
O
O
O
O
J
g
J
D
J
J
g
J
D
t
J
g
O
J
J
O
O
n
"}
(36,1,1) = {"
O
J
g
J
J
J
J
O
J
J
t
J
g
J
D
t
J
O
O
O
O
O
O
O
O
O
J
g
J
D
t
J
g
J
D
t
J
O
O
n
"}
(37,1,1) = {"
J
g
J
D
t
J
g
O
J
J
O
O
O
O
O
O
O
O
O
O
O
O
O
O
O
O
J
O
J
J
J
J
g
J
O
J
t
O
O
n
"}
(38,1,1) = {"
g
J
D
t
J
g
J
D
t
J
a
a
a
O
O
O
O
O
O
O
O
O
O
O
O
O
g
O
J
g
J
J
J
J
O
J
J
O
O
n
"}
(39,1,1) = {"
O
O
O
O
a
a
a
a
a
a
a
a
a
a
a
a
a
a
O
O
O
O
O
O
O
O
J
J
g
J
D
t
J
g
O
J
J
O
O
n
"}
(40,1,1) = {"
O
O
O
O
a
a
a
a
a
a
a
a
a
a
a
a
a
a
a
a
O
O
O
O
O
O
J
g
J
D
t
J
g
J
D
t
J
O
O
n
"}
(41,1,1) = {"
O
O
O
O
a
a
a
a
a
a
a
a
a
a
a
a
a
a
a
a
a
a
O
O
O
O
O
O
O
O
O
O
O
O
O
O
O
O
n
n
"}
(42,1,1) = {"
O
O
O
O
a
a
a
a
a
a
a
a
a
a
a
a
a
a
a
a
a
a
a
a
O
O
O
O
O
O
O
O
O
O
O
O
O
n
n
n
"}
(43,1,1) = {"
O
O
O
O
a
a
a
a
a
a
a
a
a
a
a
a
a
a
a
a
a
a
a
a
a
O
O
n
n
n
n
n
n
n
n
n
n
n
n
n
"}
(44,1,1) = {"
O
O
O
O
a
a
a
a
a
a
a
a
a
a
a
a
a
a
a
a
a
a
a
a
a
a
n
n
n
n
n
n
n
n
n
n
n
n
n
n
"}
(45,1,1) = {"
O
O
O
a
a
a
a
a
a
a
a
a
a
a
a
a
a
a
a
a
a
a
a
a
a
a
a
a
n
n
n
n
n
n
n
n
n
n
n
n
"}
(46,1,1) = {"
O
O
O
a
a
a
a
a
a
a
a
a
a
a
a
a
a
a
a
a
a
a
a
a
a
a
a
a
a
a
n
n
n
n
n
n
n
n
n
n
"}
(47,1,1) = {"
O
O
O
a
a
a
a
a
a
a
a
a
a
a
a
a
a
a
a
a
a
a
a
a
a
a
a
a
a
a
a
n
n
n
n
n
n
n
n
n
"}
(48,1,1) = {"
O
O
O
a
a
a
a
a
a
a
a
a
a
a
a
a
a
a
a
a
a
a
a
a
a
a
a
a
a
a
a
a
n
n
n
n
n
n
n
n
"}
(49,1,1) = {"
O
O
a
a
a
a
a
a
a
a
a
a
a
a
a
a
a
a
a
a
a
a
a
a
a
a
a
a
a
a
a
a
a
a
n
n
n
n
n
n
"}
(50,1,1) = {"
O
O
a
a
a
a
a
a
a
a
a
a
a
a
a
a
a
a
a
a
a
a
a
a
a
a
a
a
a
a
a
a
a
a
a
n
n
n
n
n
"}
(51,1,1) = {"
O
O
a
a
a
a
a
a
a
a
a
a
a
a
a
a
a
a
a
a
a
a
a
a
a
a
a
a
a
a
a
a
a
a
a
a
n
n
n
n
"}
(52,1,1) = {"
O
O
a
a
a
a
a
a
a
a
a
a
a
a
a
a
a
a
a
a
a
a
a
a
a
a
a
a
a
a
a
a
a
a
a
a
a
n
n
n
"}
(53,1,1) = {"
O
O
a
a
a
a
a
a
a
a
a
a
a
a
a
a
a
a
a
a
a
a
a
a
a
a
a
a
a
a
a
a
a
a
a
a
a
n
n
n
"}
(54,1,1) = {"
O
O
a
a
a
a
a
a
a
a
a
a
a
a
a
a
a
a
a
a
a
a
a
a
a
a
a
a
a
a
a
a
a
a
a
a
a
a
n
n
"}
(55,1,1) = {"
O
O
a
a
a
a
a
a
a
a
a
a
a
a
a
a
a
a
a
a
a
a
a
a
a
a
a
a
a
a
a
a
a
a
a
a
a
a
n
n
"}
(56,1,1) = {"
O
O
a
a
a
a
a
a
a
a
a
a
a
a
a
a
a
a
a
a
a
a
a
a
a
a
a
a
a
a
a
a
a
a
a
a
a
a
n
n
"}
(57,1,1) = {"
O
O
a
a
a
a
a
a
a
a
a
a
a
a
a
a
a
a
a
a
a
a
a
a
a
a
a
a
a
a
a
a
a
a
a
a
a
a
n
n
"}
(58,1,1) = {"
O
a
a
a
a
a
a
a
a
a
a
a
a
a
a
a
a
a
a
a
a
a
a
a
a
a
a
a
a
a
a
a
a
a
a
a
a
a
a
n
"}
(59,1,1) = {"
O
a
a
a
a
a
a
a
a
a
a
a
a
a
a
a
a
a
a
a
a
a
a
a
a
a
a
a
a
a
a
a
a
a
a
a
a
a
a
n
"}
(60,1,1) = {"
O
a
a
a
a
a
a
a
a
a
a
a
a
a
a
a
a
a
a
a
a
a
a
a
a
a
a
a
a
a
a
a
a
a
a
a
a
a
a
n
"}
(61,1,1) = {"
O
a
a
a
a
a
a
a
a
a
a
a
a
a
a
a
a
a
a
a
a
a
a
a
a
a
a
a
a
a
a
a
a
a
a
a
a
a
a
n
"}
(62,1,1) = {"
O
a
a
a
a
a
a
a
a
a
a
a
a
a
a
a
a
a
a
a
a
a
a
a
a
a
a
a
a
a
a
a
a
a
a
a
a
a
a
n
"}
(63,1,1) = {"
O
a
a
a
a
a
a
a
a
a
a
a
a
a
a
a
a
a
a
a
a
a
a
a
a
a
a
a
a
a
a
a
a
a
a
a
a
a
a
n
"}
(64,1,1) = {"
O
a
a
a
a
a
a
a
a
a
a
a
a
a
a
a
a
a
a
a
a
a
a
a
a
a
a
a
a
a
a
a
a
a
a
a
a
a
a
n
"}
(65,1,1) = {"
O
a
a
a
a
a
a
a
a
a
a
a
a
a
a
a
a
a
a
a
a
a
a
a
a
a
a
a
a
a
a
a
a
a
a
a
a
a
a
n
"}
(66,1,1) = {"
O
a
a
a
a
a
a
a
a
a
a
a
a
a
a
a
a
a
a
a
a
a
a
a
a
a
a
a
a
a
a
a
a
a
a
a
a
a
a
n
"}
(67,1,1) = {"
O
a
a
a
a
a
a
a
a
a
a
a
a
a
a
a
a
a
a
a
a
a
a
a
a
a
a
a
a
a
a
a
a
a
a
a
a
a
a
n
"}
(68,1,1) = {"
O
a
a
a
a
a
a
a
a
a
a
a
a
a
a
a
a
a
a
a
a
a
a
a
a
a
a
a
a
a
a
a
a
a
a
a
a
a
a
n
"}
(69,1,1) = {"
O
a
a
a
a
a
a
a
a
a
a
a
a
a
a
a
a
a
a
a
a
a
a
a
a
a
a
a
a
a
a
a
a
a
a
a
a
a
a
n
"}
(70,1,1) = {"
O
a
a
a
a
a
a
a
a
a
a
a
a
a
a
a
a
a
a
a
a
a
a
a
a
a
a
a
a
a
a
a
a
a
a
a
a
a
a
n
"}
(71,1,1) = {"
O
a
a
a
a
a
a
a
a
a
a
a
a
a
a
a
a
a
a
a
a
a
a
a
a
a
a
a
a
a
a
a
a
a
a
a
a
a
a
n
"}
(72,1,1) = {"
O
a
a
a
a
a
a
a
a
a
a
a
a
a
a
a
a
a
a
a
a
a
a
a
a
a
a
a
a
a
a
a
a
a
a
a
a
a
a
n
"}
(73,1,1) = {"
O
a
a
a
a
a
a
a
a
a
a
a
a
a
a
a
a
a
a
a
a
a
a
a
a
a
a
a
a
a
a
a
a
a
a
a
a
a
a
n
"}
(74,1,1) = {"
O
a
a
a
a
a
a
a
a
a
a
a
a
a
a
a
a
a
a
a
a
a
a
a
a
a
a
a
a
a
a
a
a
a
a
a
a
a
a
n
"}
(75,1,1) = {"
O
a
a
a
a
a
a
a
a
a
a
a
a
a
a
a
a
a
a
a
a
a
a
a
a
a
a
a
a
a
a
a
a
a
a
a
a
a
a
n
"}
(76,1,1) = {"
O
a
a
a
a
a
a
a
a
a
a
a
a
a
a
a
a
a
a
a
a
a
a
a
a
a
a
a
a
a
a
a
a
a
a
a
a
a
a
n
"}
(77,1,1) = {"
O
a
a
a
a
a
a
a
a
a
a
a
a
a
a
a
a
a
a
a
a
a
a
a
a
a
a
a
a
a
a
a
a
a
a
a
a
a
a
n
"}
(78,1,1) = {"
O
a
a
a
a
a
a
a
a
a
a
a
a
a
a
a
a
a
a
a
a
a
a
a
a
a
a
a
a
a
a
a
a
a
a
a
a
a
a
n
"}
(79,1,1) = {"
O
a
a
a
a
a
a
a
a
a
a
a
a
a
a
a
a
a
a
a
a
a
a
a
a
a
a
a
a
a
a
a
a
a
a
a
a
a
a
n
"}
(80,1,1) = {"
O
a
a
a
a
a
a
a
a
a
a
a
a
a
a
a
a
a
a
a
a
a
a
a
a
a
a
a
a
a
a
a
a
a
a
a
a
a
a
n
"}
(81,1,1) = {"
O
a
a
a
a
a
a
a
a
a
a
a
a
a
a
a
a
a
a
a
a
a
a
a
a
a
a
a
a
a
a
a
a
a
a
a
a
a
a
n
"}
(82,1,1) = {"
O
a
a
a
a
a
a
a
a
a
a
a
a
a
a
a
a
a
a
a
a
a
a
a
a
a
a
a
a
a
a
a
a
a
a
a
a
a
a
n
"}
(83,1,1) = {"
O
a
a
a
a
a
a
a
a
a
a
a
a
a
a
a
a
a
a
a
a
a
a
a
a
a
a
a
a
a
a
a
a
a
a
a
a
a
a
n
"}
(84,1,1) = {"
O
a
a
a
a
a
a
a
a
a
a
a
a
a
a
a
a
a
a
a
a
a
a
a
a
a
a
a
a
a
a
a
a
a
a
a
a
a
a
n
"}
(85,1,1) = {"
O
a
a
a
a
a
a
a
a
a
a
a
a
a
a
a
a
a
a
a
a
a
a
a
a
a
a
a
a
a
a
a
a
a
a
a
a
a
a
n
"}
(86,1,1) = {"
O
a
a
a
a
a
a
a
a
a
a
a
a
a
a
a
a
a
a
a
a
a
a
a
a
a
a
a
a
a
a
a
a
a
a
a
a
a
a
n
"}
(87,1,1) = {"
O
a
a
a
a
a
a
a
a
a
a
a
a
a
a
a
a
a
a
a
a
a
a
a
a
a
a
a
a
a
a
a
a
a
a
a
a
a
a
n
"}
(88,1,1) = {"
O
a
a
a
a
a
a
a
a
a
a
a
a
a
a
a
a
a
a
a
a
a
a
a
a
a
a
a
a
a
a
a
a
a
a
a
a
a
a
n
"}
(89,1,1) = {"
O
a
a
a
a
a
a
a
a
a
a
a
a
a
a
a
a
a
a
a
a
a
a
a
a
a
a
a
a
a
a
a
a
a
a
a
a
a
a
n
"}
(90,1,1) = {"
O
a
a
a
a
a
a
a
a
a
a
a
a
a
a
a
a
a
a
a
a
a
a
a
a
a
a
a
a
a
a
a
a
a
a
a
a
a
a
n
"}
(91,1,1) = {"
O
a
a
a
a
a
a
a
a
a
a
a
a
a
a
a
a
a
a
a
a
a
a
a
a
a
a
a
a
a
a
a
a
a
a
a
a
a
a
n
"}
(92,1,1) = {"
O
a
a
a
a
a
a
a
a
a
a
a
a
a
a
a
a
a
a
a
a
a
a
a
a
a
a
a
a
a
a
a
a
a
a
a
a
a
a
n
"}
(93,1,1) = {"
O
a
a
a
a
a
a
a
a
a
a
a
a
a
a
a
a
a
a
a
a
a
a
a
a
a
a
a
a
a
a
a
a
a
a
a
a
a
a
n
"}
(94,1,1) = {"
O
a
a
a
a
a
a
a
a
a
a
a
a
a
a
a
a
a
a
a
a
a
a
a
a
a
a
a
a
a
a
a
a
a
a
a
a
a
a
n
"}
(95,1,1) = {"
O
a
a
a
a
a
a
a
a
a
a
a
a
a
a
a
a
a
a
a
a
a
a
a
a
a
a
a
a
a
a
a
a
a
a
a
a
a
a
n
"}
(96,1,1) = {"
O
a
a
a
a
a
a
a
a
a
a
a
a
a
a
a
a
a
a
a
a
a
a
a
a
a
a
a
a
a
a
a
a
a
a
a
a
a
a
n
"}
(97,1,1) = {"
O
a
a
a
a
a
a
a
a
a
a
a
a
a
a
a
a
a
a
a
a
a
a
a
a
a
a
a
a
a
a
a
a
a
a
a
a
a
a
n
"}
(98,1,1) = {"
O
a
a
a
a
a
a
a
a
a
a
a
a
a
a
a
a
a
a
a
a
a
a
a
a
a
a
a
a
a
a
a
a
a
a
a
a
a
a
n
"}
(99,1,1) = {"
O
a
a
a
a
a
a
a
a
a
a
a
a
a
a
a
a
a
a
a
a
a
a
a
a
a
a
a
a
a
a
a
a
a
a
a
a
a
a
n
"}
(100,1,1) = {"
O
a
a
a
a
a
a
a
a
a
a
a
a
a
a
a
a
a
a
a
a
a
a
a
a
a
a
a
a
a
a
a
a
a
a
a
a
a
a
n
"}
(101,1,1) = {"
O
a
a
a
a
a
a
a
a
a
a
a
a
a
a
a
a
a
a
a
a
a
a
a
a
a
a
a
a
a
a
a
a
a
a
a
a
a
a
n
"}
(102,1,1) = {"
O
a
a
a
a
a
a
a
a
a
a
a
a
a
a
a
a
a
a
a
a
a
a
a
a
a
a
a
a
a
a
a
a
a
a
a
a
a
a
n
"}
(103,1,1) = {"
O
a
a
a
a
a
a
a
a
a
a
a
a
a
a
a
a
a
a
a
a
a
a
a
a
a
a
a
a
a
a
a
a
a
a
a
a
a
a
n
"}
(104,1,1) = {"
O
a
a
a
a
a
a
a
a
a
a
a
a
a
a
a
a
a
a
a
a
a
a
a
a
a
a
a
a
a
a
a
a
a
a
a
a
a
a
n
"}
(105,1,1) = {"
O
a
a
a
a
a
a
a
a
a
a
a
a
a
a
a
a
a
a
a
a
a
a
a
a
a
a
a
a
a
a
a
a
a
a
a
a
a
a
n
"}
(106,1,1) = {"
O
a
a
a
a
a
a
a
a
a
a
a
a
a
a
a
a
a
a
a
a
a
a
a
a
a
a
a
a
a
a
a
a
a
a
a
a
a
a
n
"}
(107,1,1) = {"
O
a
a
a
a
a
a
a
a
a
a
a
a
a
a
a
a
a
a
a
a
a
a
a
a
a
a
a
a
a
a
a
a
a
a
a
a
a
a
n
"}
(108,1,1) = {"
O
O
a
a
a
a
a
a
a
a
a
a
a
a
a
a
a
a
a
a
a
a
a
a
a
a
a
a
a
a
a
a
a
a
a
a
a
a
a
n
"}
(109,1,1) = {"
O
O
a
a
a
a
a
a
a
a
a
a
a
a
a
a
a
a
a
a
a
a
a
a
a
a
a
a
a
a
a
a
a
a
a
a
a
a
a
n
"}
(110,1,1) = {"
O
O
a
a
a
a
a
a
a
a
a
a
a
a
a
a
a
a
a
a
a
a
a
a
a
a
a
a
a
a
a
a
a
a
a
a
a
a
a
n
"}
(111,1,1) = {"
O
O
a
a
a
a
a
a
a
a
a
a
a
a
a
a
a
a
a
a
a
a
a
a
a
a
a
a
a
a
a
a
a
a
a
a
a
a
a
n
"}
(112,1,1) = {"
O
O
O
a
a
a
a
a
a
a
a
a
a
a
a
a
a
a
a
a
a
a
a
a
a
a
a
a
a
a
a
a
a
a
a
a
a
a
a
n
"}
(113,1,1) = {"
O
O
O
a
a
a
a
a
a
a
a
a
a
a
a
a
a
a
a
a
a
a
a
a
a
a
a
a
a
a
a
a
a
a
a
a
a
a
a
n
"}
(114,1,1) = {"
O
O
O
a
a
a
a
a
a
a
a
a
a
a
a
a
a
a
a
a
a
a
a
a
a
a
a
a
a
a
a
a
a
a
a
a
a
a
a
n
"}
(115,1,1) = {"
O
O
O
a
a
a
a
a
a
a
a
a
a
a
a
a
a
a
a
a
a
a
a
a
a
a
a
a
a
a
a
a
a
v
H
H
C
a
a
n
"}
(116,1,1) = {"
O
O
O
a
a
a
a
a
a
a
a
a
a
a
a
a
a
a
a
a
a
a
a
a
a
a
a
a
a
a
a
a
a
v
H
H
C
a
a
n
"}
(117,1,1) = {"
O
O
O
a
a
a
a
a
a
a
a
a
a
a
a
a
a
a
a
a
a
a
a
a
a
a
a
a
a
a
a
a
a
v
H
H
C
a
a
n
"}
(118,1,1) = {"
O
O
O
a
a
a
a
a
a
a
a
a
a
a
a
a
a
a
a
a
a
a
a
a
a
a
a
a
a
a
a
a
a
v
H
H
C
a
a
n
"}
(119,1,1) = {"
O
O
O
a
a
a
a
a
a
a
a
a
a
a
a
a
a
a
a
a
a
a
a
a
a
a
a
a
a
a
a
a
a
v
H
H
C
a
a
n
"}
(120,1,1) = {"
O
O
O
O
a
a
a
a
a
a
a
a
a
a
a
a
a
a
a
a
a
a
a
a
a
a
a
a
a
a
a
a
a
v
H
H
C
a
a
n
"}
(121,1,1) = {"
O
O
O
O
a
a
a
a
a
a
a
a
a
a
a
a
a
a
a
a
a
a
a
a
a
a
a
a
a
a
a
a
a
v
H
H
C
a
a
n
"}
(122,1,1) = {"
O
O
O
O
a
a
a
a
a
a
a
a
a
a
a
a
a
a
a
a
a
a
a
a
a
a
a
a
a
a
a
a
a
v
H
H
C
a
a
n
"}
(123,1,1) = {"
O
O
O
O
O
O
O
a
a
a
a
a
a
a
a
a
a
a
a
a
a
a
a
a
a
a
a
a
a
a
a
a
a
v
H
H
C
O
O
n
"}
(124,1,1) = {"
O
O
O
O
O
O
O
O
O
a
a
a
a
a
a
a
a
a
a
a
a
a
a
a
a
a
a
a
a
a
a
a
O
U
H
H
R
O
O
n
"}
(125,1,1) = {"
J
D
t
J
g
O
O
O
O
O
O
O
O
O
a
a
a
a
a
a
a
a
a
O
O
O
O
O
O
q
O
O
T
O
O
O
O
O
O
n
"}
(126,1,1) = {"
O
O
O
O
O
O
O
O
O
O
O
O
O
O
O
O
O
O
O
O
O
O
O
O
O
O
O
O
O
q
T
X
X
X
B
X
X
X
O
n
"}
(127,1,1) = {"
J
J
J
g
J
O
O
O
O
O
O
O
O
O
O
O
O
O
O
O
O
O
O
O
O
O
O
O
O
z
T
X
S
V
w
w
x
X
O
n
"}
(128,1,1) = {"
g
J
J
J
J
O
t
J
g
O
O
O
O
O
O
O
O
O
O
O
O
O
O
O
O
O
O
O
O
q
O
X
N
Y
k
k
h
X
O
n
"}
(129,1,1) = {"
J
D
t
J
g
O
O
O
O
O
O
O
O
O
O
O
O
O
O
O
O
O
t
J
g
J
O
O
O
q
O
X
N
k
k
k
h
X
O
n
"}
(130,1,1) = {"
O
O
O
O
O
t
J
g
J
O
O
O
O
O
O
O
J
g
J
g
J
g
g
J
J
O
O
O
O
O
O
X
Z
I
u
k
h
X
O
n
"}
(131,1,1) = {"
Q
J
J
t
g
J
J
J
J
O
O
O
t
J
J
J
J
J
J
J
J
J
J
g
J
J
O
O
O
O
O
X
F
I
I
k
h
X
O
n
"}
(132,1,1) = {"
t
J
J
J
t
g
t
J
g
O
J
g
g
J
J
J
t
J
t
J
t
J
e
J
J
g
J
O
O
O
O
X
j
G
G
M
P
X
O
n
"}
(133,1,1) = {"
J
g
J
O
J
t
O
O
O
J
J
J
J
J
g
J
D
t
J
O
O
O
t
J
g
J
O
O
O
q
O
X
X
X
X
X
X
X
O
n
"}
(134,1,1) = {"
J
J
J
O
J
J
J
t
g
g
J
g
J
g
J
D
O
O
t
t
J
t
g
J
J
O
J
g
O
q
O
O
O
O
O
O
O
O
O
n
"}
(135,1,1) = {"
t
J
g
O
J
J
A
J
t
J
D
t
J
g
J
D
J
g
g
J
J
J
J
t
t
Q
J
J
O
O
O
O
O
O
l
O
O
l
l
n
"}
(136,1,1) = {"
J
g
J
D
t
J
J
O
J
J
D
t
J
t
J
g
J
J
J
O
J
O
J
Q
t
t
t
J
e
J
O
O
O
O
O
O
O
O
O
n
"}
(137,1,1) = {"
O
J
g
J
J
J
J
O
J
J
g
O
t
J
g
J
t
J
e
O
J
O
J
J
J
J
O
O
t
J
g
O
O
O
O
O
O
O
O
n
"}
(138,1,1) = {"
J
g
J
D
t
J
g
O
J
O
O
O
O
O
O
O
O
O
t
O
g
O
J
g
J
J
J
t
g
J
J
O
O
O
O
O
O
O
O
n
"}
(139,1,1) = {"
g
J
D
t
J
g
J
D
t
J
J
J
J
J
g
J
D
t
J
J
J
J
g
J
D
t
J
J
J
t
t
Q
J
J
t
g
J
O
O
n
"}
(140,1,1) = {"
O
O
O
O
O
O
O
O
b
g
J
g
J
g
J
D
O
O
t
g
J
g
J
D
O
O
t
J
g
J
D
t
J
g
O
t
g
O
O
n
"}
(141,1,1) = {"
O
O
O
O
O
O
O
O
O
J
D
t
J
g
J
D
J
g
g
t
J
g
J
D
J
g
g
J
A
O
O
O
O
O
O
J
t
O
O
n
"}
(142,1,1) = {"
J
J
J
J
J
g
J
D
t
J
D
t
J
t
J
g
J
J
J
t
J
t
J
g
J
J
J
g
J
J
J
J
g
J
O
J
J
O
O
n
"}
(143,1,1) = {"
g
J
g
J
g
J
D
O
O
J
g
O
t
J
g
J
t
J
e
O
t
J
g
J
t
J
e
J
J
g
J
J
J
J
O
J
J
O
O
n
"}
(144,1,1) = {"
J
D
t
J
g
J
D
J
g
O
O
O
O
O
J
J
J
J
J
g
J
D
t
J
O
O
t
J
g
J
D
t
J
g
O
t
J
O
O
n
"}
(145,1,1) = {"
J
D
t
J
t
J
g
J
J
g
J
d
O
O
g
J
g
J
g
J
D
O
O
t
J
t
g
J
J
O
O
O
O
O
t
O
O
O
O
n
"}
(146,1,1) = {"
J
g
O
t
J
g
J
t
J
J
J
O
O
O
J
D
t
J
g
J
D
J
g
g
J
J
J
t
t
Q
J
J
t
g
J
O
O
O
O
n
"}
(147,1,1) = {"
O
O
O
O
J
J
J
J
J
g
J
D
t
J
J
D
t
J
t
J
g
J
J
J
J
D
t
J
g
O
J
J
J
t
g
O
O
O
O
n
"}
(148,1,1) = {"
g
J
O
O
g
J
g
J
g
J
D
O
O
t
J
g
O
t
J
g
J
t
J
e
O
O
O
O
O
O
g
J
O
J
t
O
O
O
O
n
"}
(149,1,1) = {"
J
J
O
O
J
D
t
J
g
J
D
J
g
g
O
O
O
O
O
O
O
O
O
t
J
J
J
g
J
O
J
J
O
J
J
O
O
O
n
n
"}
(150,1,1) = {"
J
g
O
O
J
D
t
J
t
J
g
J
J
J
g
J
O
O
O
O
O
J
t
g
g
J
J
J
J
O
J
g
O
J
J
O
O
O
n
n
"}
(151,1,1) = {"
O
O
t
O
J
g
O
t
J
g
J
t
J
e
J
J
O
O
O
O
O
J
J
J
t
J
g
O
g
O
g
J
D
t
J
O
O
O
n
n
"}
(152,1,1) = {"
J
J
J
J
O
O
O
O
O
O
L
O
O
t
J
g
O
O
t
J
g
J
D
t
O
O
O
O
O
t
O
O
O
O
O
O
O
n
n
n
"}
(153,1,1) = {"
D
t
J
g
g
J
O
O
O
O
O
J
t
g
O
O
t
O
g
J
J
O
O
O
J
g
O
O
g
J
O
O
O
O
O
O
O
n
n
n
"}
(154,1,1) = {"
t
J
g
J
J
J
O
O
O
O
O
J
J
J
J
g
J
D
t
J
J
O
O
O
O
O
O
O
t
g
O
O
O
O
O
O
O
n
n
n
"}
(155,1,1) = {"
O
O
O
O
J
g
O
O
t
J
g
J
D
t
t
J
g
J
D
t
J
J
J
J
g
o
O
O
J
t
O
O
O
O
O
n
n
n
n
n
"}
(156,1,1) = {"
O
O
O
O
O
O
t
O
g
J
J
O
O
O
J
J
t
J
e
J
J
g
J
J
J
J
O
t
J
J
O
O
O
O
n
n
n
n
n
n
"}
(157,1,1) = {"
t
J
g
O
J
J
g
J
D
t
J
g
J
D
t
J
J
g
J
D
t
J
g
O
J
g
O
J
J
J
O
n
n
n
n
n
n
n
n
n
"}
(158,1,1) = {"
O
O
O
O
J
O
J
Q
t
t
J
J
J
t
g
g
J
J
O
O
O
O
O
O
O
O
t
g
t
J
O
n
n
n
n
n
n
n
n
n
"}
(159,1,1) = {"
J
g
J
O
J
O
J
J
J
J
g
J
O
J
t
J
g
J
J
J
J
g
J
O
t
g
J
t
O
O
n
n
n
n
n
n
n
n
n
n
"}
(160,1,1) = {"
J
J
J
O
g
O
J
g
J
J
J
J
O
J
J
D
t
J
g
O
J
J
J
O
J
t
g
J
O
O
n
n
n
n
n
n
n
n
n
n
"}
(161,1,1) = {"
t
J
g
O
J
J
g
J
D
t
J
g
O
J
J
O
O
O
O
O
t
J
g
O
O
J
t
J
O
O
n
n
n
n
n
n
n
n
n
n
"}
(162,1,1) = {"
O
O
O
t
J
g
J
D
t
J
g
J
D
t
J
J
J
g
J
O
O
O
O
t
O
J
J
J
O
n
n
n
n
n
n
n
n
n
n
n
"}
(163,1,1) = {"
J
t
g
J
O
O
d
O
b
t
J
e
J
J
g
J
J
J
J
O
J
t
g
J
O
J
J
O
O
n
n
n
n
n
n
n
n
n
n
n
"}
(164,1,1) = {"
J
J
t
g
O
O
O
O
O
O
O
t
J
g
J
D
t
J
g
O
J
J
t
g
D
t
J
O
O
n
n
n
n
n
n
n
n
n
n
n
"}
(165,1,1) = {"
J
O
J
t
O
O
O
O
O
J
t
g
J
J
O
O
O
O
O
t
J
O
J
t
O
O
O
O
n
n
n
n
n
n
n
n
n
n
n
n
"}
(166,1,1) = {"
J
O
J
J
O
O
O
O
O
J
J
J
t
t
Q
J
J
t
g
J
J
O
J
J
O
O
O
n
n
n
n
n
n
n
n
n
n
n
n
n
"}
(167,1,1) = {"
g
O
J
J
O
O
O
O
O
J
O
J
Q
t
t
J
J
J
t
g
g
O
J
J
O
O
n
n
n
n
n
n
n
n
n
n
n
n
n
n
"}
(168,1,1) = {"
J
D
t
J
O
O
O
O
O
J
O
J
J
J
J
g
J
O
J
t
J
D
t
J
n
n
n
n
n
n
n
n
n
n
n
n
n
n
n
n
"}
(169,1,1) = {"
O
O
O
O
O
O
O
O
O
g
O
J
g
J
J
J
J
O
J
J
n
n
n
n
n
n
n
n
n
n
n
n
n
n
n
n
n
n
n
n
"}
(170,1,1) = {"
n
n
n
n
n
n
n
n
n
n
n
n
n
n
n
n
n
n
n
n
n
n
n
n
n
n
n
n
n
n
n
n
n
n
n
n
n
n
n
n
"}
